State,City,Population,Never Married,Married,Divorced,Separated,Widowed,Total
Alabama,La Fayette,2945,931,827,252,69,236,2315
Alabama,Altoona,890,205,286,130,52,42,715
Alabama,Benton,47,0,37,0,0,6,43
Alabama,Mosses,1073,473,191,63,32,84,843
Alabama,Ohatchee,1293,164,708,122,2,45,1041
Alabama,Saks,10763,1923,4021,1428,333,846,8551
Alabama,New Brockton,1127,258,412,181,9,71,931
Alabama,Madrid,301,61,100,45,4,37,247
Alabama,Oakman,691,176,143,121,37,79,556
Alabama,Toxey,118,21,44,9,0,25,99
Alabama,Sylvan Springs,1670,237,818,166,12,110,1343
Alabama,Helena,17861,3612,8445,1477,78,380,13992
Alabama,Hoover,84480,17070,40348,5848,511,3176,66953
Alabama,Midfield,5158,1769,1480,524,271,276,4320
Alabama,Vestavia Hills,34163,5519,16764,2344,314,1572,26513
Alabama,Andalusia,8864,2205,3017,1091,195,742,7250
Alabama,Horn Hill,262,35,138,22,0,14,209
Alabama,Onycha,119,16,54,9,0,4,83
Alabama,Red Level,324,74,116,31,14,25,260
Alabama,Birmingham,212021,81265,49272,25625,6685,12242,175089
Alabama,Fort Deposit,1630,500,416,129,107,43,1195
Alabama,Reece City,729,109,384,67,11,58,629
Alabama,Trafford,640,102,280,99,8,41,530
Alabama,Rock Creek,1369,86,712,200,31,66,1095
Alabama,Babbie,557,101,251,65,4,44,465
Alabama,Shorter,433,100,160,31,26,62,379
Alabama,Tuskegee,8699,4703,1313,708,244,428,7396
Alabama,Clayton,2900,1210,544,504,231,122,2611
Alabama,Heath,339,76,96,48,11,6,237
Alabama,Opp,6520,1322,2404,697,175,697,5295
Alabama,Hayneville,1028,430,217,68,43,62,820
Alabama,Carrollton,1056,344,308,112,33,53,850
Alabama,Boaz,9553,1951,3759,952,108,729,7499
Alabama,Rainbow City,9581,1860,3991,1133,191,551,7726
Alabama,Lowndesboro,99,18,50,10,0,10,88
Alabama,Alexandria,4000,579,2004,372,24,152,3131
Alabama,Brookside,1538,266,544,122,27,119,1078
Alabama,Forestdale,9273,2603,3188,1236,315,464,7806
Alabama,Gardendale,13875,2576,6510,1141,105,1084,11416
Alabama,Grayson Valley,5986,1364,1839,1241,109,284,4837
Alabama,Graysville,1965,410,801,247,35,189,1682
Alabama,Hueytown,15583,3265,5832,1752,379,949,12177
Alabama,Berry,1400,318,616,98,20,44,1096
Alabama,Belk,243,38,153,14,0,17,222
Alabama,Anniston,21924,6541,6771,2475,690,1628,18105
Alabama,Atmore,9746,4020,2477,1100,186,595,8378
Alabama,Mignon,974,214,433,61,40,33,781
Alabama,Triana,686,166,244,119,25,25,579
Alabama,Meadowbrook,9387,1817,4981,386,35,405,7624
Alabama,Dayton,26,2,10,0,3,1,16
Alabama,Demopolis,6918,2089,1887,930,85,585,5576
Alabama,Sweet Water,326,59,152,11,0,10,232
Alabama,Huguley,2273,580,893,227,104,192,1996
Alabama,Shiloh,321,42,156,35,6,15,254
Alabama,Ozark,14456,3081,5423,1865,459,1085,11913
Alabama,Goldville,33,2,20,0,0,6,28
Alabama,Waverly,154,22,86,25,0,4,137
Alabama,Valley,9305,2538,3302,920,225,576,7561
Alabama,Littleville,1104,157,509,111,26,43,846
Alabama,Bear Creek,1256,295,574,88,13,79,1049
Alabama,Lexington,927,162,443,72,2,48,727
Alabama,Decatur,54617,13052,20254,5916,1576,3454,44252
Alabama,Lincoln,6600,1475,2969,709,283,285,5721
Alabama,Woodland,204,39,115,17,3,20,194
Alabama,Fairhope,20327,3434,9411,1910,279,1266,16300
Alabama,Hartselle,14405,2952,6743,1222,91,770,11778
Alabama,North Johns,188,45,56,35,2,11,149
Alabama,Powell,1089,366,344,109,24,80,923
Alabama,Camp Hill,1101,483,173,119,90,60,925
Alabama,Lineville,2471,647,832,192,64,164,1899
Alabama,Heflin,3449,754,1067,528,170,325,2844
Alabama,Akron,295,95,87,41,4,26,253
Alabama,Moundville,2774,672,1027,277,93,154,2223
Alabama,Guntersville,8377,1642,3354,1003,174,598,6771
Alabama,Pollard,198,16,80,17,1,4,118
Alabama,Orange Beach,5927,1145,2927,580,60,344,5056
Alabama,Goshen,223,39,90,19,2,14,164
Alabama,Bay Minette,9089,2783,2699,1047,136,472,7137
Alabama,Elberta,1741,349,690,296,38,130,1503
Alabama,Talladega,15609,5526,3799,1941,572,1312,13150
Alabama,New Site,791,196,345,80,11,33,665
Alabama,Wedowee,772,142,303,63,20,76,604
Alabama,Loxley,2077,547,758,212,15,79,1611
Alabama,Sylvania,2413,433,1021,169,93,118,1834
Alabama,St. Florian,406,72,251,28,0,29,380
Alabama,Somerville,534,93,245,80,16,36,470
Alabama,Oak Grove,605,94,285,87,5,36,507
Alabama,Vincent,2162,496,703,267,78,160,1704
Alabama,Geraldine,929,95,466,85,20,75,741
Alabama,Point Clear,2482,479,935,180,45,160,1799
Alabama,Mountain Brook,20466,3270,10894,784,23,741,15712
Alabama,Brighton,2823,1058,423,414,83,239,2217
Alabama,Allgood,674,184,245,65,19,27,540
Alabama,Rosa,400,74,183,32,1,24,314
Alabama,Brantley,828,288,203,84,29,62,666
Alabama,Deatsville,1350,192,679,88,1,35,995
Alabama,Frisco City,1459,375,400,84,70,153,1082
Alabama,Courtland,771,195,256,91,17,74,633
Alabama,Aliceville,2408,1012,477,182,101,201,1973
Alabama,Montgomery,200156,65413,59364,20268,4951,9828,159824
Alabama,Arley,566,116,262,53,6,44,481
Alabama,Bridgeport,2303,546,793,412,22,195,1968
Alabama,Pleasant Groves,416,107,178,17,10,30,342
Alabama,Fayette,4385,891,1645,507,126,315,3484
Alabama,Notasulga,953,235,438,104,5,75,857
Alabama,Baileyton,810,101,367,126,21,42,657
Alabama,West Point,593,88,318,35,10,18,469
Alabama,Oak Hill,22,5,4,2,0,11,22
Alabama,Midway,703,382,75,69,11,36,573
Alabama,Lakeview,154,16,50,18,2,20,106
Alabama,Dutton,411,74,145,36,11,41,307
Alabama,Addison,641,96,281,96,6,62,541
Alabama,Billingsley,121,33,24,15,13,23,108
Alabama,Winfield,4475,818,1754,292,154,407,3425
Alabama,Meridianville,6609,1500,3228,584,36,287,5635
Alabama,Redstone Arsenal,1414,541,516,71,3,6,1137
Alabama,Ladonia,3444,468,1268,603,53,146,2538
Alabama,York,3078,1205,701,217,87,171,2381
Alabama,McKenzie,608,173,165,61,18,41,458
Alabama,Columbiana,4420,1132,1433,609,191,457,3822
Alabama,Centreville,2677,760,1030,283,30,224,2327
Alabama,Luverne,2771,656,929,347,24,328,2284
Alabama,Rutledge,363,55,129,61,12,37,294
Alabama,Yellow Bluff,149,75,12,3,13,16,119
Alabama,West Blocton,1352,400,400,234,50,103,1187
Alabama,Gordo,1856,381,597,302,61,194,1535
Alabama,Brent,4840,1969,1113,535,210,306,4133
Alabama,Section,959,157,383,107,7,74,728
Alabama,Skyline,939,174,391,93,21,85,764
Alabama,South Vinemont,630,167,220,67,8,46,508
Alabama,Carolina,258,28,137,26,2,7,200
Alabama,River Falls,646,178,168,92,15,88,541
Alabama,Gu-Win,118,32,44,12,0,4,92
Alabama,Bon Air,87,16,35,11,3,7,72
Alabama,Waldo,261,63,99,35,2,16,215
Alabama,Newton,1722,305,653,226,47,151,1382
Alabama,Coffee Springs,195,33,78,38,2,17,168
Alabama,Linden,2041,592,700,183,41,294,1810
Alabama,Ethelsville,169,41,55,5,0,4,105
Alabama,Pine Apple,155,59,63,2,1,16,141
Alabama,Haleyville,3996,783,1241,725,39,347,3135
Alabama,County Line,274,24,150,20,2,12,208
Alabama,Nauvoo,160,26,73,23,7,14,143
Alabama,Holt,4159,1300,1298,383,54,231,3266
Alabama,Northport,25457,6835,9477,2252,142,1380,20086
Alabama,Hillsboro,618,188,242,74,6,29,539
Alabama,Highland Lake,360,39,194,38,7,34,312
Alabama,Elmore,1607,468,478,151,13,135,1245
Alabama,Tallassee,5013,1453,1459,413,190,516,4031
Alabama,Elkmont,490,65,237,62,5,22,391
Alabama,Trussville,21721,3033,10455,1848,161,1133,16630
Alabama,Elba,3852,980,1366,470,105,307,3228
Alabama,Columbia,661,113,309,88,13,44,567
Alabama,Grand Bay,4090,546,1758,469,105,210,3088
Alabama,McDonald Chapel,633,153,173,87,45,33,491
Alabama,Sipsey,397,99,134,42,16,24,315
Alabama,Pelham,23242,5257,10470,2349,141,745,18962
Alabama,Edgewater,743,120,268,77,24,27,516
Alabama,Vance,1732,321,755,127,6,86,1295
Alabama,Nectar,330,35,171,17,7,16,246
Alabama,Alexander City,14621,3446,5479,1662,285,990,11862
Alabama,Taylor,2397,356,928,327,85,88,1784
Alabama,Webb,1453,290,657,166,24,73,1210
Alabama,Bayou La Batre,2527,750,768,260,39,94,1911
Alabama,Mooresville,89,12,49,8,0,6,75
Alabama,Tillmans Corner,17814,3857,6626,2123,330,687,13623
Alabama,Carbon Hill,1402,251,399,278,48,175,1151
Alabama,Tuscaloosa,98881,43511,26628,7775,1562,3732,83208
Alabama,Oneonta,6575,958,2890,698,96,582,5224
Alabama,Susan Moore,700,161,362,55,3,49,630
Alabama,Fulton,208,55,82,23,0,19,179
Alabama,Gaylesville,191,28,101,13,0,14,156
Alabama,Glenwood,221,34,122,3,0,26,185
Alabama,Marion,3359,1385,434,697,55,316,2887
Alabama,Langston,216,22,125,41,3,18,209
Alabama,Hazel Green,3452,698,1607,413,13,198,2929
Alabama,Madison,48275,10898,22920,3343,420,1463,39044
Alabama,Edwardsville,197,13,89,19,0,17,138
Alabama,Lake View,3028,905,1366,192,11,83,2557
Alabama,Snead,702,108,379,74,13,49,623
Alabama,Robertsdale,6521,1117,2301,869,194,572,5053
Alabama,Garden City,553,103,230,46,13,60,452
Alabama,Georgiana,1914,608,441,256,54,264,1623
Alabama,Ider,644,100,312,103,20,49,584
Alabama,Pine Ridge,287,49,150,35,3,8,245
Alabama,Sand Rock,471,83,235,36,0,45,399
Alabama,Valley Head,660,180,217,103,11,40,551
Alabama,Waterloo,195,25,72,37,0,15,149
Alabama,Eva,560,87,290,51,3,21,452
Alabama,Falkville,1373,258,521,162,16,216,1173
Alabama,Priceville,3318,509,1598,223,52,183,2565
Alabama,Fyffe,1357,212,525,149,12,106,1004
Alabama,Childersburg,4959,1071,1777,685,28,377,3938
Alabama,Avon,463,91,214,62,0,20,387
Alabama,West End-Cobb Town,3346,728,1118,481,199,275,2801
Alabama,Kinston,708,195,235,117,10,38,595
Alabama,Rehobeth,1862,354,785,154,8,68,1369
Alabama,Ardmore,1305,244,450,247,16,86,1043
Alabama,Athens,25176,6342,9755,2586,472,1855,21010
Alabama,Citronelle,3911,741,1464,378,131,253,2967
Alabama,Dauphin Island,1229,180,719,162,9,53,1123
Alabama,Attalla,5847,1265,2026,745,191,331,4558
Alabama,Fort Payne,14006,3287,4925,1794,253,770,11029
Alabama,Mentone,305,31,161,52,2,36,282
Alabama,Steele,1133,162,513,133,23,103,934
Alabama,Homewood,25595,8036,9764,1806,250,763,20619
Alabama,Irondale,12474,3574,4136,1477,308,564,10059
Alabama,Wilsonville,2246,465,958,276,52,118,1869
Alabama,Sardis City,1763,341,898,139,24,106,1508
Alabama,White Hall,786,266,208,41,27,83,625
Alabama,Mulga,803,155,286,113,22,70,646
Alabama,Monroeville,6011,2014,1829,496,159,417,4915
Alabama,Minor,1074,211,491,78,11,16,807
Alabama,Tarrant,6212,2136,1415,775,199,447,4972
Alabama,Florence,40104,11675,13901,4542,650,3014,33782
Alabama,Hamilton,6664,1509,2963,707,51,419,5649
Alabama,Banks,157,47,28,30,6,4,115
Alabama,Wadley,809,384,175,67,13,30,669
Alabama,Wilton,806,247,254,72,32,58,663
Alabama,Lanett,6318,1950,1796,793,163,624,5326
Alabama,Tuscumbia,8426,1879,3205,915,60,533,6592
Alabama,Boligee,519,202,25,30,10,30,297
Alabama,Malvern,1773,386,726,235,9,79,1435
Alabama,Thorsby,1938,343,882,159,1,150,1535
Alabama,Cardiff,43,1,21,1,0,0,23
Alabama,Mobile,191485,62200,57323,21112,5066,11621,157322
Alabama,Argo,4235,715,2153,374,128,31,3401
Alabama,Bessemer,26759,9195,6423,3369,870,2101,21958
Alabama,Napier Field,418,130,126,42,4,20,322
Alabama,Fairview,497,75,215,31,16,39,376
Alabama,Vredenburgh,363,203,50,22,23,20,318
Alabama,Scottsboro,14527,2709,6359,1462,357,1122,12009
Alabama,Eufaula,12289,3494,4153,1070,283,873,9873
Alabama,Warrior,3209,719,1388,382,78,351,2918
Alabama,Double Springs,1408,303,345,209,41,166,1064
Alabama,Natural Bridge,14,4,7,3,0,0,14
Alabama,Selmont-West Selmont,2040,868,344,206,145,109,1672
Alabama,North Courtland,704,254,162,56,30,63,565
Alabama,Margaret,4752,952,1680,407,81,17,3137
Alabama,Killen,1196,205,562,112,23,52,954
Alabama,McIntosh,431,95,174,26,21,6,322
Alabama,Muscle Shoals,13874,2830,6031,1327,159,917,11264
Alabama,Forkland,794,281,162,36,44,84,607
Alabama,Albertville,21460,4123,8152,2044,284,1289,15892
Alabama,Hartford,2604,627,895,337,116,178,2153
Alabama,Gilbertown,166,48,48,20,3,12,131
Alabama,Lisman,627,150,219,72,17,34,492
Alabama,Daleville,5113,1225,1632,780,142,383,4162
Alabama,Fairfield,10790,4176,2313,1343,375,847,9054
Alabama,Douglas,1077,212,374,100,45,49,780
Alabama,Town Creek,1136,173,386,186,49,55,849
Alabama,Leeds,12348,2374,5454,1225,133,657,9843
Alabama,Lipscomb,2024,599,611,233,57,131,1631
Alabama,Sumiton,2586,460,989,384,31,183,2047
Alabama,West Jefferson,465,61,190,57,2,45,355
Alabama,Needham,113,22,58,11,1,11,103
Alabama,Silas,613,169,215,66,16,35,501
Alabama,Jacksonville,12654,5559,3347,1090,280,530,10806
Alabama,Weaver,3076,443,1346,281,66,182,2318
Alabama,Gordon,237,79,87,19,5,26,216
Alabama,Faunsdale,32,19,5,4,0,4,32
Alabama,Ariton,697,203,186,83,12,70,554
Alabama,Clayhatchee,513,96,208,74,20,18,416
Alabama,Level Plains,2478,502,1192,135,37,94,1960
Alabama,Newbern,203,41,95,10,0,14,160
Alabama,Phil Campbell,1513,282,492,167,33,92,1066
Alabama,Blue Ridge,1602,221,791,101,0,212,1325
Alabama,Millbrook,15160,3675,6214,1407,143,549,11988
Alabama,Prattville,35657,7369,15730,3383,332,1627,28441
Alabama,Wetumpka,8117,2321,2706,1073,100,681,6881
Alabama,Rockford,714,167,175,108,77,57,584
Alabama,Concord,1690,454,756,136,48,80,1474
Alabama,Adamsville,4374,981,1582,483,86,346,3478
Alabama,Parrish,1108,269,382,113,21,65,850
Alabama,Flomaton,1695,462,441,252,33,94,1282
Alabama,Five Points,258,81,80,31,2,27,221
Alabama,Oxford,21208,4160,9216,2226,281,1158,17041
Alabama,Cowarts,2223,520,904,192,34,104,1754
Alabama,Prichard,21927,7998,4393,1883,1114,1639,17027
Alabama,Satsuma,6151,895,3021,521,86,437,4960
Alabama,Maytown,328,69,135,29,4,29,266
Alabama,Morris,1831,295,935,199,5,117,1551
Alabama,Pleasant Grove,10185,2064,4449,1264,66,599,8442
Alabama,Glencoe,5120,535,2862,507,0,296,4200
Alabama,Hokes Bluff,4271,870,1670,577,25,292,3434
Alabama,Gordonville,185,66,28,33,14,19,160
Alabama,Lockhart,282,66,96,49,6,17,234
Alabama,Autaugaville,821,299,305,71,24,73,772
Alabama,Arab,8234,1570,3347,1047,141,629,6734
Alabama,Pell City,13593,2834,5718,1973,203,618,11346
Alabama,Rogersville,1177,265,451,142,36,90,984
Alabama,Sheffield,8986,2145,3007,1298,161,819,7430
Alabama,Brilliant,1037,210,364,124,20,75,793
Alabama,Brewton,5263,1155,1790,702,136,495,4278
Alabama,Harvest,5700,1253,2293,545,192,158,4441
Alabama,Eclectic,1042,276,308,134,14,53,785
Alabama,Owens Cross Roads,2029,456,882,235,16,143,1732
Alabama,Brookwood,2192,433,983,225,34,98,1773
Alabama,Walnut Grove,917,221,367,88,27,70,773
Alabama,Dothan,67872,17168,23889,7854,1449,4136,54496
Alabama,Kinsey,2211,598,750,221,90,95,1754
Alabama,Theodore,6483,1181,2476,662,91,298,4708
Alabama,Eldridge,134,35,58,1,0,7,101
Alabama,Jasper,13727,2813,5248,1496,320,1006,10883
Alabama,Kansas,187,43,67,15,11,15,151
Alabama,Fultondale,9097,1634,4140,957,149,534,7414
Alabama,Foley,17818,4468,6216,2378,325,2053,15440
Alabama,Underwood-Petersville,3196,507,1543,338,49,245,2682
Alabama,Guin,2561,555,1045,371,87,161,2219
Alabama,Daphne,25361,5600,10428,2692,234,1086,20040
Alabama,Silverhill,633,79,331,72,4,70,556
Alabama,Leesburg,1092,143,571,98,10,59,881
Alabama,Rainsville,5018,955,2062,619,97,281,4014
Alabama,Piedmont,4651,783,1979,510,103,417,3792
Alabama,Huntsville,193663,54564,71169,20242,3302,9661,158938
Alabama,Castleberry,510,130,167,58,34,50,439
Alabama,Abbeville,2582,720,915,239,72,286,2232
Alabama,Greenville,7714,2277,2127,848,215,478,5945
Alabama,Evergreen,3705,1316,800,353,66,318,2853
Alabama,East Brewton,2963,922,869,242,158,159,2350
Alabama,Hurtsboro,551,127,196,68,32,48,471
Alabama,Haleburg,132,28,80,5,6,1,120
Alabama,Newville,402,77,131,57,13,52,330
Alabama,Louisville,496,129,167,44,32,28,400
Alabama,Orrville,175,66,63,21,9,9,168
Alabama,Cuba,410,46,206,48,20,32,352
Alabama,Gainesville,161,53,47,16,2,2,120
Alabama,Libertyville,85,11,43,12,0,1,67
Alabama,Alabaster,32878,6512,15199,2222,402,1246,25581
Alabama,Harpersville,1506,245,669,153,60,92,1219
Alabama,Gantt,128,10,74,13,0,15,112
Alabama,Glen Allen,435,66,188,65,2,43,364
Alabama,Franklin,186,41,76,32,7,5,161
Alabama,Blue Springs,95,18,54,6,6,4,88
Alabama,Hobson City,724,271,221,43,30,42,607
Alabama,Cottonwood,1291,239,418,172,24,133,986
Alabama,Chickasaw,5837,1617,1345,618,210,310,4100
Alabama,Saraland,14268,3145,5842,1332,291,748,11358
Alabama,Cordova,1927,358,782,256,36,180,1612
Alabama,New Market,1205,222,522,38,0,119,901
Alabama,Repton,288,55,96,17,9,47,224
Alabama,New Hope,2856,484,1212,416,52,105,2269
Alabama,Gurley,738,147,272,103,9,61,592
Alabama,Auburn,62996,29603,19275,3281,442,1018,53619
Alabama,Opelika,29798,8191,10602,3083,715,1675,24266
Alabama,Leighton,1088,382,293,150,27,66,918
Alabama,Fort Rucker,5134,1214,2156,108,3,26,3507
Alabama,Midland City,2144,512,682,177,80,145,1596
Alabama,Black,197,22,121,13,0,3,159
Alabama,Geneva,4379,1084,1570,554,135,328,3671
Alabama,Jacksons' Gap,779,109,379,141,12,33,674
Alabama,Maplesville,752,159,233,131,23,33,579
Alabama,Odenville,3751,524,1787,360,107,272,3050
Alabama,Brundidge,2295,892,528,217,65,181,1883
Alabama,Roanoke,5941,1387,1886,774,157,733,4937
Alabama,Rock Mills,486,213,140,12,16,46,427
Alabama,Russellville,9711,2508,3464,727,252,585,7536
Alabama,Vina,363,67,149,65,2,15,298
Alabama,Providence,179,61,88,18,2,5,174
Alabama,Grant,933,118,435,96,29,59,737
Alabama,Daviston,186,30,97,11,2,21,161
Alabama,Clanton,8724,2213,2955,1241,39,664,7112
Alabama,Moores Mill,6815,1427,2827,755,149,510,5668
Alabama,Excel,1013,211,420,91,6,32,760
Alabama,Pine Hill,782,274,251,33,41,48,647
Alabama,Spruce Pine,149,48,28,73,0,0,149
Alabama,Woodstock,2371,676,966,163,44,110,1959
Alabama,Westover,1603,161,777,196,9,47,1190
Alabama,Valley Grande,3773,826,1742,228,72,130,2998
Alabama,Center Point,16460,4650,4429,2000,634,837,12550
Alabama,Smiths Station,5349,1137,2190,604,157,350,4438
Alabama,Gadsden,35624,10308,10499,4944,926,2929,29606
Alabama,Abanda,218,16,98,0,0,49,163
Alabama,Mount Vernon,1243,446,433,112,43,89,1123
Alabama,Pennington,333,81,116,54,11,31,293
Alabama,Union,295,151,48,27,7,37,270
Alabama,Red Bay,3102,649,967,368,61,343,2388
Alabama,Stockton,709,105,259,87,49,13,513
Alabama,Stapleton,1196,111,695,100,21,60,987
Alabama,Perdido,751,142,276,166,12,16,612
Alabama,Samson,2086,422,625,289,61,156,1553
Alabama,Lillian,1330,218,814,104,0,62,1198
Alabama,Axis,1473,256,728,43,0,108,1135
Alabama,Belgreen,76,0,28,26,0,6,60
Alabama,Chelsea,12643,1661,6310,796,65,316,9148
Alabama,Ashville,2418,596,955,205,31,197,1984
Alabama,Ashland,1943,396,583,311,80,243,1613
Alabama,Ashford,2346,586,932,179,57,138,1892
Alabama,Carlisle-Rockledge,2391,509,1017,383,8,63,1980
Alabama,Calvert,957,194,88,154,0,186,622
Alabama,Ballplay,1458,250,749,119,0,54,1172
Alabama,Bucks,68,0,68,0,0,0,68
Alabama,Brook Highland,7116,2189,2880,753,124,199,6145
Alabama,Bristow Cove,769,142,268,99,0,66,575
Alabama,Brantleyville,987,255,283,159,0,51,748
Alabama,Boykin,134,85,8,0,29,6,128
Alabama,Belle Fontaine,532,113,197,108,0,25,443
Alabama,Bellamy,380,189,73,47,17,54,380
Alabama,Broomtown,198,49,82,8,0,18,157
Alabama,Bon Secour,1011,86,464,273,0,84,907
Alabama,Kimberly,3073,534,1500,194,13,147,2388
Alabama,Cottondale,3469,933,1189,301,53,205,2681
Alabama,Stewartville,1627,339,759,129,26,189,1442
Alabama,Sterrett,866,127,359,209,10,74,779
Alabama,Tidmore Bend,1237,200,663,92,28,62,1045
Alabama,Standing Rock,153,7,111,0,0,0,118
Alabama,Spring Garden,185,58,92,16,0,19,185
Alabama,Sims Chapel,85,34,51,0,0,0,85
Alabama,Tibbie,73,8,21,0,16,0,45
Alabama,Shoal Creek,1398,227,728,71,6,61,1093
Alabama,Loachapoka,251,91,80,18,18,3,210
Alabama,Dadeville,3115,817,1076,318,80,228,2519
Alabama,Pickensville,883,251,271,68,12,67,669
Alabama,Talladega Springs,188,37,58,27,11,12,145
Alabama,Calera,13557,2361,5823,1457,227,432,10300
Alabama,Coosada,1116,240,474,93,38,82,927
Alabama,Vernon,1811,441,691,228,21,125,1506
Alabama,Uriah,307,56,169,14,0,14,253
Alabama,Vandiver,1016,193,447,135,23,45,843
Alabama,Vinegar Bend,247,8,137,0,0,9,154
Alabama,Semmes,4869,1010,2250,453,139,463,4315
Alabama,Morrison Crossroads,253,10,165,52,0,0,227
Alabama,Joppa,690,196,293,28,0,162,679
Alabama,Riverside,2500,352,1080,280,14,155,1881
Alabama,Good Hope,2793,447,1233,250,5,92,2027
Alabama,Moody,12752,2253,5454,1330,257,707,10001
Alabama,Kellyton,196,45,76,26,1,21,169
Alabama,Twin,457,88,220,41,14,38,401
Alabama,Pinson,7121,1314,3559,656,42,348,5919
Alabama,Munford,1305,272,415,209,35,110,1041
Alabama,Cusseta,112,14,63,5,2,13,97
Alabama,Whitesboro,2352,452,987,252,8,157,1856
Alabama,White Plains,770,103,416,58,0,73,650
Alabama,Whatley,178,21,140,0,0,17,178
Alabama,Weogufka,301,53,156,14,0,0,223
Alabama,Bakerhill,278,22,154,16,14,10,216
Alabama,Butler,2136,455,721,138,128,173,1615
Alabama,Camden,2142,762,558,196,22,138,1676
Alabama,Clio,1018,219,278,87,37,106,727
Alabama,Millerville,158,26,50,76,0,6,158
Alabama,Megargel,12,0,12,0,0,0,12
Alabama,Marbury,1573,338,637,160,22,60,1217
Alabama,Malcolm,358,242,0,11,0,0,253
Alabama,Macedonia,197,37,49,65,6,28,185
Alabama,Lookout Mountain,1805,490,722,144,0,122,1478
Alabama,Mount Olive CDP (Coosa County),315,0,182,23,0,25,230
Alabama,Leroy,685,138,257,138,0,55,588
Alabama,Holtville,4133,568,1951,367,137,210,3233
Alabama,Hollis Crossroads,591,104,225,80,0,62,471
Alabama,Hollins,892,132,454,58,0,101,745
Alabama,Hobson,147,40,91,9,0,7,147
Alabama,Hissop,461,176,116,89,0,80,461
Alabama,Highland Lakes,5500,636,3163,260,0,239,4298
Alabama,Ivalee,886,151,461,10,33,52,707
Alabama,Mount Olive CDP (Jefferson County),4021,702,2045,332,10,210,3299
Alabama,New Union,1091,147,577,51,0,64,839
Alabama,Movico,88,8,46,0,17,0,71
Alabama,Penton,68,5,16,4,13,18,56
Alabama,Perdido Beach,550,85,202,149,9,69,514
Alabama,Peterman,139,9,83,6,0,0,98
Alabama,Pine Level,4574,879,2204,279,124,93,3579
Alabama,Putnam,60,0,38,4,6,0,48
Alabama,Ray,257,57,81,60,0,12,210
Alabama,Redland,4242,618,2348,211,0,109,3286
Alabama,Reeltown,306,40,143,45,0,0,228
Alabama,Rockville,16,0,9,7,0,0,16
Alabama,St. Stephens,394,20,157,129,0,39,345
Alabama,Shelby,1305,340,383,78,65,92,958
Alabama,Magnolia Springs,815,155,498,44,9,56,762
Alabama,Clay,9653,1832,4330,688,45,651,7546
Alabama,Nances Creek,494,43,205,25,7,43,323
Alabama,Nanafalia,42,14,24,0,0,4,42
Alabama,Hatton,106,0,70,30,0,6,106
Alabama,Grimes,731,175,217,131,48,15,586
Alabama,Hackneyville,337,48,192,37,0,9,286
Alabama,Graham,84,22,62,0,0,0,84
Alabama,Uniontown,1969,747,288,128,106,199,1468
Alabama,Stevenson,1847,347,743,203,45,112,1450
Alabama,Springville,4195,502,2102,404,0,243,3251
Alabama,Reform,1907,619,440,225,83,189,1556
Alabama,Pike Road,8884,1412,4747,504,84,189,6936
Alabama,Jemison,2637,441,1003,175,71,182,1872
Alabama,Carlton,36,23,6,7,0,0,36
Alabama,Indian Springs Village,2590,429,1457,111,12,94,2103
Alabama,Goodwater,1311,375,306,197,53,128,1059
Alabama,Fruithurst,254,42,132,16,4,16,210
Alabama,Florala,1549,313,543,271,48,255,1430
Alabama,Eutaw,2722,913,708,252,209,369,2451
Alabama,Creola,1887,400,742,187,46,105,1480
Alabama,Coaling,1635,312,726,165,15,44,1262
Alabama,Henagar,2059,341,942,326,37,78,1724
Alabama,Catherine,21,0,21,0,0,0,21
Alabama,Choccolocco,2396,341,1407,137,23,158,2066
Alabama,Chunchula,142,22,75,28,0,7,132
Alabama,Gallant,743,169,382,14,15,24,604
Alabama,Fruitdale,224,74,34,24,17,16,165
Alabama,Fredonia,220,18,149,15,0,0,182
Alabama,Fitzpatrick,41,0,23,0,0,18,41
Alabama,Fayetteville,1432,178,915,104,0,0,1197
Alabama,Fairford,64,7,57,0,0,0,64
Alabama,Eunola,239,0,180,26,19,0,225
Alabama,Emerald Mountain,3200,417,1510,194,16,45,2182
Alabama,Egypt,774,142,347,85,0,35,609
Alabama,East Point,97,24,32,41,0,0,97
Alabama,Dunnavant,914,120,451,107,15,65,758
Alabama,Delta,219,23,178,0,0,0,201
Alabama,Deer Park,134,59,39,15,0,0,113
Alabama,Cullomburg,155,40,61,21,0,0,122
Alabama,Coats Bend,1600,332,694,207,36,70,1339
Alabama,Gulfcrest,321,83,157,8,0,0,248
Alabama,Panola,33,15,0,18,0,0,33
Alabama,Crossville,1945,371,862,158,16,235,1642
Alabama,Ranburne,539,65,237,68,0,47,417
Alabama,Emelle,69,24,31,4,0,5,64
Alabama,Woodville,821,175,272,100,19,46,612
Alabama,Montevallo,6654,3243,1829,592,69,290,6023
Alabama,Myrtlewood,122,37,53,16,0,8,114
Alabama,Chatom,980,317,342,138,16,48,861
Alabama,Millry,602,130,270,68,1,52,521
Alabama,Millport,1061,188,450,112,10,154,914
Alabama,Sulligent,2083,294,810,244,84,156,1588
Alabama,Anderson,254,68,114,18,0,31,231
Alabama,Hackleburg,1341,225,544,159,38,129,1095
Alabama,Trinity,2972,399,1275,300,14,126,2114
Alabama,Gulf Shores,12033,2665,5476,1810,87,880,10918
Alabama,Summerdale,1026,228,415,118,9,40,810
Alabama,Hammondville,526,66,254,61,0,45,426
Alabama,Slocomb,1953,402,733,255,19,142,1551
Alabama,Hollywood,1088,242,364,154,77,85,922
Alabama,Livingston,3410,1845,688,157,23,256,2969
Alabama,Holly Pond,953,121,400,161,12,53,747
Alabama,Colony,434,99,126,69,27,27,348
Alabama,Coker,682,162,325,66,3,30,586
Alabama,Troy,19141,9395,4391,1245,146,998,16175
Alabama,Jackson,4851,1306,1698,347,253,297,3901
Alabama,Dodge City,554,68,212,95,11,47,433
Alabama,Beaverton,241,19,105,45,4,28,201
Alabama,Detroit,181,42,87,22,10,10,171
Alabama,Kennedy,424,69,222,40,20,29,380
Alabama,Hytop,394,58,190,36,2,26,312
Alabama,Pisgah,761,162,235,136,36,56,625
Alabama,Coffeeville,420,134,102,49,22,35,342
Alabama,Blountsville,1838,349,623,239,29,137,1377
Alabama,Locust Fork,1631,299,753,156,22,92,1322
Alabama,Smoke Rise,2360,205,1355,230,0,62,1852
Alabama,Thomasville,3997,1181,1661,193,85,310,3430
Alabama,Memphis,32,2,14,3,6,4,29
Alabama,Hanceville,3340,879,1071,541,79,505,3075
Alabama,Spanish Fort,8324,1669,3453,749,25,632,6528
Alabama,Our Town,519,32,350,73,0,64,519
Alabama,Geiger,314,66,122,19,4,8,219
Alabama,Sylacauga,12397,3262,4025,1278,329,731,9625
Alabama,Lester,190,37,100,19,7,4,167
Alabama,Grove Hill,1573,436,506,162,36,94,1234
Alabama,Headland,4661,909,1993,462,54,233,3651
Alabama,Enterprise,27859,5628,11531,2729,726,1382,21996
Alabama,Hodges,324,60,153,27,16,15,271
Alabama,Collinsville,2074,588,647,207,37,192,1671
Alabama,Lynn,562,89,204,91,16,75,475
Alabama,Centre,3505,789,1234,565,77,414,3079
Alabama,Moulton,3283,746,1296,411,62,296,2811
Alabama,Ridgeville,118,56,31,8,3,12,110
Alabama,Cullman,15558,3152,6041,2121,136,1040,12490
Alabama,Ragland,1899,332,807,197,23,129,1488
Alabama,Epes,482,201,173,85,4,9,472
Alabama,Petrey,48,5,16,7,7,1,36
Alabama,Union Springs,3596,1339,966,190,152,133,2780
Alabama,Dozier,367,124,97,50,4,27,302
Alabama,Beatrice,310,112,65,35,16,15,243
Alabama,Greensboro,2870,1288,505,299,33,183,2308
Alabama,Cedar Bluff,2067,274,920,263,78,172,1707
Alabama,Pinckard,458,100,203,61,8,34,406
Alabama,Union Grove,75,8,44,4,3,7,66
Alabama,Riverview,85,14,29,10,2,14,69
Alabama,Phenix City,36641,10306,11666,3930,1021,1773,28696
Alabama,Cleveland,1167,189,678,84,4,65,1020
Alabama,Sanford,189,34,93,23,0,11,161
Alabama,Cherokee,814,135,351,112,42,51,691
Alabama,Dora,2200,371,831,246,71,149,1668
Alabama,Selma,18804,6778,4230,1819,594,1301,14722
Alabama,Paint Rock,184,23,84,31,0,10,148
Alabama,Hayden,1252,255,556,135,16,95,1057
Alabama,McMullen,5,0,0,2,0,3,5
Alabama,Thomaston,340,122,107,27,8,9,273
Alabama,Southside,8788,1607,4436,814,77,432,7366
Alaska,Nelson Lagoon,74,31,35,4,0,4,74
Alaska,Chiniak,0,0,0,0,0,0,0
Alaska,Womens Bay,967,195,461,50,18,6,730
Alaska,Ouzinkie,171,71,46,12,0,9,138
Alaska,Larsen Bay,52,20,10,6,0,11,47
Alaska,Savoonga,921,368,182,14,15,51,630
Alaska,Atmautluak,209,66,52,3,11,10,142
Alaska,Brevig Mission,407,168,75,5,4,13,265
Alaska,Kodiak Station,1354,195,618,9,5,12,839
Alaska,Eek,491,136,161,5,7,17,326
Alaska,Crooked Creek,90,39,23,4,0,2,68
Alaska,Bethel,6424,2185,1800,441,158,152,4736
Alaska,Kalifornsky,8134,1344,3822,790,74,320,6350
Alaska,Beluga,4,2,0,0,0,2,4
Alaska,Nome,3813,1197,1117,368,78,112,2872
Alaska,Funny River,1251,205,573,148,15,63,1004
Alaska,Chevak,1144,513,209,36,5,37,800
Alaska,Cantwell,183,48,62,33,0,15,158
Alaska,Emmonak,761,304,163,23,9,30,529
Alaska,Halibut Cove,71,18,48,0,0,5,71
Alaska,Old Harbor,249,132,39,22,3,15,211
Alaska,Akhiok,57,20,15,2,6,0,43
Alaska,Stebbins,473,164,108,11,12,28,323
Alaska,St. Michael,468,176,76,8,7,15,282
Alaska,Diomede,94,43,6,4,0,0,53
Alaska,Game Creek,0,0,0,0,0,0,0
Alaska,Seldovia Village,164,28,87,21,3,4,143
Alaska,Primrose,99,29,51,0,19,0,99
Alaska,Kenai,7687,1758,2759,975,209,351,6052
Alaska,Fritz Creek,1956,519,809,210,35,63,1636
Alaska,Attu Station,17,11,0,6,0,0,17
Alaska,Wainwright,508,157,151,13,8,19,348
Alaska,Ferry,16,4,12,0,0,0,16
Alaska,Kasilof,531,141,143,0,48,25,357
Alaska,Salcha,995,244,520,23,0,11,798
Alaska,Kwethluk,653,249,133,20,21,28,451
Alaska,Manley Hot Springs,80,16,38,5,0,3,62
Alaska,Fox,566,194,149,205,0,18,566
Alaska,Fairbanks,31677,9031,12005,2589,466,837,24928
Alaska,Ester,1312,511,542,66,4,48,1171
Alaska,Pleasant Valley,569,47,301,0,0,0,348
Alaska,Tenakee Springs,155,15,84,21,0,5,125
Alaska,Chenega,48,22,10,0,7,1,40
Alaska,Nelchina,171,0,82,0,0,0,82
Alaska,Copper Center,299,133,44,43,4,16,240
Alaska,Mendeltna,26,17,0,9,0,0,26
Alaska,Silver Springs,120,18,55,4,0,2,79
Alaska,Alakanuk,837,279,199,5,7,43,533
Alaska,Anderson,137,57,51,14,0,2,124
Alaska,Nuiqsut,469,183,100,11,1,30,325
Alaska,False Pass,78,31,20,9,6,0,66
Alaska,McGrath,283,73,89,27,8,7,204
Alaska,Tununak,339,121,73,10,9,9,222
Alaska,Big Lake,2765,636,1243,300,9,179,2367
Alaska,New Stuyahok,557,170,168,13,9,15,375
Alaska,Nightmute,189,75,40,0,4,11,130
Alaska,Galena,510,176,159,34,7,23,399
Alaska,Coldfoot,132,32,78,22,0,0,132
Alaska,Arctic Village,153,62,24,12,2,5,105
Alaska,Kotzebue,3288,1119,895,257,50,117,2438
Alaska,Ambler,299,140,58,5,0,12,215
Alaska,Ekwok,80,30,21,5,0,4,60
Alaska,Aleknagik,204,77,44,16,2,17,156
Alaska,Venetie,141,58,52,2,5,3,120
Alaska,Red Dog Mine,82,34,48,0,0,0,82
Alaska,Tanana,242,89,59,20,7,17,192
Alaska,Rampart,60,11,5,11,0,4,31
Alaska,Grayling,176,73,32,10,3,5,123
Alaska,Fort Yukon,533,202,112,48,19,31,412
Alaska,Stony River,41,14,8,2,0,0,24
Alaska,Akiak,416,122,111,3,4,11,251
Alaska,Kiana,262,94,48,17,10,10,179
Alaska,Kivalina,688,247,128,55,1,16,447
Alaska,Anaktuvuk Pass,274,129,52,8,3,12,204
Alaska,Angoon,523,142,180,101,2,13,438
Alaska,Dry Creek,133,60,52,0,9,12,133
Alaska,Susitna,0,0,0,0,0,0,0
Alaska,Lakes,10098,2240,4354,764,205,241,7804
Alaska,Lake Louise,9,0,0,0,0,9,9
Alaska,Gateway,7037,1604,3005,534,77,160,5380
Alaska,Fishhook,6203,1672,2435,554,19,124,4804
Alaska,Farm Loop,1137,323,468,61,34,34,920
Alaska,Tuluksak,415,144,119,9,6,10,288
Alaska,Mekoryuk,226,76,69,14,3,9,171
Alaska,Kongiganak,441,146,123,14,6,8,297
Alaska,Kasigluk,574,190,131,18,23,18,380
Alaska,Aniak,525,141,184,38,9,19,391
Alaska,Akutan,758,278,351,79,19,17,744
Alaska,Ruby,207,63,47,14,0,7,131
Alaska,Koliganek,161,43,62,2,2,7,116
Alaska,Kaltag,172,86,55,8,1,4,154
Alaska,Four Mile Road,4,4,0,0,0,0,4
Alaska,Evansville,11,5,0,6,0,0,11
Alaska,Knik-Fairview,17513,4054,6858,1700,148,538,13298
Alaska,Wasilla,9675,2412,3139,1059,228,570,7408
Alaska,Shageluk,75,35,12,2,2,6,57
Alaska,Takotna,23,5,5,0,3,2,15
Alaska,Dillingham,2250,640,714,189,86,89,1718
Alaska,Quinhagak,796,235,276,16,27,19,573
Alaska,Tanaina,10520,2677,4045,778,122,216,7838
Alaska,Pilot Station,576,218,115,6,0,17,356
Alaska,Port Lions,190,47,91,6,9,17,170
Alaska,Mountain Village,828,357,145,19,27,27,575
Alaska,Scammon Bay,585,193,119,11,10,15,348
Alaska,Point Hope,592,194,128,13,4,23,362
Alaska,Hoonah,800,252,250,102,23,42,669
Alaska,Stevens Village,11,7,0,0,0,2,9
Alaska,Glennallen,289,18,139,0,0,0,157
Alaska,Buckland,608,211,156,15,10,23,415
Alaska,Deering,154,52,28,7,6,8,101
Alaska,Central,47,9,26,12,0,0,47
Alaska,Homer,5607,1320,2352,596,66,250,4584
Alaska,Soldotna,4589,1313,1650,671,108,216,3958
Alaska,Aleneva,27,15,12,0,0,0,27
Alaska,Salamatof,1015,371,312,159,21,25,888
Alaska,Kodiak,6107,1812,2288,618,98,174,4990
Alaska,Nikiski,4575,1125,1796,446,66,226,3659
Alaska,Cohoe,1217,201,569,194,22,62,1048
Alaska,Nikolaevsk,261,47,131,35,0,6,219
Alaska,Chistochina,85,47,6,14,0,8,75
Alaska,Chitina,98,46,7,25,0,1,79
Alaska,Mentasta Lake,205,57,54,21,17,14,163
Alaska,Tonsina,28,0,0,18,0,10,28
Alaska,Whittier,311,107,79,40,8,8,242
Alaska,Huslia,404,132,113,11,6,18,280
Alaska,Seldovia,229,50,110,30,0,12,202
Alaska,Butte,3929,998,1629,360,45,98,3130
Alaska,Eielson AFB,2979,611,1414,82,69,8,2184
Alaska,Circle,74,20,14,6,1,1,42
Alaska,Chalkyitsik,115,51,27,5,5,3,91
Alaska,Livengood,4,0,0,4,0,0,4
Alaska,Minto,229,118,36,16,0,0,170
Alaska,Nikolai,114,69,23,7,3,3,105
Alaska,Palmer,6978,2108,2072,771,124,251,5326
Alaska,College,13709,4822,4897,1267,154,175,11315
Alaska,Koyukuk,62,31,14,2,2,2,51
Alaska,Newtok,360,140,83,4,3,11,241
Alaska,Platinum,13,5,6,2,0,0,13
Alaska,Houston,2172,493,763,251,42,86,1635
Alaska,Petersville,0,0,0,0,0,0,0
Alaska,Sutton-Alpine,1586,528,489,258,51,55,1381
Alaska,Beaver,46,29,3,7,0,5,44
Alaska,Bettles,66,22,22,22,0,0,66
Alaska,Nunapitchuk,869,275,252,17,11,26,581
Alaska,Hughes,90,37,21,2,3,4,67
Alaska,Napaskiak,356,105,88,7,6,21,227
Alaska,Toksook Bay,527,194,143,6,11,14,368
Alaska,Craig,1263,313,468,156,23,47,1007
Alaska,Mosquito Lake,183,20,40,94,0,0,154
Alaska,Tetlin,144,73,18,9,0,3,103
Alaska,Pope-Vannoy Landing,0,0,0,0,0,0,0
Alaska,Perryville,86,41,17,5,1,3,67
Alaska,Ivanof Bay,0,0,0,0,0,0,0
Alaska,Iliamna,63,12,30,4,0,0,46
Alaska,Levelock,76,30,1,11,1,7,50
Alaska,Alatna,4,2,0,0,2,0,4
Alaska,Point MacKenzie,976,478,285,91,54,9,917
Alaska,Meadow Lakes,7656,1799,2603,825,151,317,5695
Alaska,Lazy Mountain,1800,360,768,203,38,45,1414
Alaska,Chase,9,9,0,0,0,0,9
Alaska,Napakiak,369,136,89,13,12,20,270
Alaska,Goodnews Bay,192,67,39,3,2,12,123
Alaska,Sterling,5321,972,2539,499,78,272,4360
Alaska,Hope,55,0,38,6,0,0,44
Alaska,Elfin Cove,12,0,12,0,0,0,12
Alaska,Hobart Bay,0,0,0,0,0,0,0
Alaska,Shishmaref,525,209,105,10,5,21,350
Alaska,Teller,182,83,25,6,3,10,127
Alaska,Manokotak,824,282,311,15,11,22,641
Alaska,Kotlik,811,292,140,28,31,25,516
Alaska,Chignik Lake,51,15,23,1,0,5,44
Alaska,St. Mary's,640,244,109,32,22,28,435
Alaska,Kaktovik,178,79,29,4,7,7,126
Alaska,Anchor Point,2093,439,902,342,17,81,1781
Alaska,Cooper Landing,569,23,322,24,0,22,391
Alaska,Ninilchik,749,125,369,65,13,52,624
Alaska,Diamond Ridge,1285,255,609,117,11,40,1032
Alaska,Fox River,594,101,218,12,3,9,343
Alaska,Healy,1022,293,441,116,20,0,870
Alaska,Newhalen,121,46,19,8,5,9,87
Alaska,Pedro Bay,20,11,7,1,0,1,20
Alaska,Pilot Point,83,23,34,3,0,5,65
Alaska,South Naknek,41,16,13,5,2,5,41
Alaska,Ketchikan,8224,2297,2978,1009,110,352,6746
Alaska,Coffman Cove,130,17,76,20,0,13,126
Alaska,Excursion Inlet,33,21,4,8,0,0,33
Alaska,Egegik,83,11,48,11,0,8,78
Alaska,Port Heiden,78,22,29,5,2,4,62
Alaska,Port Protection,38,10,0,28,0,0,38
Alaska,Portage Creek,0,0,0,0,0,0,0
Alaska,Twin Hills,63,27,4,3,8,8,50
Alaska,Kobuk,143,54,24,1,1,1,81
Alaska,Atqasuk,164,71,24,2,2,11,110
Alaska,Kipnuk,613,190,181,17,12,21,421
Alaska,Kwigillingok,379,87,131,6,4,20,248
Alaska,Lower Kalskag,283,89,75,5,5,14,188
Alaska,Togiak,705,251,164,39,14,10,478
Alaska,Upper Kalskag,222,74,54,9,1,10,148
Alaska,Metlakatla,1635,480,528,131,26,65,1230
Alaska,Karluk,44,24,13,2,0,0,39
Alaska,Eagle,74,16,37,8,4,3,68
Alaska,Northway Junction,37,19,11,3,0,0,33
Alaska,Northway Village,100,47,21,2,0,9,79
Alaska,Tanacross,141,63,37,9,2,10,121
Alaska,Juneau city and borough,32330,8553,13224,3179,513,1119,26588
Alaska,Kenny Lake,9,0,0,9,0,0,9
Alaska,Klawock,876,233,278,125,16,47,699
Alaska,Tyonek,344,156,82,16,8,14,276
Alaska,Gakona,148,33,42,23,0,3,101
Alaska,Tolsona,0,0,0,0,0,0,0
Alaska,Valdez,3870,941,1691,323,0,52,3007
Alaska,Klukwan,47,16,13,14,0,4,47
Alaska,Gambell,601,258,117,12,14,31,432
Alaska,Golovin,128,38,31,9,0,5,83
Alaska,Cordova,3055,639,1413,517,33,44,2646
Alaska,Harding-Birch Lakes,209,10,164,13,0,18,205
Alaska,Chefornak,501,188,134,10,3,8,343
Alaska,Kake,578,195,198,48,11,28,480
Alaska,Happy Valley,656,110,352,67,0,24,553
Alaska,King Cove,1074,353,485,47,15,50,950
Alaska,Hooper Bay,1101,399,178,39,12,20,648
Alaska,Ridgeway,2617,556,1237,194,13,34,2034
Alaska,Allakaket,170,82,35,3,3,8,131
Alaska,St. Paul,425,185,96,52,2,20,355
Alaska,Slana,0,0,0,0,0,0,0
Alaska,Point Baker,0,0,0,0,0,0,0
Alaska,Gulkana,52,38,0,5,0,3,46
Alaska,Naukati Bay,112,38,42,22,0,0,102
Alaska,Crown Point,58,8,25,6,0,0,39
Alaska,Tazlina,354,126,84,36,4,9,259
Alaska,Port Graham,192,92,41,15,1,10,159
Alaska,Chignik,61,8,36,3,0,0,47
Alaska,Anchorage municipal,296112,80133,114952,27898,3758,7848,234589
Alaska,Deltana,2613,506,1135,169,11,128,1949
Alaska,Two Rivers,399,156,111,0,0,0,267
Alaska,Nenana,383,105,130,38,4,19,296
Alaska,Mertarvik,0,0,0,0,0,0,0
Alaska,Loring,0,0,0,0,0,0,0
Alaska,Goldstream,4389,1514,1919,256,0,34,3723
Alaska,Farmers Loop,5535,1237,2572,456,0,134,4399
Alaska,Eureka Roadhouse,0,0,0,0,0,0,0
Alaska,Chena Ridge,5903,1277,2738,319,39,112,4485
Alaska,Badger,18792,3533,8644,1748,276,474,14675
Alaska,Clark's Point,48,15,11,6,0,0,32
Alaska,Haines,1870,326,911,148,9,108,1502
Alaska,Wrangell city and borough,2484,487,1103,351,46,121,2108
Alaska,Gustavus,416,77,218,56,0,15,366
Alaska,Nunam Iqua,167,63,31,5,0,13,112
Alaska,Adak,203,71,38,19,5,5,138
Alaska,Sleetmute,83,28,22,3,4,4,61
Alaska,Selawik,839,340,127,32,10,26,535
Alaska,Tatitlek,78,46,22,2,0,3,73
Alaska,Lake Minchumina,14,0,12,1,0,1,14
Alaska,Trapper Creek,382,94,137,72,10,8,321
Alaska,Glacier View,208,36,93,21,0,44,194
Alaska,St. George,78,32,21,5,0,7,65
Alaska,Eagle Village,25,10,13,2,0,0,25
Alaska,Dot Lake,0,0,0,0,0,0,0
Alaska,Clam Gulch,197,46,68,29,0,34,177
Alaska,Bear Creek,1465,373,503,177,36,67,1156
Alaska,Sand Point,1372,455,480,130,38,44,1147
Alaska,Pitkas Point,122,48,36,0,0,6,90
Alaska,Whitestone Logging Camp,0,0,0,0,0,0,0
Alaska,White Mountain,186,75,24,17,16,10,142
Alaska,Unalakleet,693,130,269,121,17,24,561
Alaska,Kasaan,75,11,26,11,1,6,55
Alaska,Hyder,15,0,0,15,0,0,15
Alaska,Hollis,127,27,59,16,0,0,102
Alaska,Port Alexander,97,9,54,4,0,0,67
Alaska,Unalaska,4781,1487,1880,456,102,179,4104
Alaska,Saxman,360,123,96,55,14,12,300
Alaska,Nabesna,0,0,0,0,0,0,0
Alaska,Kupreanof,13,0,6,7,0,0,13
Alaska,Port Alsworth,151,41,49,6,0,2,98
Alaska,Chuathbaluk,124,37,37,5,6,2,87
Alaska,Red Devil,21,6,12,0,0,2,20
Alaska,Noorvik,597,215,131,11,28,9,394
Alaska,Ugashik,8,0,0,6,0,1,7
Alaska,Sunrise,40,22,0,18,0,0,40
Alaska,Seward,2770,1142,820,252,40,95,2349
Alaska,Lowell Point,167,142,0,12,0,13,167
Alaska,Holy Cross,183,81,43,10,4,7,145
Alaska,Flat,0,0,0,0,0,0,0
Alaska,Anvik,104,41,19,8,3,4,75
Alaska,Willow,2126,473,876,198,27,74,1648
Alaska,Talkeetna,965,271,307,129,39,24,770
Alaska,Skwentna,42,5,28,4,0,0,37
Alaska,Thorne Bay,614,105,313,58,0,43,519
Alaska,Yakutat,665,206,226,49,12,18,511
Alaska,Nondalton,114,61,18,10,3,7,99
Alaska,Point Possession,0,0,0,0,0,0,0
Alaska,Birch Creek,2,0,0,2,0,0,2
Alaska,Tuntutuliak,566,177,136,27,12,12,364
Alaska,Koyuk,271,85,52,10,3,6,156
Alaska,Naknek,464,78,219,49,5,31,382
Alaska,Marshall,299,106,77,6,3,2,194
Alaska,North Pole,2660,659,1218,160,9,24,2070
Alaska,Moose Creek,794,342,228,112,13,19,714
Alaska,Tok,1160,219,543,60,56,10,888
Alaska,Big Delta,457,151,174,59,0,6,390
Alaska,Prudhoe Bay,1893,318,1239,306,13,17,1893
Alaska,Sitka city and borough,8738,2043,3549,1018,137,392,7139
Alaska,Point Lay,251,97,27,10,5,4,143
Alaska,Willow Creek,0,0,0,0,0,0,0
Alaska,Wales,170,81,16,9,0,5,111
Alaska,Paxson,0,0,0,0,0,0,0
Alaska,Chisana,0,0,0,0,0,0,0
Alaska,Nanwalek,212,64,58,18,7,6,153
Alaska,Moose Pass,357,86,194,31,0,0,311
Alaska,Covenant Life,35,8,27,0,0,0,35
Alaska,Chignik Lagoon,75,22,36,4,0,0,62
Alaska,Nikolski,26,1,15,2,2,0,20
Alaska,Mud Bay,149,0,74,57,0,0,131
Alaska,Edna Bay,34,20,0,9,0,0,29
Alaska,Fort Greely,161,43,69,10,0,0,122
Alaska,Kachemak,488,98,290,50,2,7,447
Alaska,Whale Pass,48,0,36,12,0,0,48
Alaska,McCarthy,0,0,0,0,0,0,0
Alaska,Utqiagvik,4408,1313,1274,273,62,116,3038
Alaska,Pelican,93,29,25,31,3,5,93
Alaska,Wiseman,13,0,7,0,0,0,7
Alaska,Chicken,13,0,13,0,0,0,13
Alaska,Alcan Border,177,34,45,0,0,0,79
Alaska,Russian Mission,318,129,52,7,10,8,206
Alaska,Hydaburg,330,105,82,38,6,18,249
Alaska,Lutak,154,54,0,30,0,0,84
Alaska,Kokhanok,150,74,23,2,3,9,111
Alaska,Igiugig,62,15,16,3,2,6,42
Alaska,Atka,35,15,10,1,0,1,27
Alaska,Healy Lake,4,1,0,0,0,0,1
Alaska,Dot Lake Village,38,14,6,14,0,0,34
Alaska,Delta Junction,1053,286,419,66,4,22,797
Alaska,Nulato,257,101,68,9,6,26,210
Alaska,Port Clarence,43,43,0,0,0,0,43
Alaska,King Salmon,385,82,171,35,9,8,305
Alaska,Shaktoolik,294,86,82,14,4,10,196
Alaska,Knik River,833,221,295,123,4,35,678
Alaska,Chickaloon,241,30,160,22,4,17,233
Alaska,Buffalo Soapstone,871,245,325,96,20,12,698
Alaska,Oscarville,64,17,17,0,0,0,34
Alaska,Lime Village,8,6,0,0,0,0,6
Alaska,Akiachak,567,160,167,4,17,16,364
Alaska,Shungnak,288,120,42,10,0,4,176
Alaska,Noatak,422,165,112,16,2,9,304
Alaska,Cold Bay,52,13,29,2,0,3,47
Alaska,Elim,303,111,65,14,0,11,201
Alaska,Denali Park,856,398,324,69,44,5,840
Alaska,Petersburg,3106,763,1299,261,26,155,2504
Alaska,Whitestone,80,11,47,0,0,0,58
Alaska,South Van Horn,552,193,98,103,22,17,433
Alaska,Susitna North,882,201,372,171,0,22,766
Alaska,Steele Creek,7380,1543,3581,459,108,99,5790
Alaska,Northway,102,66,10,3,0,0,79
Alaska,Skagway,1005,336,383,102,16,29,866
Arizona,Bowie,363,72,187,28,19,13,319
Arizona,Brenda,406,5,370,5,0,26,406
Arizona,Bryce,48,22,0,14,0,0,36
Arizona,Buckshot,24,0,24,0,0,0,24
Arizona,Cactus Flats,1378,371,458,102,30,34,995
Arizona,Cactus Forest,955,216,256,234,0,20,726
Arizona,Campo Bonito,133,0,62,71,0,0,133
Arizona,Cane Beds,319,49,76,68,9,0,202
Arizona,Carrizo,119,23,24,5,0,3,55
Arizona,Wellton Hills,310,144,90,46,0,12,292
Arizona,Casa Blanca,1044,482,129,86,0,74,771
Arizona,Bylas,1719,659,271,113,7,137,1187
Arizona,Beyerville,116,42,32,13,9,0,96
Arizona,Bear Flat,0,0,0,0,0,0,0
Arizona,Beaver Dam,1547,69,894,223,194,109,1489
Arizona,Aztec,0,0,0,0,0,0,0
Arizona,Avenue B and C,3708,775,1494,368,53,171,2861
Arizona,Washington Park,153,37,89,0,0,27,153
Arizona,Arlington,131,6,89,19,0,8,122
Arizona,Arivaca Junction,1233,332,504,47,43,108,1034
Arizona,Walnut Creek,689,20,467,33,0,34,554
Arizona,Wall Lane,375,68,129,47,5,30,279
Arizona,Wahak Hotrontk,161,61,23,0,0,5,89
Arizona,Wagon Wheel,1602,178,838,41,0,134,1191
Arizona,Village of Oak Creek (Big Park),6057,759,3541,858,31,517,5706
Arizona,Vicksburg,621,35,370,82,20,92,599
Arizona,Vernon,122,7,17,29,21,0,74
Arizona,Verde Village,12473,2326,5142,1540,117,961,10086
Arizona,Beaver Valley,251,40,143,31,0,23,237
Arizona,Cedar Creek,633,109,223,21,0,39,392
Arizona,Charco,28,23,0,0,0,5,28
Arizona,Central,417,33,226,5,0,23,287
Arizona,Benson,4884,975,1690,912,9,540,4126
Arizona,Rock Point,461,210,131,6,2,18,367
Arizona,Douglas,16453,6472,4261,1695,230,837,13495
Arizona,Huachuca City,2275,488,718,371,29,113,1719
Arizona,Black Canyon City,3172,804,1126,504,88,412,2934
Arizona,Camp Verde,11169,2449,4162,1429,220,808,9068
Arizona,Cornville,3192,496,1598,362,85,377,2918
Arizona,Lake Montezuma,5212,1127,2166,1046,77,304,4720
Arizona,Coolidge,12503,3128,3607,1591,681,389,9396
Arizona,Florence,26350,10719,7235,4836,525,843,24158
Arizona,Cornfields,313,126,85,9,3,25,248
Arizona,Nazlini,457,191,70,10,0,15,286
Arizona,Kykotsmovi Village,863,277,205,102,17,47,648
Arizona,Winslow,9505,3691,2239,827,171,484,7412
Arizona,Ajo,3279,866,1229,240,22,281,2638
Arizona,Marana,43606,7739,21507,3417,372,1323,34358
Arizona,Tacna,761,204,328,59,9,28,628
Arizona,Window Rock,2952,1250,532,157,110,206,2255
Arizona,Sierra Vista,43550,8446,19154,3956,707,2272,34535
Arizona,Copper Hill,0,0,0,0,0,0,0
Arizona,Concho,116,36,43,0,0,0,79
Arizona,Comobabi,46,0,16,0,0,0,16
Arizona,Clacks Canyon,283,56,138,24,0,20,238
Arizona,Citrus Park,5033,1050,2589,299,120,90,4148
Arizona,Cienega Springs,1882,481,667,307,5,167,1627
Arizona,Clay Springs,349,57,102,100,0,0,259
Arizona,Christopher Creek,125,17,73,35,0,0,125
Arizona,Chloride,385,101,155,43,8,59,366
Arizona,Chiawuli Tak,0,0,0,0,0,0,0
Arizona,Centennial Park,1236,302,378,53,0,8,741
Arizona,Ventana,93,81,0,6,0,0,87
Arizona,Wikieup,118,8,57,28,0,6,99
Arizona,Valle,204,67,54,29,54,0,204
Arizona,Wheatfields,354,28,80,150,0,21,279
Arizona,Whispering Pines,86,0,17,10,0,59,86
Arizona,Whitecone,801,286,212,39,24,44,605
Arizona,White Hills,221,26,115,37,0,43,221
Arizona,White Mountain Lake,2605,563,1016,515,40,194,2328
Arizona,Tusayan,353,139,120,34,9,2,304
Arizona,Why,151,41,41,19,12,17,130
Arizona,Whetstone,2146,445,813,382,26,180,1846
Arizona,Theba,87,14,48,0,0,0,62
Arizona,Red Rock CDP (Pinal County),3775,744,1358,263,23,61,2449
Arizona,Cottonwood,186,88,38,7,15,6,154
Arizona,Cowlic,168,87,19,25,0,0,131
Arizona,Crozier,40,5,20,4,0,5,34
Arizona,Crystal Beach,134,21,74,10,9,20,134
Arizona,Kohls Ranch,126,0,119,0,0,7,126
Arizona,Komatke,1156,490,121,88,6,18,723
Arizona,Lake of the Woods,3671,877,1514,464,21,200,3076
Arizona,La Paz Valley,762,126,123,98,0,415,762
Arizona,Red Rock CDP (Apache County),148,98,24,0,0,11,133
Arizona,Morristown,182,37,81,28,12,24,182
Arizona,Ko Vaya,8,0,8,0,0,0,8
Arizona,Gold Canyon,11038,1489,7276,1002,56,750,10573
Arizona,Buckeye,65630,16680,25412,5313,754,1559,49718
Arizona,Yucca,108,17,16,33,0,23,89
Arizona,York,725,239,270,33,0,38,580
Arizona,Woodruff,199,0,199,0,0,0,199
Arizona,Wittmann,641,186,313,0,0,0,499
Arizona,Wintersburg,24,9,15,0,0,0,24
Arizona,Willow Canyon,0,0,0,0,0,0,0
Arizona,Wet Camp Village,218,95,40,5,0,8,148
Arizona,Valle Vista,2132,178,1328,298,0,94,1898
Arizona,Sehili,87,40,23,0,3,3,69
Arizona,Scenic,1792,128,924,201,0,94,1347
Arizona,Valentine,72,24,39,3,0,0,66
Arizona,Vaiva Vo,0,0,0,0,0,0,0
Arizona,Utting,115,0,70,36,0,9,115
Arizona,Upper Santan Village,489,145,126,35,22,45,373
Arizona,Turkey Creek,429,193,69,59,6,12,339
Arizona,Truxton,78,22,32,5,0,10,69
Arizona,Toyei,0,0,0,0,0,0,0
Arizona,Santa Cruz,0,0,0,0,0,0,0
Arizona,Wide Ruins,60,29,16,15,0,0,60
Arizona,Topock,15,0,0,15,0,0,15
Arizona,San Tan Valley,93230,21639,36777,6515,740,3292,68963
Arizona,Arivaca,646,130,356,74,19,57,636
Arizona,Topawa,237,166,17,0,9,23,215
Arizona,Tonto Village,239,13,127,15,0,33,188
Arizona,Tolani Lake,370,140,85,14,4,23,266
Arizona,Tees Toh,574,266,115,37,15,23,456
Arizona,Tat Momoli,52,13,0,0,0,39,52
Arizona,Tonopah,51,0,51,0,0,0,51
Arizona,Sweet Water Village,73,52,16,0,0,5,73
Arizona,Sunwest,23,0,23,0,0,0,23
Arizona,Sun Valley,175,57,96,15,7,0,175
Arizona,Sunizona,198,27,108,35,0,20,190
Arizona,Summerhaven,157,16,35,0,0,9,60
Arizona,Stotonic Village,342,181,86,0,0,26,293
Arizona,South Komelik,298,111,45,0,0,8,164
Arizona,Solomon,389,146,140,24,0,29,339
Arizona,So-Hi,216,28,119,55,0,14,216
Arizona,Six Shooter Canyon,1065,205,347,70,13,102,737
Arizona,Seven Mile,990,347,239,56,15,64,721
Arizona,Seba Dalkai,123,56,33,10,3,9,111
Arizona,Anthem,22570,4095,11360,1401,169,1035,18060
Arizona,Many Farms,1288,467,343,46,6,37,899
Arizona,Anegam,120,61,36,18,0,0,115
Arizona,Hotevilla-Bacavi,1102,383,250,81,51,74,839
Arizona,St. Michaels,1218,647,224,90,40,51,1052
Arizona,Lukachukai,1430,584,400,55,30,59,1128
Arizona,Santa Rosa,494,216,73,39,6,59,393
Arizona,Safford,9735,2389,3235,1108,96,719,7547
Arizona,Peach Springs,1333,470,270,95,10,85,930
Arizona,Show Low,11014,1698,4898,1124,187,722,8629
Arizona,San Manuel,3753,972,1273,516,113,227,3101
Arizona,Vail,12044,1958,6237,636,63,430,9324
Arizona,Mohave Valley,2674,539,1078,254,82,210,2163
Arizona,Gila Bend,1782,367,657,174,15,70,1283
Arizona,Somerton,15932,3584,6233,672,414,332,11235
Arizona,Mojave Ranch Estates,17,0,7,7,0,0,14
Arizona,Leupp,1314,440,385,51,19,80,975
Arizona,Kayenta,4889,2346,1058,46,35,57,3542
Arizona,Sierra Vista Southeast,16021,2825,7817,1384,66,841,12933
Arizona,Corona de Tucson,8326,1210,4108,484,18,114,5934
Arizona,Prescott Valley,43198,8261,19447,5540,464,2205,35917
Arizona,Paulden,4559,687,2026,433,236,306,3688
Arizona,Chino Valley,11376,1907,5369,1568,40,778,9662
Arizona,Sedona,10315,1765,5474,1705,101,552,9597
Arizona,San Simon,140,13,45,28,7,9,102
Arizona,Round Rock,769,305,188,14,8,33,548
Arizona,Chinle,5378,1945,1130,247,34,105,3461
Arizona,Burnside,602,253,118,60,6,34,471
Arizona,Kearny,2263,659,817,158,16,101,1751
Arizona,Chuichu,324,248,32,21,0,0,301
Arizona,Summit,5027,1581,1604,295,230,208,3918
Arizona,Picture Rocks,9452,1860,4064,1181,94,436,7635
Arizona,Snowflake,5724,1043,2211,295,101,198,3848
Arizona,Drexel Heights,29514,8404,10470,2173,559,1213,22819
Arizona,Quartzsite,3707,409,2387,270,179,193,3438
Arizona,Mesquite Creek,473,33,303,60,0,55,451
Arizona,Gilbert,237484,51136,100787,17995,1632,5561,177111
Arizona,Bouse,1078,121,623,130,0,121,995
Arizona,Mountainaire,776,197,286,103,0,9,595
Arizona,Pima,2507,505,961,110,19,136,1731
Arizona,Phoenix,1610071,489238,524613,157631,27206,54353,1253041
Arizona,Kachina Village,2581,393,1316,316,13,118,2156
Arizona,Bitter Springs,426,169,103,27,0,34,333
Arizona,Flagstaff,71202,33507,19555,5761,333,1339,60495
Arizona,Wickenburg,7021,1310,3416,989,125,686,6526
Arizona,Mesa,491194,129202,186728,47163,6617,21459,391169
Arizona,Glendale,245514,70978,82235,25520,4762,10177,193672
Arizona,El Mirage,35004,8937,11543,3744,504,973,25701
Arizona,Chandler,248631,62068,100832,22754,2534,7253,195441
Arizona,Wenden,315,45,142,38,27,33,285
Arizona,Bluewater,1004,165,443,118,32,117,875
Arizona,Payson,15439,2589,7828,2296,107,1104,13924
Arizona,Claypool,1278,254,521,184,16,50,1025
Arizona,Cottonwood,11826,2728,3918,2070,237,893,9846
Arizona,Cordes Lakes,2410,460,1017,541,16,186,2220
Arizona,Seligman,495,82,290,0,12,13,397
Arizona,Willow Valley,857,149,359,184,23,94,809
Arizona,Page,7547,2809,2624,260,19,124,5836
Arizona,Fredonia,1069,283,485,89,8,60,925
Arizona,Queen Creek,36053,7003,16069,1830,101,686,25689
Arizona,Peoria,164572,35614,68796,16199,1880,8262,130751
Arizona,Cave Creek,5569,872,3128,708,11,376,5095
Arizona,Apache Junction,39674,8431,16167,5933,486,3037,34054
Arizona,Globe,7346,1864,2777,941,135,400,6117
Arizona,New Kingman-Butler,13471,3424,4953,1776,295,976,11424
Arizona,Kingman,29244,6627,10892,3931,380,2015,23845
Arizona,Antares,140,24,54,35,0,12,125
Arizona,Houck,863,429,182,48,21,39,719
Arizona,Tucson Estates,11758,2259,5126,1475,154,1028,10042
Arizona,Rough Rock,471,206,104,11,13,27,361
Arizona,Ganado,1035,340,260,46,12,61,719
Arizona,McNary,657,223,155,37,4,20,439
Arizona,Chilchinbito,892,453,128,15,3,21,620
Arizona,Amado,53,0,15,38,0,0,53
Arizona,Cameron,1077,453,217,59,36,52,817
Arizona,Heber-Overgaard,2542,417,1115,415,49,144,2140
Arizona,Kaibab,134,49,18,15,2,17,101
Arizona,Colorado City,4825,1317,760,196,77,84,2434
Arizona,Arizona Village,1288,314,292,259,77,54,996
Arizona,Tumacacori-Carmen,218,9,128,0,0,0,137
Arizona,Yuma,95573,23296,38354,6840,1423,4419,74332
Arizona,Ash Fork,814,120,268,65,24,76,553
Arizona,Tanque Verde,15860,2580,9482,976,61,796,13895
Arizona,Eagar,4875,828,2055,456,42,169,3550
Arizona,Pisinemo,339,186,39,6,11,13,255
Arizona,Whiteriver,4185,1427,906,282,37,234,2886
Arizona,Catalina,7635,1549,3490,795,89,367,6290
Arizona,Green Valley,21723,1017,13976,2823,116,3502,21434
Arizona,Tucson,539216,187905,159019,61877,9955,23955,442711
Arizona,Valencia West,11919,2917,4076,1404,114,333,8844
Arizona,Fortuna Foothills,29485,3408,16769,2502,305,2508,25492
Arizona,Casa Grande,54316,13480,19738,5547,731,2513,42009
Arizona,LeChee,1589,633,453,50,30,66,1232
Arizona,Dewey-Humboldt,4026,646,2018,550,93,182,3489
Arizona,Maricopa,47314,11108,19558,3667,501,1198,36032
Arizona,Ali Chukson,96,17,28,0,0,9,54
Arizona,Ali Molina,54,45,0,9,0,0,54
Arizona,Alpine,119,10,72,0,16,0,98
Arizona,Springerville,1946,375,671,300,12,107,1465
Arizona,Dennehotso,779,373,195,21,6,25,620
Arizona,Tsaile,1296,737,145,55,16,47,1000
Arizona,St. David,1332,314,521,149,20,48,1052
Arizona,Three Points,5161,1161,1843,1030,159,327,4520
Arizona,Second Mesa,1736,675,329,47,80,138,1269
Arizona,Hayden,503,135,208,74,0,42,459
Arizona,Arizona City,11761,2859,3864,1769,209,710,9411
Arizona,Sonoita,808,163,466,94,4,21,748
Arizona,Nogales,20288,5328,6680,1933,448,1147,15536
Arizona,Eloy,18083,8678,4119,2465,395,463,16120
Arizona,Pirtleville,1572,534,584,156,27,38,1339
Arizona,Fort Defiance,4209,2118,738,190,81,141,3268
Arizona,Morenci,1510,336,506,191,3,7,1043
Arizona,Duncan,662,99,289,88,5,70,551
Arizona,Superior,3018,680,803,625,94,346,2548
Arizona,Stanfield,572,234,200,0,0,0,434
Arizona,Dudleyville,662,143,314,90,14,14,575
Arizona,Blackwater,1566,629,250,130,116,46,1171
Arizona,Ak-Chin Village,1185,486,229,106,19,37,877
Arizona,Casas Adobes,69615,16586,28634,8370,834,3931,58355
Arizona,Winslow West,666,250,110,62,61,0,483
Arizona,South Tucson,5666,2029,1197,902,150,288,4566
Arizona,Pinon,738,211,236,31,19,27,524
Arizona,Pinetop-Lakeside,4330,709,2061,564,149,251,3734
Arizona,Keams Canyon,162,57,39,29,0,11,136
Arizona,Jeddito,258,69,74,16,3,12,174
Arizona,Cibecue,2187,807,386,65,15,49,1322
Arizona,Spring Valley,1636,191,642,314,44,148,1339
Arizona,Prescott,42068,9206,19927,5019,293,3273,37718
Arizona,Peeples Valley,534,64,317,81,3,29,494
Arizona,Clarkdale,4258,301,2330,631,43,587,3892
Arizona,Bagdad,1814,307,860,82,0,42,1291
Arizona,Naco,830,157,349,79,23,62,670
Arizona,San Miguel,266,83,57,19,0,19,178
Arizona,Top-of-the-World,325,92,132,92,0,0,316
Arizona,Sanders,533,137,86,29,4,6,262
Arizona,Drysdale,526,108,281,19,3,5,416
Arizona,Dripping Springs,210,59,107,42,0,0,208
Arizona,Dragoon,49,16,0,16,0,17,49
Arizona,Donovan Estates,1276,289,600,93,0,52,1034
Arizona,Doney Park,5352,1038,2777,324,20,101,4260
Arizona,Del Muerto,253,76,57,42,21,18,214
Arizona,Deer Creek,198,49,105,25,0,19,198
Arizona,Dateland,488,132,188,46,22,22,410
Arizona,Cutter,0,0,0,0,0,0,0
Arizona,Star Valley,1907,133,954,263,48,227,1625
Arizona,Ali Chuk,108,59,0,0,0,14,73
Arizona,Ak Chin,0,0,0,0,0,0,0
Arizona,Aguila,1164,380,506,32,16,7,941
Arizona,East Globe,148,32,49,18,0,8,107
Arizona,Rillito,0,0,0,0,0,0,0
Arizona,Rancho Mesa Verde,629,196,239,76,0,76,587
Arizona,Rainbow City,1008,312,276,75,9,51,723
Arizona,Pinion Pines,175,44,87,23,0,21,175
Arizona,Pinetop Country Club,1634,149,966,68,10,132,1325
Arizona,Pine Lake,79,0,63,0,0,16,79
Arizona,Pinedale,322,38,175,68,0,5,286
Arizona,Pinal,486,89,52,106,9,53,309
Arizona,Pimaco Two,776,120,357,121,0,47,645
Arizona,Picacho,401,92,185,67,16,11,371
Arizona,Palominas,231,18,130,38,0,45,231
Arizona,Padre Ranchitos,185,81,36,4,0,4,125
Arizona,Oxbow Estates,197,23,73,41,0,19,156
Arizona,Orange Grove Mobile Manor,634,142,254,0,57,31,484
Arizona,Alamo Lake,20,0,0,7,0,13,20
Arizona,Oatman,0,0,0,0,0,0,0
Arizona,East Verde Estates,121,0,79,33,0,9,121
Arizona,Elephant Head,794,100,358,105,4,65,632
Arizona,Lake Havasu City,53952,10093,26184,6866,773,3817,47733
Arizona,Jerome,445,97,178,72,14,50,411
Arizona,Mayer,2101,389,847,367,63,138,1804
Arizona,Tonalea,264,116,45,15,4,20,200
Arizona,Peridot,1643,597,326,92,7,78,1100
Arizona,Rio Verde,2107,19,1922,25,0,141,2107
Arizona,Scottsdale,246026,64307,108722,26670,1715,13154,214568
Arizona,Sun City,39348,2893,21271,6541,369,7900,38974
Arizona,Youngtown,6747,1776,1899,1012,148,427,5262
Arizona,Poston,322,125,80,11,11,30,257
Arizona,Salome,1215,143,697,131,75,33,1079
Arizona,Bullhead City,40024,8140,15178,5969,1120,3799,34206
Arizona,Golden Valley,8673,1654,4071,1319,242,727,8013
Arizona,El Capitan,104,20,52,14,0,0,86
Arizona,San Carlos,4247,1352,819,355,26,182,2734
Arizona,Avondale,83392,22900,28996,7723,1408,2260,63287
Arizona,Tempe,183652,88923,47422,17250,1947,5608,161150
Arizona,Tolleson,7184,1662,2769,527,182,235,5375
Arizona,Parks,1392,137,857,187,64,45,1290
Arizona,Congress,1540,85,875,94,0,253,1307
Arizona,Wilhoit,933,164,476,172,9,44,865
Arizona,Fort Valley,1549,407,558,360,0,0,1325
Arizona,Fort Thomas,375,59,188,44,0,32,323
Arizona,Fort Mohave,15228,2398,7550,1623,262,1046,12879
Arizona,Fort Apache,198,82,54,0,0,8,144
Arizona,Flowing Springs,62,8,19,25,0,10,62
Arizona,El Prado Estates,547,269,60,45,6,4,384
Arizona,Elfrida,409,84,187,42,12,10,335
Arizona,Swift Trail Junction,3292,948,1190,406,152,119,2815
Arizona,Oak Springs,74,22,33,2,0,0,57
Arizona,Nutrioso,38,0,38,0,0,0,38
Arizona,North Fork,1787,576,623,169,11,18,1397
Arizona,Moenkopi,1300,453,351,137,23,30,994
Arizona,Sahuarita,28949,4794,13886,2183,175,868,21906
Arizona,Oro Valley,43815,7951,23695,3673,308,2312,37939
Arizona,Winkelman,218,93,33,36,0,48,210
Arizona,Catalina Foothills,50426,9252,26283,4827,776,2702,43840
Arizona,Shonto,605,156,186,53,33,14,442
Arizona,Holbrook,5037,1548,1415,613,183,177,3936
Arizona,Greasewood,441,144,112,25,15,26,322
Arizona,Taylor,4170,799,1832,425,55,328,3439
Arizona,Gadsden,441,83,206,27,30,22,368
Arizona,Parker Strip,748,80,494,59,0,99,732
Arizona,East Fork,613,244,119,68,9,25,465
Arizona,Canyon Day,1466,399,413,36,19,58,925
Arizona,Kaibito,1522,544,423,49,3,66,1085
Arizona,Williamson,5297,454,3699,430,14,287,4884
Arizona,Guadalupe,6405,2041,1584,564,172,323,4684
Arizona,Goodyear,77476,17184,35808,5328,660,2533,61513
Arizona,St. Johns,3500,871,1317,472,31,38,2729
Arizona,Red Mesa,386,162,104,29,9,19,323
Arizona,Litchfield Park,5899,1044,2670,533,115,482,4844
Arizona,Sun Lakes,14582,861,10433,1171,72,2045,14582
Arizona,Sun City West,25444,1121,16348,2874,70,5012,25425
Arizona,New River,15808,2811,8362,1632,15,891,13711
Arizona,Fountain Hills,24490,3389,14039,2803,125,1849,22205
Arizona,Gisela,611,85,208,103,5,51,452
Arizona,Tuba City,8662,3422,1880,634,172,378,6486
Arizona,Supai,15,10,5,0,0,0,15
Arizona,Williams,3152,516,1536,214,38,97,2401
Arizona,Parker,3121,1010,1045,300,55,115,2525
Arizona,Grand Canyon Village,2130,949,501,172,28,121,1771
Arizona,Paradise Valley,14215,1828,8270,974,60,723,11855
Arizona,Carefree,3749,463,2437,438,0,314,3652
Arizona,San Jose,589,109,213,46,10,15,393
Arizona,Nelson,591,161,139,22,0,29,351
Arizona,Moccasin,81,19,62,0,0,0,81
Arizona,Miracle Valley,778,124,314,161,0,17,616
Arizona,Mescal,1760,319,885,204,0,75,1483
Arizona,Mesa del Caballo,816,152,320,89,0,65,626
Arizona,Meadview,940,127,530,161,0,114,932
Arizona,Mead Ranch,0,0,0,0,0,0,0
Arizona,Martinez Lake,65,0,58,0,0,7,65
Arizona,Maricopa Colony,727,269,161,40,16,29,515
Arizona,Maish Vaya,169,69,40,12,0,15,136
Arizona,McNeal,140,10,72,24,0,15,121
Arizona,McConnico,0,0,0,0,0,0,0
Arizona,Lupton,18,6,10,2,0,0,18
Arizona,Low Mountain,732,268,167,61,20,32,548
Arizona,Lower Santan Village,206,49,22,10,0,29,110
Arizona,Littlefield,396,56,340,0,0,0,396
Arizona,Linden,2848,460,1419,263,31,181,2354
Arizona,Lazy Y U,285,14,245,0,14,0,273
Arizona,Tonto Basin,1540,193,717,278,19,182,1389
Arizona,Munds Park,868,209,470,158,0,0,837
Arizona,Cibola,293,33,104,65,0,25,227
Arizona,Young,553,99,204,140,0,49,492
Arizona,Central Heights-Midland City,2838,834,1009,325,20,148,2336
Arizona,Miami,2084,605,489,292,41,125,1552
Arizona,Pine,1727,174,1031,193,26,146,1570
Arizona,Ehrenberg,939,235,367,141,71,58,872
Arizona,Surprise,132904,25907,61563,11884,1094,6192,106640
Arizona,Thatcher,5030,1336,2059,305,53,129,3882
Arizona,Desert Hills,2703,260,1420,461,53,252,2446
Arizona,Willcox,3549,850,1328,324,10,133,2645
Arizona,Nolic,83,20,16,0,0,7,43
Arizona,Bisbee,5231,1210,1601,898,60,573,4342
Arizona,Hunter Creek,19,0,0,19,0,0,19
Arizona,Hondah,1034,306,309,117,18,23,773
Arizona,Hard Rock,85,37,6,5,0,7,55
Arizona,Haivana Nakya,170,88,0,22,0,19,129
Arizona,Haigler Creek,30,0,30,0,0,0,30
Arizona,Hackberry,84,10,64,3,0,7,84
Arizona,Icehouse Canyon,563,53,347,60,0,29,489
Arizona,Tombstone,1375,161,636,217,16,188,1218
Arizona,Greer,38,0,38,0,0,0,38
Arizona,Grand Canyon West,0,0,0,0,0,0,0
Arizona,Goodyear Village,270,143,51,22,0,10,226
Arizona,Golden Shores,1064,181,303,276,0,275,1035
Arizona,Gila Crossing,758,368,89,64,23,26,570
Arizona,Geronimo Estates,0,0,0,0,0,0,0
Arizona,Gu Oidak,62,12,19,22,0,9,62
Arizona,Indian Wells,284,115,81,17,13,14,240
Arizona,Jakes Corner,73,0,37,17,0,19,73
Arizona,Joseph City,1557,398,458,180,18,37,1091
Arizona,St. Johns,663,287,140,12,0,31,470
Arizona,Saddlebrooke,10530,568,7816,839,13,886,10122
Arizona,Sacaton Flats Village,506,194,97,9,0,26,326
Arizona,Sacate Village,182,77,14,8,13,0,112
Arizona,Round Valley,640,48,298,29,0,60,435
Arizona,Roosevelt,72,15,53,4,0,0,72
Arizona,Rock House,91,0,72,0,0,19,91
Arizona,Rye,105,25,64,16,0,0,105
Arizona,Rio Rico,19601,5074,7891,1094,223,573,14855
Arizona,Rincon Valley,5469,908,2875,307,0,226,4316
Arizona,Kohatk,0,0,0,0,0,0,0
Arizona,Klagetoh,234,73,60,21,2,9,165
Arizona,Kino Springs,314,63,106,22,0,4,195
Arizona,Katherine,69,24,10,29,0,6,69
Arizona,Kaka,119,64,10,9,0,15,98
Arizona,Freedom Acres,135,0,91,0,0,0,91
Arizona,Franklin,54,15,23,7,0,9,54
Arizona,Strawberry,760,131,375,105,0,141,752
Arizona,Dolan Springs,2180,111,1072,242,0,299,1724
Arizona,Yarnell,700,44,399,155,8,58,664
Arizona,Clifton,3691,840,1440,278,39,118,2715
Arizona,San Luis,32279,8291,13074,1312,888,625,24190
Arizona,Wellton,2994,491,1738,239,20,251,2739
Arizona,Elgin,117,11,92,14,0,0,117
Arizona,Patagonia,867,161,340,110,26,60,697
Arizona,Tubac,1230,144,758,138,0,160,1200
Arizona,First Mesa,1981,705,404,125,42,100,1376
Arizona,Oljato-Monument Valley,197,65,46,0,0,0,111
Arizona,Shongopovi,1102,459,109,114,19,40,741
Arizona,Dilkon,1215,353,288,55,20,65,781
Arizona,Flowing Wells,15290,4084,5052,2051,334,991,12512
Arizona,Sells,2749,1279,376,113,35,136,1939
Arizona,Mammoth,1856,538,536,221,76,164,1535
Arizona,Oracle,3920,461,2138,385,37,190,3211
Arizona,Queen Valley,771,0,606,73,16,76,771
Arizona,Sacaton,2051,1146,343,153,55,106,1803
Arizona,Teec Nos Pos,793,376,190,34,8,13,621
Arizona,Sawmill,771,348,186,15,13,30,592
Arizona,Avra Valley,5966,1363,2799,575,48,227,5012
Arizona,Steamboat,364,164,71,19,0,29,283
Arkansas,Hughes,1336,525,253,128,40,105,1051
Arkansas,Swifton,836,162,302,102,19,65,650
Arkansas,Gravette,3340,572,1413,390,55,193,2623
Arkansas,Lake View,459,190,46,23,34,55,348
Arkansas,Mineral Springs,1131,352,338,117,12,64,883
Arkansas,Hot Springs,36969,10215,11315,5529,737,2882,30678
Arkansas,Daisy,90,9,44,22,2,7,84
Arkansas,Tupelo,134,36,53,14,3,9,115
Arkansas,Sparkman,434,52,183,62,23,30,350
Arkansas,Garner,175,31,82,21,3,13,150
Arkansas,Russellville,29244,9682,9132,3226,560,967,23567
Arkansas,Dover,1989,388,588,318,29,128,1451
Arkansas,Hatfield,434,93,154,82,4,21,354
Arkansas,Rudy,278,94,64,41,0,6,205
Arkansas,Pindall,112,21,41,15,0,10,87
Arkansas,Marshall,1508,212,665,142,32,206,1257
Arkansas,Humphrey,509,122,219,48,9,45,443
Arkansas,Valley Springs,189,30,88,11,1,10,140
Arkansas,Marmaduke,1399,244,429,270,64,82,1089
Arkansas,Fordyce,3925,1153,1085,390,120,370,3118
Arkansas,Marion,12447,2929,4675,1185,272,479,9540
Arkansas,Casa,230,48,95,23,10,19,195
Arkansas,Branch,330,68,144,41,7,22,282
Arkansas,Centerton,13252,2782,4953,1127,262,200,9324
Arkansas,Biggers,291,45,115,47,6,13,226
Arkansas,Gillett,729,129,303,57,11,65,565
Arkansas,Almyra,263,51,132,39,0,14,236
Arkansas,Ratcliff,192,18,88,35,5,16,162
Arkansas,Paris,3426,805,1170,468,43,263,2749
Arkansas,Houston,157,21,99,14,3,5,142
Arkansas,Bono,2487,377,924,296,76,128,1801
Arkansas,Jericho,40,17,10,0,1,12,40
Arkansas,Magazine,918,185,265,182,36,61,729
Arkansas,Haynes,153,49,44,29,3,5,130
Arkansas,Aubrey,139,26,61,10,0,22,119
Arkansas,Russell,220,26,72,53,8,19,178
Arkansas,Anthonyville,138,28,53,10,0,15,106
Arkansas,Zinc,74,12,24,14,1,9,60
Arkansas,Gassville,2519,478,969,275,34,130,1886
Arkansas,Nimmons,85,19,34,17,3,2,75
Arkansas,Datto,94,24,39,10,2,4,79
Arkansas,Sulphur Rock,584,96,191,92,9,16,404
Arkansas,Coal Hill,1189,218,573,82,34,116,1023
Arkansas,Booneville,3869,667,1394,461,68,354,2944
Arkansas,Dyer,730,126,360,46,16,58,606
Arkansas,Imboden,713,99,335,70,5,80,589
Arkansas,Lockesburg,886,208,284,119,6,55,672
Arkansas,Luxora,1203,412,288,104,45,61,910
Arkansas,McCaskill,74,28,13,4,10,4,59
Arkansas,Mount Vernon,148,23,59,27,1,14,124
Arkansas,Oakhaven,120,20,48,9,3,4,84
Arkansas,Ogden,185,64,59,10,5,4,142
Arkansas,Ozan,86,19,38,3,0,17,77
Arkansas,Patterson,429,92,152,54,13,23,334
Arkansas,Lexa,267,57,69,18,6,29,179
Arkansas,Peach Orchard,90,12,45,17,0,9,83
Arkansas,Pollard,179,13,92,20,1,23,149
Arkansas,Pottsville,3136,620,1400,260,73,174,2527
Arkansas,Hamburg,2741,479,1063,280,112,211,2145
Arkansas,Ulm,224,50,96,24,0,19,189
Arkansas,Higginson,698,146,284,71,6,11,518
Arkansas,Griffithville,126,23,52,29,5,16,125
Arkansas,Lepanto,2071,597,725,202,25,136,1685
Arkansas,Reyno,421,70,122,72,26,38,328
Arkansas,Perrytown,434,94,144,36,9,42,325
Arkansas,Lake City,2380,399,991,331,86,223,2030
Arkansas,Knoxville,861,103,456,67,4,31,661
Arkansas,Knobel,183,44,84,17,0,24,169
Arkansas,Salem,1845,490,481,314,26,185,1496
Arkansas,Van Buren,23296,4690,9069,2390,539,1343,18031
Arkansas,Parkin,767,272,216,56,59,108,711
Arkansas,Bonanza,507,78,196,74,9,49,406
Arkansas,Campbell Station,230,24,114,32,4,9,183
Arkansas,Caraway,1121,230,442,160,21,79,932
Arkansas,Cushman,422,101,155,67,0,26,349
Arkansas,De Valls Bluff,634,75,215,99,10,69,468
Arkansas,LaGrange,45,20,8,0,0,11,39
Arkansas,Evening Shade,454,93,160,73,25,43,394
Arkansas,Fisher,277,64,115,37,4,7,227
Arkansas,Fouke,838,135,259,146,18,54,612
Arkansas,Fulton,129,15,31,30,0,14,90
Arkansas,Gilmore,199,52,76,4,12,24,168
Arkansas,Greenway,170,48,56,26,4,12,146
Arkansas,Grubbs,436,81,156,71,12,35,355
Arkansas,Harrell,391,183,84,45,6,24,342
Arkansas,Helena-West Helena,10965,3417,2753,1102,546,703,8521
Arkansas,Jerome,37,0,19,6,2,6,33
Arkansas,Sedgwick,219,57,82,26,7,7,179
Arkansas,Georgetown,85,5,42,9,5,9,70
Arkansas,Grady,288,94,102,29,4,17,246
Arkansas,Paragould,28296,5257,11418,3287,878,1550,22390
Arkansas,Damascus,464,79,209,33,11,14,346
Arkansas,Huntington,551,40,217,94,41,33,425
Arkansas,Washington,185,58,53,40,13,2,166
Arkansas,Bradley,575,125,160,40,46,57,428
Arkansas,Turrell,539,204,78,89,21,51,443
Arkansas,Buckner,284,75,108,26,11,22,242
Arkansas,Blevins,460,38,227,25,9,18,317
Arkansas,Patmos,63,9,32,8,0,4,53
Arkansas,Wrightsville,1671,822,371,254,87,77,1611
Arkansas,Sherwood,30812,6928,12528,3544,385,1414,24799
Arkansas,McAlmont,2017,604,445,306,159,76,1590
Arkansas,Guion,161,31,39,33,9,10,122
Arkansas,Ola,1101,257,346,122,79,112,916
Arkansas,Bodcaw,212,35,109,5,0,2,151
Arkansas,Mount Pleasant,574,49,253,100,2,49,453
Arkansas,Stuttgart,8866,1995,3063,1151,303,531,7043
Arkansas,Strawberry,285,38,86,54,0,30,208
Arkansas,Conway,65069,22720,21750,5706,834,2440,53450
Arkansas,Twin Groves,368,66,166,17,25,38,312
Arkansas,Lamar,2002,270,816,273,26,167,1552
Arkansas,Flippin,1342,257,368,259,32,87,1003
Arkansas,Yellville,1162,224,336,125,35,123,843
Arkansas,Etowah,262,38,122,42,9,12,223
Arkansas,Keiser,647,154,164,87,15,25,445
Arkansas,St. Joe,171,30,91,9,1,11,142
Arkansas,Victoria,11,0,8,0,0,0,8
Arkansas,Foreman,1145,273,333,153,43,120,922
Arkansas,Greenbrier,5370,811,2019,590,98,309,3827
Arkansas,Rose Bud,540,87,251,44,8,25,415
Arkansas,Gurdon,2580,724,895,319,31,93,2062
Arkansas,Higden,113,10,58,9,0,12,89
Arkansas,Carthage,514,110,213,31,17,28,399
Arkansas,Magness,180,19,65,24,9,10,127
Arkansas,Piggott,3653,895,1150,472,86,445,3048
Arkansas,Success,97,15,33,18,0,18,84
Arkansas,Garland,369,177,68,29,12,18,304
Arkansas,Hot Springs Village,14466,1098,9593,1314,90,1373,13468
Arkansas,Bassett,233,40,80,34,8,10,172
Arkansas,Emerson,253,105,64,43,4,15,231
Arkansas,Winthrop,145,29,98,8,0,1,136
Arkansas,Magnolia,11573,4246,3209,919,288,848,9510
Arkansas,Marianna,3685,1253,981,336,136,157,2863
Arkansas,Hoxie,2641,562,1024,367,100,147,2200
Arkansas,Clarksville,9512,2204,3321,1290,205,479,7499
Arkansas,Edmondson,208,87,34,23,15,22,181
Arkansas,Jonesboro,74710,21121,24620,8329,1433,3439,58942
Arkansas,Burdette,175,49,77,19,4,2,151
Arkansas,Dell,226,18,108,26,2,23,177
Arkansas,Manila,3330,581,1408,458,72,224,2743
Arkansas,Pine Bluff,43840,15085,11647,4593,1303,2473,35101
Arkansas,Cedarville,1328,161,603,152,67,78,1061
Arkansas,Enola,335,72,156,32,10,16,286
Arkansas,Waldo,1409,288,482,114,41,131,1056
Arkansas,Lynn,232,39,108,20,10,10,187
Arkansas,Redfield,1620,345,522,250,19,71,1207
Arkansas,Star City,1862,289,796,126,29,220,1460
Arkansas,Portia,659,151,257,95,6,38,547
Arkansas,Tuckerman,2119,336,812,259,38,169,1614
Arkansas,Springtown,164,46,77,20,0,3,146
Arkansas,Leola,535,123,190,29,29,19,390
Arkansas,Cotter,930,204,408,135,37,31,815
Arkansas,Holland,643,121,319,35,5,44,524
Arkansas,Stamps,1562,467,485,206,28,166,1352
Arkansas,Hickory Ridge,237,45,111,32,0,4,192
Arkansas,Trumann,7089,1225,2911,786,145,388,5455
Arkansas,Smithville,83,15,48,10,0,2,75
Arkansas,Ward,4957,1012,2017,442,107,102,3680
Arkansas,Oak Grove,411,86,162,33,16,30,327
Arkansas,Mountain View,2834,338,1108,564,32,434,2476
Arkansas,Portland,307,56,140,36,5,49,286
Arkansas,Mitchellville,423,122,104,37,12,26,301
Arkansas,Watson,196,44,93,23,0,24,184
Arkansas,Gillham,271,88,81,14,10,31,224
Arkansas,Clarkedale,448,69,243,4,14,6,336
Arkansas,Midway,456,110,198,44,4,23,379
Arkansas,Briarcliff,214,28,113,22,5,15,183
Arkansas,Cherokee Village,5067,557,2119,736,191,420,4023
Arkansas,DeWitt,3117,730,1049,379,102,196,2456
Arkansas,Adona,188,17,90,22,10,4,143
Arkansas,Ravenden,467,83,151,91,13,38,376
Arkansas,Lake Village,2461,674,762,309,38,200,1983
Arkansas,Gould,753,212,196,55,14,79,556
Arkansas,Fountain Lake,417,68,134,61,32,24,319
Arkansas,Diamond City,861,130,398,148,6,66,748
Arkansas,Alicia,155,27,89,6,0,8,130
Arkansas,Powhatan,58,15,30,7,0,0,52
Arkansas,Morrison Bluff,82,30,28,6,0,2,66
Arkansas,Salem,2047,320,1141,145,32,133,1771
Arkansas,Midland,248,16,104,40,9,31,200
Arkansas,Oden,177,31,106,11,2,4,154
Arkansas,Allport,127,57,27,11,2,4,101
Arkansas,Central City,602,79,266,85,0,48,478
Arkansas,Hartford,599,106,286,62,4,27,485
Arkansas,Mansfield,1384,257,551,206,8,71,1093
Arkansas,Felsenthal,58,7,36,7,0,8,58
Arkansas,Strong,350,85,121,64,6,37,313
Arkansas,Thornton,620,175,128,96,21,39,459
Arkansas,Fountain Hill,142,15,91,9,2,13,130
Arkansas,Bergman,628,74,340,46,5,24,489
Arkansas,Shannon Hills,3774,887,1321,450,86,165,2909
Arkansas,Vandervoort,133,5,48,12,10,0,75
Arkansas,Walnut Ridge,5125,1100,1868,664,105,398,4135
Arkansas,Rondo,339,130,54,39,32,33,288
Arkansas,Murfreesboro,1834,360,631,341,23,186,1541
Arkansas,Gum Springs,132,40,46,26,0,2,114
Arkansas,Lakeview,856,122,485,90,6,74,777
Arkansas,Maumelle,18053,2713,8781,1916,57,925,14392
Arkansas,Forrest City,14475,5070,3074,2099,553,612,11408
Arkansas,Dermott,2631,991,674,304,100,167,2236
Arkansas,Kensett,1690,390,500,255,71,120,1336
Arkansas,Highfill,819,162,403,66,5,32,668
Arkansas,Eudora,2035,682,446,176,45,163,1512
Arkansas,Tinsman,49,8,24,2,0,6,40
Arkansas,Traskwood,403,68,141,93,9,46,357
Arkansas,Tyronza,943,189,376,91,23,53,732
Arkansas,Vilonia,4491,865,1773,603,0,160,3401
Arkansas,Wabbaseka,265,65,67,45,10,15,202
Arkansas,Wilson,994,230,404,64,32,58,788
Arkansas,Wilton,265,30,106,65,11,23,235
Arkansas,Winchester,183,81,40,13,7,5,146
Arkansas,Bethel Heights,2597,655,977,126,31,53,1842
Arkansas,Alexander,3007,808,848,350,59,214,2279
Arkansas,Avilla,1273,174,620,212,10,0,1016
Arkansas,Dennard,363,83,199,46,0,20,348
Arkansas,Brookland,3156,735,1324,302,43,104,2508
Arkansas,Center Ridge,378,96,182,24,0,10,312
Arkansas,Cherokee City,42,0,28,0,0,14,42
Arkansas,Guy,721,116,380,48,3,23,570
Arkansas,Hagarville,154,8,76,0,0,0,84
Arkansas,Sunset,180,87,28,16,9,14,154
Arkansas,Holiday Island,2108,231,1044,252,20,317,1864
Arkansas,Rockport,880,109,442,102,16,79,748
Arkansas,Harrisburg,2607,498,898,258,106,218,1978
Arkansas,Fifty-Six,122,11,57,22,2,14,106
Arkansas,Bauxite,579,108,186,110,9,40,453
Arkansas,Benton,34873,6668,13890,4187,581,1930,27256
Arkansas,East End,7019,1344,2970,926,165,400,5805
Arkansas,North Crossett,3184,554,1448,321,74,252,2649
Arkansas,Rison,1294,372,300,138,0,185,995
Arkansas,McGehee,3858,1090,1220,234,107,217,2868
Arkansas,Cale,135,27,55,21,0,9,112
Arkansas,Big Flat,33,0,16,7,0,5,28
Arkansas,Gilbert,15,0,0,6,2,3,11
Arkansas,Letona,277,35,138,26,0,7,206
Arkansas,Amity,730,127,283,75,12,63,560
Arkansas,Fourche,56,6,31,10,0,7,54
Arkansas,Hazen,1321,230,560,153,22,153,1118
Arkansas,Beebe,8055,1491,3448,834,155,376,6304
Arkansas,Judsonia,2088,403,755,350,39,152,1699
Arkansas,Arkadelphia,10611,5030,2409,700,277,637,9053
Arkansas,Danville,2270,507,708,123,71,111,1520
Arkansas,Kirby,846,113,454,65,6,11,649
Arkansas,Landmark,3279,734,1314,510,65,159,2782
Arkansas,Lost Bridge Village,351,51,239,9,0,14,313
Arkansas,Widener,298,71,106,27,5,33,242
Arkansas,Viola,332,69,123,37,6,25,260
Arkansas,Poyen,261,64,109,7,7,20,207
Arkansas,Louann,166,26,72,11,0,7,116
Arkansas,Fredonia (Biscoe),364,118,115,33,19,6,291
Arkansas,Bradford,610,111,207,94,32,45,489
Arkansas,McRae,757,149,261,108,26,31,575
Arkansas,Weiner,745,117,287,106,5,61,576
Arkansas,Dardanelle,4594,1247,1403,467,81,492,3690
Arkansas,Jacksonville,28588,7122,10241,2803,607,1453,22226
Arkansas,Blue Eye,64,6,0,7,20,3,36
Arkansas,Egypt,52,8,13,8,0,11,40
Arkansas,Rogers,64947,13723,28114,4837,528,2499,49701
Arkansas,Alpena,438,90,122,39,25,35,311
Arkansas,Everton,113,8,38,17,0,10,73
Arkansas,Hope,9847,2246,2732,1080,475,712,7245
Arkansas,Hartman,513,96,203,69,22,21,411
Arkansas,Waldron,3401,623,1242,399,81,122,2467
Arkansas,Hensley,56,45,0,11,0,0,56
Arkansas,Havana,526,77,143,48,7,17,292
Arkansas,Perry,283,71,91,55,8,8,233
Arkansas,Maysville,307,104,134,15,0,0,253
Arkansas,Midway,965,355,353,78,0,52,838
Arkansas,Natural Steps,439,112,232,34,18,0,396
Arkansas,New Blaine,126,7,36,31,0,8,82
Arkansas,New Edinburg,370,51,211,0,0,22,284
Arkansas,Reader,194,71,61,7,0,55,194
Arkansas,Roland,537,63,282,56,0,96,497
Arkansas,Rye,181,56,78,13,0,0,147
Arkansas,Mount Ida,1240,245,429,213,55,130,1072
Arkansas,Staves,142,7,112,12,0,0,131
Arkansas,Tumbling Shoals,876,61,519,61,0,103,744
Arkansas,Woodlawn,186,19,101,28,0,6,154
Arkansas,Yarborough Landing,430,0,292,25,0,49,366
Arkansas,Hermitage,947,327,201,53,11,26,618
Arkansas,Bella Vista,28328,3767,15983,2497,266,1826,24339
Arkansas,Magnet Cove,573,142,329,31,38,9,549
Arkansas,Southside,3934,705,1458,614,165,250,3192
Arkansas,Prescott,3072,685,884,273,94,248,2184
Arkansas,Sulphur Springs,790,134,375,138,11,80,738
Arkansas,Barling,4844,1047,1941,596,87,241,3912
Arkansas,Black Springs,44,3,27,7,0,5,42
Arkansas,Pleasant Plains,318,57,125,29,6,26,243
Arkansas,Eureka Springs,2011,425,799,403,24,145,1796
Arkansas,Concord,173,20,90,21,4,17,152
Arkansas,Caldwell,408,89,165,40,3,69,366
Arkansas,Moro,218,26,106,13,6,12,163
Arkansas,Blue Mountain,78,17,42,15,0,0,74
Arkansas,St. Charles,324,50,165,42,0,27,284
Arkansas,Franklin,156,36,44,40,4,16,140
Arkansas,Lafe,459,64,194,69,15,32,374
Arkansas,Shirley,295,75,98,44,7,21,245
Arkansas,Roe,80,3,50,9,0,12,74
Arkansas,Carlisle,2294,374,849,312,47,229,1811
Arkansas,Bald Knob,2891,393,987,435,51,289,2155
Arkansas,Amagon,63,17,16,21,0,9,63
Arkansas,Wilmot,477,155,112,40,18,28,353
Arkansas,Pangburn,536,112,198,87,0,55,452
Arkansas,Delight,423,70,204,39,0,34,347
Arkansas,Holly Grove,548,153,135,71,23,29,411
Arkansas,Searcy,23853,7770,7701,2107,287,1496,19361
Arkansas,Elaine,656,151,207,42,19,38,457
Arkansas,Elm Springs,2268,361,1131,173,7,125,1797
Arkansas,Augusta,2402,573,772,205,84,251,1885
Arkansas,Oppelo,764,129,325,94,17,30,595
Arkansas,Pocahontas,6506,1231,2237,887,195,550,5100
Arkansas,Lavaca,2794,409,1331,222,24,83,2069
Arkansas,Kingsland,361,71,123,69,13,28,304
Arkansas,Taylor,605,94,222,48,3,32,399
Arkansas,Melbourne,1787,351,744,186,61,137,1479
Arkansas,O'Kean,298,42,135,21,4,12,214
Arkansas,Fort Smith,87639,21467,31304,10677,2066,4290,69804
Arkansas,Hunter,106,2,74,8,0,7,91
Arkansas,Calion,518,120,200,128,4,18,470
Arkansas,Johnson,3665,488,1732,255,0,154,2629
Arkansas,Mayflower,1949,380,815,355,49,78,1677
Arkansas,McNeil,423,110,141,23,19,30,323
Arkansas,Ravenden Springs,150,20,70,17,4,8,119
Arkansas,Clinton,2534,479,1099,304,40,206,2128
Arkansas,Fairfield Bay,2537,155,1461,289,20,317,2242
Arkansas,Greenwood,9357,1592,4204,896,58,433,7183
Arkansas,Norphlet,605,76,297,58,13,31,475
Arkansas,Rector,2098,351,725,266,90,177,1609
Arkansas,Sidney,199,23,101,30,0,2,156
Arkansas,Warren,5704,1413,1790,658,198,444,4503
Arkansas,Wooster,988,145,449,82,30,34,740
Arkansas,Mammoth Spring,919,165,352,133,29,83,762
Arkansas,Decatur,1879,387,609,165,41,76,1278
Arkansas,Bearden,1007,178,477,93,22,36,806
Arkansas,Chidester,297,60,116,49,5,29,259
Arkansas,Cotton Plant,595,161,183,100,32,55,531
Arkansas,Prairie Creek,2404,486,1180,208,9,152,2035
Arkansas,Bellefonte,428,42,187,78,10,13,330
Arkansas,Tillar,269,63,102,8,14,22,209
Arkansas,Mountain Home,12303,1914,5509,1599,268,1298,10588
Arkansas,Perla,280,83,77,20,17,22,219
Arkansas,Huntsville,2475,411,727,307,54,207,1706
Arkansas,Kibler,1122,210,550,105,12,55,932
Arkansas,Camden,11152,2718,3081,1341,542,809,8491
Arkansas,Greers Ferry,976,94,503,169,0,79,845
Arkansas,Glenwood,2085,387,887,181,31,199,1685
Arkansas,Wheatley,385,66,160,67,2,27,322
Arkansas,Tull,465,65,248,29,6,36,384
Arkansas,Black Rock,823,153,319,120,0,86,678
Arkansas,Sherrill,104,30,33,5,4,0,72
Arkansas,Western Grove,514,89,210,51,0,44,394
Arkansas,Keo,207,36,64,48,0,27,175
Arkansas,Bryant,19944,4413,8412,2241,334,834,16234
Arkansas,Haskell,4552,975,1799,553,26,109,3462
Arkansas,Crossett,5075,1145,1735,457,176,345,3858
Arkansas,Parkdale,239,90,96,4,9,14,213
Arkansas,Cherry Valley,789,134,277,131,19,23,584
Arkansas,Marked Tree,2238,505,620,327,65,250,1767
Arkansas,Belleville,609,149,199,64,23,25,460
Arkansas,Clarendon,1759,488,586,124,81,189,1468
Arkansas,Corinth,70,36,16,11,0,4,67
Arkansas,Crawfordsville,665,123,263,57,6,23,472
Arkansas,Cash,345,65,122,22,19,26,254
Arkansas,Arkansas City,457,133,176,22,7,21,359
Arkansas,Emmet,691,170,155,163,2,64,554
Arkansas,Leslie,759,199,245,124,24,54,646
Arkansas,Highland,1101,245,498,83,6,87,919
Arkansas,Williford,67,13,27,8,0,11,59
Arkansas,Caulksville,250,29,147,23,0,25,224
Arkansas,Harrison,13069,2746,4398,1709,460,893,10206
Arkansas,McCrory,1511,252,563,224,91,173,1303
Arkansas,Bigelow,282,68,70,45,7,17,207
Arkansas,Newport,7695,2244,2002,1446,345,577,6614
Arkansas,Stephens,813,229,304,58,23,107,721
Arkansas,Sweet Home,714,268,123,89,0,32,512
Arkansas,North Little Rock,66282,21330,18429,7673,1411,3237,52080
Arkansas,Minturn,87,19,26,14,5,7,71
Arkansas,White Hall,5158,845,2382,427,101,293,4048
Arkansas,Altheimer,859,242,252,54,22,73,643
Arkansas,Whelen Springs,38,6,14,1,0,0,21
Arkansas,Gosnell,3326,663,1322,336,120,191,2632
Arkansas,Newark,1094,175,438,155,41,91,900
Arkansas,Cave City,2412,474,816,332,63,170,1855
Arkansas,Ben Lomond,86,23,31,7,1,10,72
Arkansas,De Queen,6612,1692,2210,431,52,266,4651
Arkansas,Bluff City,110,8,60,13,0,10,91
Arkansas,Okolona,133,12,85,16,3,9,125
Arkansas,Reed,158,82,20,9,1,29,141
Arkansas,West Crossett,1181,293,387,185,6,107,978
Arkansas,Austin,3043,366,1464,182,5,109,2126
Arkansas,Colt,401,36,200,77,5,35,353
Arkansas,Plumerville,924,267,386,103,3,50,809
Arkansas,Madison,929,293,184,125,42,85,729
Arkansas,Cave Springs,3881,375,2231,158,0,43,2807
Arkansas,Little Flock,2727,796,1102,203,26,82,2209
Arkansas,Omaha,109,13,38,19,10,3,83
Arkansas,South Lead Hill,147,43,75,5,0,4,127
Arkansas,Monticello,9580,3247,2809,907,204,603,7770
Arkansas,Goshen,2061,205,1183,67,8,41,1504
Arkansas,Lewisville,1047,343,217,168,31,80,839
Arkansas,Bull Shoals,2097,240,1052,278,33,150,1753
Arkansas,Pyatt,271,27,133,13,5,21,199
Arkansas,Summit,426,87,168,47,12,35,349
Arkansas,Hampton,1341,318,508,146,11,170,1153
Arkansas,Des Arc,1728,421,744,246,19,98,1528
Arkansas,Caddo Valley,655,117,266,78,3,31,495
Arkansas,Corning,3181,725,1299,186,77,247,2534
Arkansas,Woodson,267,115,63,25,0,0,203
Arkansas,Scott,22,7,0,6,0,9,22
Arkansas,Alma,5688,1061,2397,495,105,313,4371
Arkansas,Brinkley,2823,1000,736,284,75,237,2332
Arkansas,Palestine,739,156,273,67,20,68,584
Arkansas,Gateway,365,56,202,33,3,31,325
Arkansas,McDougal,138,21,72,9,8,12,122
Arkansas,West Fork,2581,391,1274,171,14,138,1988
Arkansas,Winslow,426,83,162,38,5,41,329
Arkansas,Prairie Grove,5493,990,2472,442,34,315,4253
Arkansas,Huttig,723,195,219,86,2,78,580
Arkansas,Smackover,1897,386,634,294,51,132,1497
Arkansas,Junction City,479,122,165,62,16,25,390
Arkansas,Ozark,3601,819,1182,687,9,263,2960
Arkansas,Altus,851,132,316,66,32,72,618
Arkansas,Nashville,4447,1005,1294,526,164,277,3266
Arkansas,Dierks,1068,162,387,184,19,131,883
Arkansas,Horseshoe Lake,457,89,203,79,6,56,433
Arkansas,Mountain Pine,767,190,221,86,2,93,592
Arkansas,Lead Hill,192,42,68,37,3,15,165
Arkansas,Siloam Springs,16567,4604,5691,1400,226,810,12731
Arkansas,Perryville,1685,374,541,243,32,122,1312
Arkansas,Waldenburg,44,11,15,8,0,10,44
Arkansas,Gibson,4972,781,2255,561,99,192,3888
Arkansas,Elkins,3023,421,1269,397,48,93,2228
Arkansas,Avoca,519,122,193,67,5,24,411
Arkansas,Oil Trough,228,37,76,21,11,18,163
Arkansas,Garfield,594,85,351,52,4,21,513
Arkansas,Pea Ridge,5485,724,2362,558,78,299,4021
Arkansas,Calico Rock,2176,594,723,278,115,163,1873
Arkansas,Oak Grove Heights,1005,148,446,131,15,19,759
Arkansas,Batesville,10642,2598,3850,1161,222,801,8632
Arkansas,Joiner,530,199,131,61,13,29,433
Arkansas,Dyess,295,62,125,16,2,15,220
Arkansas,Birdsong,35,6,4,4,0,8,22
Arkansas,McNab,39,5,17,5,0,0,27
Arkansas,Blytheville,14298,3944,4511,1502,329,701,10987
Arkansas,Monette,1785,273,855,212,18,240,1598
Arkansas,West Memphis,25009,7931,6428,2436,887,1436,19118
Arkansas,Jennette,88,28,19,14,0,14,75
Arkansas,Marie,55,9,10,13,4,1,37
Arkansas,Little Rock,198135,60101,63993,20987,4404,9839,159324
Arkansas,College Station,601,233,29,65,40,89,456
Arkansas,Cammack Village,763,162,343,78,2,38,623
Arkansas,Plainview,623,106,296,60,7,29,498
Arkansas,Sulphur Springs,390,39,165,85,17,16,322
Arkansas,Lowell,8926,1510,4220,710,87,210,6737
Arkansas,Bentonville,46857,9497,20552,3723,442,1300,35514
Arkansas,Tollette,318,108,98,46,6,20,278
Arkansas,Weldon,78,11,29,13,1,12,66
Arkansas,Bay,2077,355,839,343,35,110,1682
Arkansas,Oxford,623,90,296,99,10,32,527
Arkansas,Coy,91,28,22,19,1,10,80
Arkansas,St. Francis,181,34,76,23,0,10,143
Arkansas,Norman,393,66,132,61,0,73,332
Arkansas,Cabot,26176,4627,11035,3188,445,989,20284
Arkansas,Osceola,7049,1837,1976,778,351,377,5319
Arkansas,Leachville,2467,507,837,228,101,147,1820
Arkansas,El Dorado,18129,4686,5653,2273,271,1168,14051
Arkansas,Lincoln,2436,435,864,323,54,193,1869
Arkansas,Quitman,801,138,304,131,8,64,645
Arkansas,Mulberry,1658,191,680,202,55,176,1304
Arkansas,Mena,5597,1081,1855,997,53,479,4465
Arkansas,Hector,619,128,271,40,0,41,480
Arkansas,Beedeville,98,12,31,15,0,7,65
Arkansas,Jacksonport,194,26,75,22,1,7,131
Arkansas,Lonsdale,141,39,60,12,0,4,115
Arkansas,Mountainburg,586,106,210,82,16,52,466
Arkansas,Rockwell,4607,643,2124,602,105,297,3771
Arkansas,Jasper,517,80,184,79,24,73,440
Arkansas,Earle,2179,637,555,325,56,120,1693
Arkansas,Fayetteville,83736,34869,24424,7732,667,2525,70217
Arkansas,Springdale,78690,17195,30451,6635,1128,2738,58147
Arkansas,Tontitown,3329,576,1720,278,0,216,2790
Arkansas,Lake Hamilton,2128,300,676,424,176,259,1835
Arkansas,Marvell,1383,336,375,170,32,134,1047
Arkansas,Charleston,2764,363,1090,425,34,244,2156
Arkansas,West Point,150,35,38,30,10,17,130
Arkansas,Green Forest,2680,702,1010,187,70,164,2133
Arkansas,St. Paul,67,13,44,4,0,3,64
Arkansas,Ashdown,4447,1229,1307,491,266,303,3596
Arkansas,Scranton,255,50,94,23,14,7,188
Arkansas,Delaplaine,100,21,57,8,0,2,88
Arkansas,Pineville,198,21,98,15,0,25,159
Arkansas,Black Oak,258,26,113,27,17,17,200
Arkansas,Subiaco,489,196,169,25,12,27,429
Arkansas,Hackett,863,107,323,131,22,42,625
Arkansas,Gentry,3739,603,1505,506,61,202,2877
Arkansas,Willisville,348,74,104,96,0,14,288
Arkansas,Beaver,64,7,32,14,0,5,58
Arkansas,Lonoke,4251,868,1713,365,118,283,3347
Arkansas,Norfork,585,68,262,78,12,42,462
Arkansas,Donaldson,336,85,121,32,4,20,262
Arkansas,Texarkana,30104,8032,9516,3812,1088,1941,24389
Arkansas,Friendship,143,11,65,25,0,15,116
Arkansas,Malvern,10853,2555,3752,1844,283,720,9154
Arkansas,Chester,150,32,68,12,7,11,130
Arkansas,Cove,243,31,98,39,18,21,207
Arkansas,Grannis,680,171,281,61,20,50,583
Arkansas,Wickes,1007,259,347,61,4,38,709
Arkansas,Atkins,3034,611,1167,356,10,286,2430
Arkansas,Sheridan,4857,980,1688,745,90,256,3759
Arkansas,Heber Springs,7047,1157,2963,936,195,469,5720
Arkansas,Denning,230,49,101,23,4,19,196
Arkansas,Berryville,5421,1290,1975,577,48,349,4239
Arkansas,Prattsville,347,79,142,26,4,26,277
Arkansas,East Camden,896,255,224,106,38,57,680
Arkansas,Antoine,64,13,26,9,2,8,58
Arkansas,Diaz,1204,317,398,119,24,104,962
Arkansas,Salesville,374,43,176,54,2,37,312
Arkansas,Hindsville,28,1,18,5,0,4,28
Arkansas,Horseshoe Bend,2464,385,1075,313,27,203,2003
Arkansas,Hardy,648,94,283,116,17,83,593
Arkansas,Moorefield,178,16,87,22,0,10,135
Arkansas,Fargo,101,28,34,9,7,4,82
Arkansas,England,2757,699,796,301,101,279,2176
Arkansas,Humnoke,221,38,94,11,7,34,184
Arkansas,Banks,128,13,72,16,2,9,112
Arkansas,Montrose,450,78,144,45,19,13,299
Arkansas,Wynne,8017,1779,2746,877,264,540,6206
Arkansas,Dumas,4287,962,1639,369,129,193,3292
Arkansas,Farmington,6810,1378,3429,317,59,204,5387
Arkansas,Rosston,317,75,89,34,7,26,231
Arkansas,Wiederkehr Village,25,5,8,9,0,0,22
Arkansas,Ash Flat,1168,217,423,177,55,156,1028
Arkansas,Wilmar,317,70,131,45,0,27,273
Arkansas,Piney,4380,855,1434,806,193,239,3527
Arkansas,London,786,157,322,141,16,46,682
Arkansas,Menifee,170,45,59,17,2,6,129
Arkansas,Morrilton,6640,1872,2044,759,140,501,5316
Arkansas,Maynard,491,89,169,62,5,24,349
Arkansas,Horatio,1027,242,305,112,31,69,759
Arkansas,Greenland,1806,317,651,235,44,69,1316
California,Newell,342,44,131,52,5,7,239
California,Pine Flat,149,26,56,23,4,11,120
California,North Richmond,4233,1437,1342,171,101,107,3158
California,North Gate,559,174,303,16,0,17,510
California,Norris Canyon,987,215,445,27,0,27,714
California,Nord,426,53,102,62,0,0,217
California,Nipinnawasee,319,53,211,0,0,0,264
California,Nicolaus,166,34,80,30,4,4,152
California,Nicasio,106,24,44,10,0,0,78
California,New Pine Creek,71,12,33,8,0,0,53
California,Pine Mountain Lake,2671,465,1472,265,76,129,2407
California,New Cuyama,763,193,277,47,7,24,548
California,Myers Flat,0,0,0,0,0,0,0
California,Mount Laguna,0,0,0,0,0,0,0
California,Mount Hermon,998,144,475,33,0,7,659
California,Newcastle,1167,194,502,187,6,96,985
California,Mountain House,15645,2023,7153,845,53,264,10338
California,Mountain Gate,794,150,415,128,0,70,763
California,Mountain Center,0,0,0,0,0,0,0
California,Moskowite Corner,151,0,100,6,0,11,117
California,Monument Hills,1700,327,934,74,28,66,1429
California,Monterey Park Tract,291,56,80,20,0,0,156
California,Montalvin Manor,3023,855,1127,203,10,57,2252
California,Monson,380,113,104,10,6,0,233
California,Mono City,98,0,52,0,0,0,52
California,Monmouth,103,37,16,3,2,23,81
California,Miranda,672,252,220,76,0,0,548
California,Minkler,1074,119,749,19,0,102,989
California,Milford,181,23,126,0,0,0,149
California,Midway City,8374,2691,3029,501,170,380,6771
California,Midpines,1396,247,645,108,0,118,1118
California,North San Juan,328,100,74,102,7,5,288
California,Pine Grove,1730,206,833,362,21,134,1556
California,North Shore,2892,805,1302,88,42,77,2314
California,Oak Glen,420,142,228,8,7,33,418
California,Pine Canyon,2294,801,963,103,20,89,1976
California,Pike,167,124,22,5,0,0,151
California,Pierpoint,0,0,0,0,0,0,0
California,Phoenix Lake,4283,589,2656,206,0,165,3616
California,Philo,201,37,84,16,9,10,156
California,Phillipsville,72,16,0,37,0,19,72
California,Phelan,15532,3200,6561,1067,207,759,11794
California,Peters,604,124,281,50,33,34,522
California,Pescadero,226,42,106,14,13,0,175
California,Penryn,925,199,397,24,24,103,747
California,Penngrove,2961,580,1521,204,17,93,2415
California,Paynes Creek,53,10,5,24,0,14,53
California,Patton Village,604,114,238,86,23,51,512
California,Patterson Tract,2351,370,1135,33,0,71,1609
California,Paskenta,105,21,31,24,5,8,89
California,Pasatiempo,1018,224,518,155,0,29,926
California,Parkway,15885,4580,4656,1074,490,790,11590
California,Parklawn,1082,201,507,48,0,24,780
California,Paradise Park,543,71,290,59,0,30,450
California,Paradise,186,55,67,17,2,13,154
California,Panorama Heights,42,0,18,11,2,11,42
California,Pajaro Dunes,255,23,203,8,0,21,255
California,Orick,296,105,79,48,11,23,266
California,Old Station,35,0,18,17,0,0,35
California,Old Fig Garden,5529,1328,2293,593,57,341,4612
California,Oasis,3020,753,1191,69,55,111,2179
California,Oakville,188,21,84,0,0,0,105
California,Oak Shores,282,24,144,38,0,40,246
California,Oak Hills,9700,2105,4736,500,306,561,8208
California,Nubieber,20,0,0,9,0,8,17
California,Piñon Hills,7592,1484,3249,576,207,624,6140
California,Coffee Creek,186,61,92,14,0,5,172
California,Plainview,863,252,246,38,46,23,605
California,Dobbins,662,224,182,31,0,30,467
California,Dogtown,2629,354,1559,129,33,132,2207
California,Dos Palos Y,242,36,113,32,0,22,203
California,Douglas City,668,121,284,87,6,32,530
California,Downieville,114,0,13,63,0,17,93
California,Doyle,622,99,252,192,7,45,595
California,Drytown,20,0,0,14,0,6,20
California,Dunnigan,1278,293,519,115,0,90,1017
California,Dutch Flat,196,27,67,52,13,27,186
California,Eagleville,81,13,53,0,0,7,73
California,East Nicolaus,254,46,98,22,0,17,183
California,East Rancho Dominguez,16734,5969,4991,667,494,398,12519
California,East Tulare Villa,980,277,414,38,14,28,771
California,Edmundson Acres,514,166,133,12,11,12,334
California,Diablo Grande,841,167,473,47,0,16,703
California,Edna,186,34,98,24,0,0,156
California,Elizabeth Lake,1895,493,824,110,50,108,1585
California,Elk Creek,191,33,94,8,0,4,139
California,El Nido,328,87,139,4,0,7,237
California,El Rancho,65,17,24,0,0,17,58
California,El Sobrante CDP (Contra Costa County),13736,4356,5510,904,212,588,11570
California,El Sobrante CDP (Riverside County),13966,2888,7024,688,49,268,10917
California,Elverta,5821,1445,2340,483,81,267,4616
California,Eucalyptus Hills,6017,764,2830,469,134,261,4458
California,Fairmead,1876,575,585,131,38,59,1388
California,Fiddletown,329,41,206,0,0,0,247
California,Fieldbrook,921,177,458,78,3,34,750
California,Fields Landing,325,158,111,56,0,0,325
California,Mexican Colony,363,110,74,22,14,13,233
California,Fish Camp,90,0,90,0,0,0,90
California,El Portal,268,64,89,0,17,21,191
California,Desert Palms,6947,444,4547,841,52,1063,6947
California,Desert Edge,3343,403,1772,460,55,380,3070
California,Desert Center,264,42,159,33,2,16,252
California,Winchester,2931,866,873,243,81,139,2202
California,Heber,4686,1299,1619,160,140,181,3399
California,Salton City,5611,1806,1811,318,122,342,4399
California,Cartago,7,0,0,0,0,7,7
California,Furnace Creek,127,96,21,0,0,9,126
California,Oak Park,13730,2480,6649,1200,96,512,10937
California,San Buenaventura (Ventura),110234,30124,42432,11057,1649,5315,90577
California,Clearlake Riviera,3933,628,1714,421,28,321,3112
California,Cleone,804,119,379,94,0,39,631
California,Clipper Mills,319,21,130,53,0,53,257
California,Coarsegold,1643,365,665,155,0,220,1405
California,Cohasset,990,104,600,76,0,16,796
California,Cold Springs CDP (El Dorado County),675,137,321,101,0,46,605
California,Cold Springs CDP (Tuolumne County),108,9,90,0,0,0,99
California,Coleville,515,255,151,18,0,0,424
California,College City,239,56,143,0,8,5,212
California,Collierville,2642,601,1259,126,51,151,2188
California,Descanso,1644,233,815,123,30,99,1300
California,Delft Colony,653,189,125,21,52,0,387
California,Davenport,264,62,126,27,0,19,234
California,Daphnedale Park,135,32,45,0,0,9,86
California,Cuyama,9,0,6,0,0,3,9
California,Crows Landing,278,97,87,23,0,23,230
California,Pioneer,1443,143,841,131,15,55,1185
California,Crowley Lake,889,253,266,108,44,17,688
California,Cressey,356,88,101,38,22,11,260
California,Cowan,570,105,190,0,0,15,310
California,Courtland,537,95,163,190,0,8,456
California,Coronita,3138,869,1233,175,24,67,2368
California,Comptche,83,23,32,12,0,0,67
California,Coloma,673,116,482,53,9,13,673
California,Creston,30,0,30,0,0,0,30
California,Mesa Verde,584,120,200,88,23,21,452
California,Blairsden,25,0,18,7,0,0,25
California,Mead Valley,19925,5494,6857,1081,456,939,14827
California,Floriston,20,0,0,7,0,13,20
California,Keeler,15,6,4,0,0,5,15
California,Victorville,121861,34007,38178,9585,3195,4186,89151
California,Rainbow,1994,389,930,237,68,114,1738
California,Carrick,47,9,22,16,0,0,47
California,Shandon,1141,249,531,103,29,56,968
California,Oceano,7678,1781,2944,992,195,258,6170
California,Atascadero,30037,6909,13284,2827,461,1202,24683
California,Arroyo Grande,18039,3779,8423,1807,324,890,15223
California,Dixon,19759,4951,7923,1278,421,530,15103
California,Point Arena,418,111,139,78,5,14,347
California,Benicia,28088,6050,13150,2536,467,1252,23455
California,Elkhorn,1151,355,470,104,0,110,1039
California,Del Rey Oaks,1596,320,771,179,39,54,1363
California,El Cajon,103285,28869,36201,9428,1810,4763,81071
California,Del Mar,4340,1226,2015,390,83,116,3830
California,Bostonia,17530,5201,5904,1657,215,675,13652
California,Castroville,6686,1882,2193,363,10,156,4604
California,Borrego Springs,2252,675,1145,120,53,39,2032
California,Thermalito,6704,1916,2048,948,64,359,5335
California,South Oroville,3181,1059,794,348,151,154,2506
California,Daly City,106638,35732,42516,7072,1847,5633,92800
California,Sand City,318,115,108,41,8,5,277
California,Atherton,7185,1691,3451,361,32,307,5842
California,Crest,2746,559,1355,256,10,122,2302
California,San Diego Country Estates,10381,1860,5330,803,56,385,8434
California,Klamath,617,136,172,110,23,61,502
California,Crescent City,6681,2815,1669,933,281,225,5923
California,Bertsch-Oceanview,2042,341,747,216,95,226,1625
California,Oakhurst,3424,705,1276,477,113,113,2684
California,Valley Ranch,10,0,10,0,0,0,10
California,Paxton,0,0,0,0,0,0,0
California,Hilmar-Irwin,5846,1449,2444,447,137,346,4823
California,Vine Hill,3887,780,1578,487,66,111,3022
California,Richmond,109340,35896,37185,8916,2817,4236,89050
California,Byron,1348,384,529,107,21,95,1136
California,Rancho San Diego,21289,4984,9353,1846,382,1337,17902
California,Alamo,15317,2847,8522,687,69,543,12668
California,Ashland,23635,8407,6845,1844,620,1001,18717
California,Beale AFB,1039,46,601,12,5,0,664
California,Tustin,80140,24105,29200,5863,1553,2563,63284
California,Rossmoor,11160,2384,5308,759,107,543,9101
California,Huntington Beach,200606,55790,81896,19489,2635,8658,168468
California,Dana Point,33913,7208,15877,3643,515,1952,29195
California,Cypress,48955,12380,22057,3496,478,2185,40596
California,Brea,42330,10386,18218,3084,628,1737,34053
California,Fullerton,139866,44347,53092,9499,1896,5795,114629
California,Anaheim,349668,106457,128316,23896,6956,13528,279153
California,Diablo,364,20,324,20,0,0,364
California,Clearlake,15323,4263,3628,2573,401,1088,11953
California,Los Banos,38119,9955,13723,1854,526,1196,27254
California,China Lake Acres,1947,490,668,133,49,64,1404
California,Kennedy,3665,788,1273,268,2,167,2498
California,Country Club,9846,2904,3343,1121,141,369,7878
California,Susanville,15216,7318,3969,1534,220,464,13505
California,Cameron Park,19902,4799,8158,2199,382,931,16469
California,Mariposa,1351,330,603,259,0,70,1262
California,Novato,55523,13807,24194,5411,525,2597,46534
California,Muir Beach,242,42,133,61,0,0,236
California,Madera,64362,18042,21117,3280,1193,2556,46188
California,Lake Almanor Country Club,302,34,198,37,0,33,302
California,Almanor,0,0,0,0,0,0,0
California,Merced,82289,25951,24303,6931,1702,3083,61970
California,Wilkerson,431,54,280,14,0,8,356
California,Round Valley,533,277,130,82,0,28,517
California,Big Pine,1568,262,555,171,53,197,1238
California,Toro Canyon,1735,305,923,108,36,113,1485
California,Montecito,8611,2396,3601,685,76,606,7364
California,Bear Valley Springs,5442,759,3007,616,42,349,4773
California,West Menlo Park,4116,827,1793,288,40,100,3048
California,Palm Springs,47525,15677,17208,5837,721,3295,42738
California,La Quinta,40704,8249,19275,4038,665,1668,33895
California,Lake Elsinore,64037,16839,22953,4033,1232,1596,46653
California,Reedley,25493,6568,9875,1403,324,1054,19224
California,West Bishop,2661,492,1428,105,27,144,2196
California,Half Moon Bay,12706,2983,6237,983,80,460,10743
California,Portola Valley,4594,747,2394,353,33,372,3899
California,Meadow Valley,362,43,196,56,13,32,340
California,Walnut Creek,69007,15098,32329,6624,635,4953,59639
California,Pittsburg,70492,20586,24345,5899,1906,2395,55131
California,Mountain View,2066,494,898,305,0,60,1757
California,Martinez,38117,10026,16278,4098,392,1385,32179
California,Lafayette,26060,5251,12908,1644,274,728,20805
California,San Bruno,43114,12181,18202,3164,512,2052,36111
California,Redwood City,85217,24387,34650,6007,1373,2873,69290
California,East Palo Alto,29633,10622,9408,1620,546,666,22862
California,Livingston,13997,3616,5860,405,154,325,10360
California,Twain,33,0,0,0,0,33,33
California,Tracy,88806,22642,36250,5566,1261,2837,68556
California,Storrie,0,0,0,0,0,0,0
California,Lake Almanor West,126,6,116,0,0,4,126
California,Point Reyes Station,290,32,125,125,0,8,290
California,Inverness,1127,136,673,148,0,76,1033
California,Santa Paula,30258,8262,11055,1934,450,1215,22916
California,Port Hueneme,22215,7011,7816,1711,356,762,17656
California,Ojai,7555,1846,2990,989,104,401,6330
California,Rollingwood,3110,1078,840,270,86,135,2409
California,Pinole,19264,5116,7994,1916,270,1112,16408
California,Iron Horse,60,0,0,60,0,0,60
California,Chilcoot-Vinton,147,0,32,28,0,87,147
California,Portola,1912,342,734,242,60,146,1524
California,Middletown,757,246,242,42,0,36,566
California,Arcata,18050,10684,3718,1407,182,453,16444
California,Humboldt Hill,4268,1399,1563,308,22,176,3468
California,Loma Mar,114,6,50,10,0,0,66
California,Loleta,676,168,173,93,3,28,465
California,Lodoga,126,30,38,29,3,7,107
California,Lockwood,604,188,124,33,24,25,394
California,Little River,189,147,11,28,0,0,186
California,Litchfield,178,15,77,0,8,20,120
California,Linnell Camp,686,200,233,35,0,12,480
California,Likely,0,0,0,0,0,0,0
California,Leona Valley,1581,445,702,134,23,75,1379
California,Lemon Hill,14096,4077,3889,1222,458,564,10210
California,Lompico,887,203,392,158,9,28,790
California,Lindcove,438,112,184,52,0,17,365
California,Lee Vining,89,43,41,0,0,5,89
California,La Vina,239,0,91,0,0,40,131
California,Las Flores CDP (Tehama County),294,65,156,0,0,6,227
California,San Marcos,94709,22844,38119,7371,1147,3399,72880
California,Rancho Santa Fe,2591,618,1370,164,12,164,2328
California,National City,60896,19795,20942,4976,1350,3200,50263
California,Lakeside,22560,5702,9038,2225,343,1264,18572
California,Hacienda Heights,54970,14875,24862,2819,662,2877,46095
California,East Pasadena,5971,1678,2676,310,83,226,4973
California,East Los Angeles,119827,41144,37849,5248,3658,5113,93012
California,Leggett,62,10,8,24,2,0,44
California,Desert View Highlands,2496,672,892,127,129,116,1936
California,Long Barn,93,0,56,0,0,37,93
California,Los Berros,541,191,272,0,0,24,487
California,Meadowbrook,3033,817,1275,216,26,171,2505
California,Mayfair,5091,1962,1230,540,95,124,3951
California,Maxwell,1096,219,447,69,11,86,832
California,Mather,4408,1080,1910,247,40,224,3501
California,Matheny,1134,322,366,53,22,21,784
California,Martell,300,79,148,0,0,0,227
California,Marin City,3173,940,984,298,58,97,2377
California,March ARB,1150,130,431,133,7,212,913
California,Manila,834,352,157,142,10,98,759
California,Manchester,199,50,86,24,0,4,164
California,Lookout,76,5,21,0,0,17,43
California,Mad River,432,94,158,59,0,9,320
California,McSwain,4137,852,2126,323,26,140,3467
California,McGee Creek,0,0,0,0,0,0,0
California,McClenney Tract,41,25,12,4,0,0,41
California,McClellan Park,809,251,105,133,42,116,647
California,Mabie,74,0,60,14,0,0,74
California,Lytle Creek,724,119,339,113,29,80,680
California,Lucerne Valley,5423,1306,1877,764,208,291,4446
California,Los Ranchos,1730,258,1038,35,0,112,1443
California,Los Osos,16292,3056,8264,1418,234,878,13850
California,Los Olivos,831,102,448,82,8,85,725
California,Madison,563,162,234,34,0,0,430
California,Burbank,104275,32400,41250,8093,1324,4971,88038
California,Orange Cove,9564,2564,2810,413,269,287,6343
California,Kingsburg,11839,2851,4902,726,99,651,9229
California,Oceanside,175389,44733,71007,17556,2494,8116,143906
California,Nipomo,17445,4530,7732,1239,282,692,14475
California,Rio del Mar,9775,2134,4737,1045,67,445,8428
California,Live Oak,17390,5243,6529,1604,156,821,14353
California,Interlaken,7191,2195,2738,409,147,169,5658
California,West Sacramento,52826,13227,19762,4900,1083,1744,40716
California,Fresno,522277,164464,157749,41875,11744,19174,395006
California,Coalinga,16538,6250,4593,1401,395,437,13076
California,Rodeo,10411,3071,3676,847,227,525,8346
California,Oakley,40669,10194,16206,2700,707,1005,30812
California,Markleeville,143,69,42,24,0,0,135
California,Round Mountain,112,3,63,19,0,14,99
California,Tuolumne City,1577,639,342,99,86,44,1210
California,Hercules,25343,6693,11234,1794,328,947,20996
California,Jamestown,2687,696,1034,304,29,324,2387
California,Columbia,2217,559,817,258,65,258,1957
California,Calistoga,5285,1760,1795,638,50,197,4440
California,Angwin,3424,1829,987,202,12,97,3127
California,West Athens,8574,3023,2742,611,207,427,7010
California,View Park-Windsor Hills,11580,4092,3882,1208,154,765,10101
California,Vernon,90,24,32,9,1,2,68
California,Temple City,36137,9339,16193,1928,286,2216,29962
California,Millville,682,107,323,78,11,29,548
California,Morro Bay,10592,2774,4191,1498,194,624,9281
California,Fort Jones,832,144,319,81,10,62,616
California,Grenada,477,81,175,38,0,39,333
California,Fowler,6364,1771,2028,479,206,299,4783
California,Del Rey,1498,463,485,52,43,36,1079
California,Piedmont,11308,1654,6363,571,22,387,8997
California,Oakland,421042,158374,133136,34517,7942,16097,350066
California,Atwater,29197,7732,9897,2051,731,1242,21653
California,Ukiah,15946,4148,5573,2305,179,598,12803
California,Covelo,1165,305,299,171,34,105,914
California,Pleasanton,80847,14980,41336,4570,626,3180,64692
California,Bethel Island,2010,494,856,188,31,187,1756
California,South Dos Palos,1682,572,498,111,0,88,1269
California,Quincy,1895,630,572,333,12,121,1668
California,Prattville,28,0,28,0,0,0,28
California,Plumas Eureka,333,21,229,34,0,43,327
California,Indian Falls,54,33,0,21,0,0,54
California,Graeagle,596,47,373,58,16,45,539
California,Cromberg,253,30,139,31,0,53,253
California,Tecopa,146,36,26,49,0,12,123
California,Pearsonville,29,0,13,0,0,16,29
California,Valley Acres,617,80,270,55,0,44,449
California,Shafter,18923,5455,6633,741,315,574,13718
California,Pine Mountain Club,1803,566,590,228,77,122,1583
California,Lamont,15222,4721,5104,463,225,247,10760
California,Norwalk,105886,33788,38465,6086,1966,4456,84761
California,Meridian,405,87,177,54,3,15,336
California,Flournoy,171,21,92,6,0,3,122
California,Santee,57615,14305,23811,5751,793,2612,47272
California,Forest Ranch,538,102,274,92,0,16,484
California,Plymouth,894,179,376,61,17,61,694
California,Jackson,4694,1068,1842,450,198,385,3943
California,Pollock Pines,6905,1424,2839,837,79,477,5656
California,Placerville,10860,2685,4069,1188,179,964,9085
California,Diamond Springs,11989,2380,5122,1545,206,948,10201
California,Redding,91327,22357,34482,11235,1214,5427,74715
California,Anderson,10265,2304,3581,1258,252,460,7855
California,Greenhorn,254,47,109,56,0,4,216
California,East Shore,169,22,97,15,5,30,169
California,C-Road,97,4,79,3,0,0,86
California,Clio,65,11,35,11,0,0,57
California,Sutter Creek,2538,508,952,426,59,191,2136
California,Amador City,167,41,58,31,0,2,132
California,San Ramon,75384,13664,38172,3673,460,1612,57581
California,Pacheco,4355,1424,1721,517,45,210,3917
California,Discovery Bay,15981,3261,7480,1569,219,322,12851
California,Danville,44417,7608,21761,3268,307,2085,35029
California,Concord,128758,34344,52613,12047,1964,5022,105990
California,Clayton,11967,2326,6029,838,117,509,9819
California,Cherryland,16387,5390,5203,1335,366,522,12816
California,North El Monte,4028,969,1736,245,40,91,3081
California,Bishop,3765,1228,1146,335,98,371,3178
California,Darwin,56,18,26,0,0,12,56
California,Lone Pine,1837,519,657,121,40,103,1440
California,Mesa,317,36,195,50,0,9,290
California,Selma,24598,7064,8386,1500,281,965,18196
California,Riverdale,3625,863,1614,79,46,62,2664
California,Caruthers,2773,914,901,123,34,223,2195
California,Union City,74601,20381,34924,3628,846,3165,62944
California,Sunol,962,217,509,90,2,27,845
California,Friant,548,96,207,64,39,27,433
California,Desert Hot Springs,28430,8259,8252,2830,699,1205,21245
California,Weaverville,3240,622,1090,574,7,319,2612
California,Pine Hills,3146,553,1244,407,66,250,2520
California,Myrtletown,5290,1903,1119,965,167,405,4559
California,Whittier,86523,26685,31257,5915,1654,4425,69936
California,Cobb,920,104,579,130,0,29,842
California,Big Bend,96,29,28,12,4,6,79
California,Taft Mosswood,951,255,352,95,22,88,812
California,Ripon,15367,3460,6621,953,134,724,11892
California,Manteca,77073,19101,30421,6063,1341,3069,59995
California,Whitehawk,66,0,61,0,0,5,66
California,Spring Garden,13,0,0,13,0,0,13
California,Lake Davis,65,0,49,0,0,16,65
California,Hamilton Branch,612,77,336,57,5,31,506
California,Chester,2116,376,1019,317,10,119,1841
California,Caribou,0,0,0,0,0,0,0
California,Palo Cedro,1151,251,565,72,0,47,935
California,Westmorland,2643,752,744,109,52,99,1756
California,Rolling Hills,1630,280,874,58,22,138,1372
California,Solana Beach,13370,3370,5818,1490,15,781,11474
California,Signal Hill,11538,4144,3803,1021,71,435,9474
California,Pico Rivera,63432,21109,21945,4132,1113,3157,51456
California,Montebello,63099,22251,20106,3629,1396,3777,51159
California,Mayflower Village,5822,1766,2534,310,27,277,4914
California,Culver City,39295,11593,16101,3354,261,1697,33006
California,Las Lomas,3755,1269,1115,193,84,82,2743
California,Santa Clarita,209478,54040,85500,15895,2611,6941,164987
California,Taft,9307,2667,2922,852,142,627,7210
California,San Pablo,30839,10820,9703,2199,669,1049,24440
California,Port Costa,186,86,0,100,0,0,186
California,South Whittier,60096,18442,22556,3360,1065,2058,47481
California,Yosemite Valley,1110,599,279,171,17,0,1066
California,La Selva Beach,2917,706,1220,301,17,182,2426
California,Lake Sherwood,1835,367,1063,98,14,43,1585
California,Lake Riverside,1049,237,425,123,0,35,820
California,Lake Mathews,6848,1723,2502,698,193,224,5340
California,Lake Hughes,587,126,247,100,0,54,527
California,Lakehead,617,131,256,97,6,19,509
California,Lake Don Pedro,1030,134,526,113,23,113,909
California,Lake City,59,0,52,0,0,7,59
California,Lake California,3281,408,1741,178,20,150,2497
California,La Honda,711,319,188,86,0,61,654
California,Las Flores CDP (Orange County),5877,1105,2782,332,46,61,4326
California,Davis,67988,32388,21791,3350,660,1562,59751
California,Walnut Park,16034,6126,5236,708,346,641,13057
California,Willow Creek,1539,190,751,205,21,59,1226
California,Fort Bragg,7298,2137,1882,1266,228,353,5866
California,Duarte,21713,6540,8502,1794,347,1100,18283
California,Eldridge,1351,414,693,20,0,0,1127
California,Mendocino,782,263,352,106,0,46,767
California,Agoura Hills,20636,5097,9921,1391,293,536,17238
California,Los Molinos,1845,409,735,148,16,103,1411
California,La Presa,37437,10688,13588,2998,894,1554,29722
California,Poplar-Cotton Center,2436,1029,840,45,84,72,2070
California,Lemoore,25791,7312,9264,1628,361,812,19377
California,Santa Ana,333499,109797,112895,17323,7740,10001,257756
California,Westlake Village,8424,1458,4516,644,63,525,7206
California,Lake Forest,82911,20946,36838,6790,907,2672,68153
California,Mountain View,80993,24190,33821,5818,842,2274,66945
California,West Point,571,97,207,116,0,93,513
California,El Dorado Hills,45599,8237,23105,2784,312,1337,35775
California,Niland,515,107,155,46,36,36,380
California,Bombay Beach,415,83,182,79,6,53,403
California,Westhaven-Moonstone,1084,238,457,140,33,31,899
California,Trinidad,272,78,127,21,6,14,246
California,Fortuna,12117,3056,4386,1367,247,726,9782
California,Upper Lake,1050,243,437,89,0,31,800
California,Nice,2393,625,889,460,12,101,2087
California,Bonsall,4464,1057,2060,425,47,229,3818
California,Esparto,3783,558,1611,255,75,227,2726
California,Aptos Hills-Larkin Valley,1993,522,953,224,38,76,1813
California,Ben Lomond,7071,2056,2944,728,21,182,5931
California,Tipton,3218,978,1029,79,104,56,2246
California,San Juan Capistrano,35952,7013,16666,2857,345,1723,28604
California,Ivanhoe,4198,1051,1711,305,34,145,3246
California,East Porterville,6679,1851,1931,355,178,387,4702
California,Waterford,8823,1972,3531,538,225,162,6428
California,Bystrom,4099,1316,1192,372,33,87,3000
California,Perris,76276,22702,25323,4541,1327,1919,55812
California,Indian Wells,5317,556,3468,536,5,544,5109
California,Hemet,84069,19168,28918,9547,1647,6341,65621
California,Mission Canyon,2755,605,1498,216,41,86,2446
California,Woodville,1852,523,649,104,41,56,1373
California,Los Alamos,1623,500,622,36,45,51,1254
California,Morongo Valley,3262,940,1013,541,86,223,2803
California,Joshua Tree,6980,2047,2169,1105,10,552,5883
California,Yucca Valley,21543,4103,7937,3046,585,1774,17445
California,Highland,54859,15223,19592,3796,994,1819,41424
California,Westwood,1545,206,860,125,37,120,1348
California,Alturas,2577,488,820,648,12,179,2147
California,McArthur,386,69,223,28,0,0,320
California,Burney,3807,743,1396,352,146,221,2858
California,Soulsbyville,2286,709,878,162,0,77,1826
California,Windsor,27506,6499,12219,2097,471,1142,22428
California,Ontario,173580,54850,60196,11044,3920,5700,135710
California,Sonoma,11074,2415,4775,1431,64,987,9672
California,Rancho Santa Margarita,48792,10436,22470,4137,502,1028,38573
California,Big Bear Lake,5229,1211,2012,757,126,246,4352
California,Thousand Oaks,128481,30843,57458,10524,1384,5745,105954
California,Olancha,213,49,128,0,0,33,210
California,Independence,542,134,175,83,18,68,478
California,Ione,7439,2616,2751,1161,136,352,7016
California,Bonadelle Ranchos-Madera Ranchos,8971,1770,4472,473,133,261,7109
California,Seeley,1699,473,480,106,101,181,1341
California,Palo Verde,85,0,0,36,0,49,85
California,Calipatria,7458,3712,1585,624,271,200,6392
California,Palm Desert,52124,11755,23243,5715,945,4134,45792
California,Exeter,10505,2565,3561,814,155,534,7629
California,Olivehurst,13309,3258,4815,1500,147,526,10246
California,Ducor,651,177,248,13,5,27,470
California,Auburn,13946,3095,5912,1811,249,902,11969
California,Boulder Creek,4712,1151,2087,532,67,171,4008
California,Aptos,5797,1540,2586,635,10,407,5178
California,South San Gabriel,8643,2483,3791,487,141,608,7510
California,Rosemead,54417,17094,22289,2678,559,2793,45413
California,Willows,6022,1352,2421,463,183,292,4711
California,Wilton,5307,796,3037,307,60,154,4354
California,Gold River,7523,1160,4221,705,62,416,6564
California,Citrus Heights,87061,23626,30674,10766,1972,4842,71880
California,Arden-Arcade,100548,28678,33765,10884,2343,5010,80680
California,Dollar Point,786,302,315,109,26,8,760
California,Ladera Ranch,30288,4262,14039,1605,315,401,20622
California,Monte Rio,1156,396,301,225,14,67,1003
California,Hanford,55893,14177,20466,4772,1064,2240,42719
California,Alameda,78462,21167,32719,6445,1125,3480,64936
California,San Gabriel,40242,12471,16817,2553,347,2134,34322
California,Sierra Madre,11006,2246,5157,1228,102,478,9211
California,Santa Fe Springs,17791,5559,6150,1269,268,1132,14378
California,San Marino,13285,2656,7292,418,25,645,11036
California,Redondo Beach,67700,17607,28542,6330,1026,2014,55519
California,Quartz Hill,10164,3004,3920,771,73,411,8179
California,Palmdale,156904,45133,53997,10211,2959,5413,117713
California,Monrovia,37006,11092,13969,3554,714,1258,30587
California,Maywood,27542,9975,8292,888,669,775,20599
California,Albany,19758,4709,8512,1540,193,505,15459
California,Manhattan Beach,35573,7879,16540,2514,191,1000,28124
California,Downey,112901,35947,39729,7996,2342,4441,90455
California,Del Aire,10065,3002,3838,623,151,307,7921
California,Covina,48403,14621,18381,3482,869,2060,39413
California,Bell Gardens,42641,16577,12006,1274,947,1043,31847
California,Tranquillity,839,150,273,80,29,24,556
California,Mendota,11393,3860,3116,325,197,341,7839
California,Beverly Hills,34362,9470,14271,2842,460,2210,29253
California,Laton,2166,501,780,122,62,71,1536
California,Lanare,234,57,80,38,0,17,192
California,Capitola,10135,2609,3995,1379,139,595,8717
California,Glendale,200372,57272,85855,12682,3036,12174,171019
California,San Juan Bautista,2106,502,701,299,17,105,1624
California,Lynwood,71022,26093,21504,2799,1746,2186,54328
California,San Lorenzo,25388,6671,11520,1520,335,1143,21189
California,Dos Palos,5272,1252,1993,248,93,240,3826
California,Delhi,11735,3313,4229,615,277,266,8700
California,Lake Los Angeles,11469,3504,4008,654,53,381,8600
California,Huntington Park,58694,21228,17541,2456,1596,1842,44663
California,Glendora,51773,13358,21395,4353,728,2495,42329
California,El Monte,115669,39800,40475,5435,2728,4642,93080
California,Claremont,36025,12193,14091,2668,439,1485,30876
California,Altadena,45146,13199,18550,3413,731,2129,38022
California,Alondra Park,8097,2720,2869,534,93,229,6445
California,Orange,139873,44674,53472,10208,1633,4967,114954
California,Fairview,10299,2851,4183,966,91,636,8727
California,Costa Mesa,113198,38934,39515,10222,1429,3757,93857
California,Dublin,59172,10888,29276,3441,640,1298,45543
California,Placentia,52049,13603,21725,3470,713,2435,41946
California,Laguna Beach,23147,5320,10797,3177,207,885,20386
California,Richgrove,2611,864,953,70,43,56,1986
California,Stanton,38509,11767,13724,2768,875,1273,30407
California,Rolling Hills Estates,8187,1155,4483,530,55,486,6709
California,Palos Verdes Estates,13523,2613,7581,489,25,619,11327
California,Los Angeles,3959657,1499067,1262379,268129,86081,150547,3266203
California,Oakdale,22599,5108,8011,2301,647,1050,17117
California,Denair,5131,1281,2254,309,66,134,4044
California,Emeryville,11724,5277,3756,1121,197,444,10795
California,Knights Landing,869,168,428,78,19,42,735
California,Kingvale,73,0,65,0,0,0,65
California,Keswick,430,86,157,83,0,7,333
California,Delano,52713,17741,17660,2588,1486,1748,41223
California,Bodfish,1384,167,632,122,105,206,1232
California,Corte Madera,9866,1828,4209,1106,98,405,7646
California,Bolinas,1077,325,461,154,7,34,981
California,Ocotillo,58,6,22,5,0,18,51
California,Desert Shores,619,195,164,66,10,87,522
California,Calexico,39934,12280,12958,2412,907,2041,30598
California,Thousand Palms,7814,1664,3048,706,302,673,6393
California,Murrieta,111427,26348,45141,7940,2135,3939,85503
California,Indio,88291,23891,35288,6468,1362,3771,70780
California,Channel Islands Beach,2864,834,1122,365,94,48,2463
California,Romoland,2227,808,778,60,14,127,1787
California,Truckee,16377,4238,7550,1144,73,208,13213
California,Lake of the Pines,4137,799,2065,431,0,330,3625
California,North Lakeport,3141,639,1329,411,17,280,2676
California,Lucerne,2956,874,932,380,77,214,2477
California,Imperial,17175,4444,5193,1335,464,492,11928
California,Holtville,6458,1755,2305,412,128,181,4781
California,El Centro,43898,12171,14189,3034,1333,2228,32955
California,Brawley,26009,6890,8011,1920,627,1246,18694
California,Home Gardens,11442,3100,4054,815,482,351,8802
California,Calimesa,8651,1732,3670,998,139,715,7254
California,Dillon Beach,219,23,64,40,9,8,144
California,Banning,30942,7820,10577,3151,732,2746,25026
California,Torrance,146392,36417,65873,10170,1556,7112,121128
California,La Mirada,48974,14658,20152,3435,507,2649,41401
California,Coulterville,38,3,10,25,0,0,38
California,Avila Beach,1273,281,714,129,0,123,1247
California,Jurupa Valley,103784,30969,36150,6945,1903,3959,79926
California,East Whittier,10391,2697,4305,879,195,580,8656
California,Vincent,17008,5080,6503,1104,197,559,13443
California,Temescal Valley,26709,5943,11962,1740,336,756,20737
California,Pleasure Point,6277,2110,2306,799,99,264,5578
California,Whitewater,976,264,321,104,6,27,722
California,Eastvale,61337,14443,25766,2909,987,1453,45558
California,Contra Costa Centre,6497,2446,2444,891,19,21,5821
California,Valinda,25296,8337,9472,1339,331,1139,20618
California,Kennedy Meadows,20,0,0,20,0,0,20
California,June Lake,508,20,319,0,0,25,364
California,Junction City,688,119,398,85,0,21,623
California,Johnstonville,1185,281,571,89,14,22,977
California,Jenner,32,18,0,14,0,0,32
California,Janesville,1278,103,860,75,3,0,1041
California,San Dimas,34239,8977,14977,2393,278,2028,28653
California,Marina del Rey,9771,4452,2718,1444,159,354,9127
California,Littlerock,1766,629,537,11,13,108,1298
California,Lawndale,33007,10660,11605,2639,425,1054,26383
California,La Verne,32358,8222,13412,2774,397,2007,26812
California,Kelly Ridge,2679,404,1089,513,17,312,2335
California,University of California-Davis,7379,6774,421,23,0,0,7218
California,Jacumba,202,19,155,28,0,0,202
California,Indianola,686,195,256,88,20,23,582
California,Graniteville,0,0,0,0,0,0,0
California,Grangeville,586,73,261,15,15,24,388
California,Goodyears Bar,29,11,18,0,0,0,29
California,Good Hope,9173,2473,3130,545,295,275,6718
California,Gold Mountain,0,0,0,0,0,0,0
California,Geyserville,928,197,445,95,0,32,769
California,Gerber,1259,214,511,210,70,45,1050
California,Gasquet,620,215,104,84,0,155,558
California,Garnet,5057,1207,2047,351,88,102,3795
California,Garey,160,69,61,17,1,6,154
California,Greeley Hill,687,41,475,64,36,62,678
California,Garden Farms,345,75,181,0,0,43,299
California,Fulton,566,120,190,20,0,10,340
California,Fuller Acres,841,289,233,38,32,12,604
California,Fruitridge Pocket,6215,2139,1583,520,106,305,4653
California,French Valley,33818,6704,13872,2111,531,781,23999
California,Freeport,81,0,49,32,0,0,81
California,Franklin CDP (Sacramento County),117,38,44,29,0,6,117
California,Franklin CDP (Merced County),7314,2178,1973,631,174,297,5253
California,Fort Washington,783,25,358,0,0,35,418
California,Fort Irwin,9086,1987,3538,381,128,25,6059
California,Fort Bidwell,181,53,36,34,1,12,136
California,Garberville,1126,428,240,224,24,0,916
California,Indio Hills,708,194,293,28,17,19,551
California,Green Acres,2542,868,733,144,82,112,1939
California,Green Valley CDP (Los Angeles County),973,219,430,118,28,23,818
California,Idlewild,0,0,0,0,0,0,0
California,Hyampom,165,0,119,25,0,21,165
California,Hornitos,61,0,52,9,0,0,61
California,Hopland,921,350,210,49,0,10,619
California,Hood,303,64,96,29,34,20,243
California,Honcut,135,39,45,39,0,0,123
California,Homewood Canyon,35,0,15,9,0,11,35
California,Homestead Valley,2723,575,1055,575,56,367,2628
California,Herlong,1353,789,286,32,174,16,1297
California,Herald,1058,221,549,88,13,88,959
California,Greenfield,3534,903,1662,173,142,42,2922
California,Hat Creek,164,12,114,8,0,30,164
California,Hasley Canyon,1085,307,494,60,6,42,909
California,Hartley,2907,563,1487,231,61,217,2559
California,Hartland,0,0,0,0,0,0,0
California,Hardwick,30,6,24,0,0,0,30
California,Happy Camp,810,136,306,138,51,80,711
California,Guinda,175,0,111,0,0,0,111
California,Groveland,307,18,168,56,0,65,307
California,Grizzly Flats,1087,195,545,69,62,43,914
California,Grimes,358,15,142,0,0,9,166
California,Green Valley CDP (Solano County),1572,97,972,181,22,175,1447
California,Hiouchi,433,118,281,15,0,19,433
California,Forbestown,221,0,152,69,0,0,221
California,University of California-Merced,0,0,0,0,0,0,0
California,Fort Dick,830,125,512,101,0,49,787
California,Lompoc,43511,11838,14496,4080,1086,1734,33234
California,Twentynine Palms,26109,7061,10079,1695,288,619,19742
California,San Antonio Heights,3034,827,1546,187,27,99,2686
California,Mountain View Acres,4260,1250,1312,309,81,235,3187
California,Montclair,38865,13425,12251,2741,913,1387,30717
California,Lenwood,3884,1076,958,301,100,206,2641
California,Arbuckle,3636,888,1557,175,35,51,2706
California,Tulare,62838,17431,20852,4472,706,2223,45684
California,Terra Bella,3304,999,1375,65,80,55,2574
California,Pixley,3796,957,1280,142,16,69,2464
California,Solvang,5734,1477,2413,503,73,411,4877
California,Lindsay,13232,3302,4558,696,354,499,9409
California,Earlimart,8790,2633,3103,254,152,164,6306
California,Watsonville,53616,15584,18599,2954,558,1723,39418
California,Valley Springs,3428,869,1735,296,20,197,3117
California,Avery,559,81,278,24,0,49,432
California,Walnut Grove,1300,194,698,52,67,48,1059
California,Sacramento,495011,159458,162585,44047,9791,21056,396937
California,Folsom,77007,16692,34260,6885,1185,2888,61910
California,American Canyon,20306,5419,8165,1416,181,797,15978
California,Woodlake,7636,1913,2710,521,108,246,5498
California,Traver,740,218,233,44,13,34,542
California,East Orosi,955,362,238,16,18,12,646
California,Lemon Cove,267,37,176,4,0,22,239
California,Vandenberg Village,7861,1652,3677,758,8,374,6469
California,North Highlands,48968,14091,15674,4523,885,2014,37187
California,Ladera,1465,183,797,54,0,71,1105
California,Kenwood,800,170,495,53,0,35,753
California,La Cañada Flintridge,20374,4166,10689,720,155,822,16552
California,Malaga,1337,378,437,53,8,67,943
California,Angels,3811,823,1707,497,46,302,3375
California,Orosi,7441,2559,2267,264,190,221,5501
California,North Tustin,24736,4904,13398,1217,179,1265,20963
California,Wildomar,36162,10186,13901,2693,624,1656,29060
California,Menifee,88515,20120,36049,8088,1567,4831,70655
California,Rancho Cordova,72056,20395,25340,7031,1570,2629,56965
California,Foothill Farms,33749,9701,11519,3472,778,1114,26584
California,Moraga,17398,4557,8055,964,148,759,14483
California,Goleta,30790,9541,11998,2450,292,1365,25646
California,Elk Grove,168503,40470,71978,11470,2352,6104,132374
California,Aliso Viejo,50925,11817,21662,4860,400,1510,40249
California,East Oakdale,3344,601,1946,189,34,144,2914
California,Soquel,10862,3034,4250,1166,141,347,8938
California,Rancho Palos Verdes,42271,7352,23076,2493,269,2226,35416
California,Malibu,12846,2883,5915,1589,196,677,11260
California,Lakewood,80771,22764,32662,6344,1124,3621,66515
California,La Habra Heights,5383,1365,2688,393,67,283,4796
California,La Crescenta-Montrose,19500,4454,9050,1462,148,993,16107
California,Yountville,2982,477,1136,631,26,555,2825
California,Fairhaven,145,51,67,6,7,6,137
California,Dinuba,23871,6964,7396,1110,672,831,16973
California,Three Rivers,2397,436,1309,237,43,107,2132
California,Bonita,13324,3401,5631,992,105,898,11027
California,Santa Clara,126209,37680,54195,7231,1317,4017,104440
California,San Francisco,870044,353092,308885,61439,10647,35802,769865
California,San Martin,7010,1878,3058,340,46,374,5696
California,San Jose,1026658,294452,422089,65666,13522,36037,831766
California,Raisin City,389,121,95,24,7,29,276
California,Kerman,14649,3860,5193,728,216,590,10587
California,Easton,2206,425,914,159,73,87,1658
California,Newark,46276,12884,20688,2657,238,1715,38182
California,Los Alamitos,11628,3018,4465,1090,293,562,9428
California,Harbison Canyon,4223,1015,1901,370,42,118,3446
California,Irvine,265502,76149,113932,16502,2245,6730,215558
California,Avenal,12923,4626,3419,1004,478,148,9675
California,Fountain Valley,56372,15011,25219,4056,673,2511,47470
California,Temelec,1564,233,691,370,16,254,1564
California,Santa Rosa,181038,51279,65065,20092,2879,8327,147642
California,Boyes Hot Springs,7863,2175,2612,746,166,191,5890
California,Bodega Bay,733,183,362,128,0,60,733
California,Westside,182,88,49,7,4,0,148
California,Pala,1143,372,268,55,38,49,782
California,Little Valley,18,9,0,9,0,0,18
California,Hoopa,3573,1254,710,347,93,252,2656
California,Kettleman City,1395,311,593,22,19,47,992
California,West Modesto,5911,1503,1754,487,149,283,4176
California,Julian,930,106,700,87,0,20,913
California,Ramona,20260,5116,8549,1742,189,768,16364
California,Empire,3667,1160,1123,364,28,143,2818
California,Day Valley,3439,738,1798,404,26,100,3066
California,Loomis,6753,1280,2984,742,116,240,5362
California,Granite Bay,22439,3869,12282,1324,201,801,18477
California,Del Rio,1235,100,814,19,0,65,998
California,Foresthill,1546,114,909,134,0,20,1177
California,Keyes,6185,1832,2119,388,111,233,4683
California,Grayson,1224,505,413,18,0,9,945
California,Rocklin,63127,15107,27320,4791,696,2291,50205
California,Bermuda Dunes,6817,2040,2727,488,8,337,5600
California,Pine Valley,1669,258,778,220,13,77,1346
California,Beaumont,45403,9902,18454,3751,765,1379,34251
California,Hayfork,2421,400,1303,226,63,154,2146
California,Bootjack,768,157,323,73,0,69,622
California,Stinson Beach,556,165,287,60,0,29,541
California,Sausalito,7139,1746,3358,870,113,474,6561
California,Santa Venetia,4790,1095,2138,530,54,283,4100
California,San Rafael,58939,16809,22203,5753,864,2374,48003
California,Kentfield,6930,1240,3546,558,26,225,5595
California,El Verano,3424,612,1406,712,65,79,2874
California,Winter Gardens,23088,5590,9708,2171,237,1190,18896
California,Vista,100108,29260,36597,8534,1306,3101,78798
California,Lewiston,1340,264,623,231,32,80,1230
California,Simi Valley,126199,32299,53889,10782,1464,5423,103857
California,Greenacres,5757,1173,2440,459,95,344,4511
California,Casa Conejo,3366,778,1491,254,31,150,2704
California,Blue Lake,981,318,413,92,33,36,892
California,Hydesville,978,218,426,126,0,67,837
California,Piru,2019,531,697,94,50,139,1511
California,Oak View,4720,1243,2122,328,49,169,3911
California,Meiners Oaks,3508,915,1456,376,55,133,2935
California,Weldon,2181,453,794,418,134,133,1932
California,Tupman,186,74,37,10,1,10,132
California,Ridgecrest,28736,5959,11238,2869,599,1280,21945
California,Maricopa,1175,221,381,153,3,90,848
California,Fellows,49,4,28,3,2,0,37
California,North Edwards,944,246,333,145,11,47,782
California,East Sonora,2189,343,1095,222,10,356,2026
California,Cutten,3029,782,1325,304,33,161,2605
California,Rail Road Flat,283,55,145,74,0,9,283
California,Parkwood,1853,430,368,294,83,142,1317
California,Madera Acres,9946,2451,4237,663,159,189,7699
California,Keddie,41,20,7,0,0,4,31
California,Johnsville,0,0,0,0,0,0,0
California,East Quincy,2622,557,1046,291,185,148,2227
California,Mono Vista,3504,674,1527,570,62,63,2896
California,Upland,76382,21388,29455,6450,1476,3095,61864
California,Rancho Cucamonga,175679,47619,71278,14419,2535,5485,141336
California,Fontana,208943,62940,74623,12928,3308,5994,159793
California,Chino Hills,79298,19098,37012,3989,940,2870,63909
California,Big Bear City,13312,2869,5225,1722,217,756,10789
California,Hamilton City,2224,540,806,101,21,85,1553
California,Mokelumne Hill,637,166,248,26,0,53,493
California,Rosemont,23617,8189,7821,2413,444,907,19774
California,Ferndale,1365,221,570,185,30,116,1122
California,Clyde,676,192,298,69,12,14,585
California,St. Helena,6079,1395,2538,769,60,401,5163
California,Napa,79516,19356,32551,7521,1307,3858,64593
California,Murphys,2100,403,883,326,37,302,1951
California,Copperopolis,4299,944,1959,593,20,136,3652
California,West Whittier-Los Nietos,27144,8621,10461,1629,516,1051,22278
California,West Carson,22537,6515,8730,1993,510,1635,19383
California,Walnut,30008,7432,15171,1328,291,1343,25565
California,Val Verde,2996,994,997,277,11,48,2327
California,South San Jose Hills,20593,7213,7097,858,335,880,16383
California,Pomona,152494,53531,47547,10018,3458,5325,119879
California,Pasadena,141246,47047,51895,10891,2127,6398,118358
California,Long Beach,468883,172620,145685,35876,8592,16671,379444
California,Antioch,110730,33379,39591,9218,1767,4342,88297
California,Lomita,20628,5836,7790,2407,330,814,17177
California,El Segundo,16850,4661,6709,1414,226,517,13527
California,Rancho Murieta,5603,905,3283,431,86,156,4861
California,Lakeport,4855,1261,1956,648,93,374,4332
California,Stockton,306283,92881,98544,22849,6708,13942,234924
California,Morada,4068,552,2033,176,49,291,3101
California,Lockeford,3390,816,1353,257,49,100,2575
California,South Lake Tahoe,21814,7303,7511,2658,301,931,18704
California,Shingle Springs,3865,838,2202,317,41,80,3478
California,Lake Isabella,3454,734,1228,626,138,272,2998
California,Orinda,19431,3241,10939,849,136,799,15964
California,Knightsen,1500,282,804,76,0,64,1226
California,Kensington,5415,1105,2698,391,92,332,4618
California,Irwindale,1405,484,442,68,33,83,1110
California,Mission Hills,3796,908,1887,238,42,178,3253
California,Isla Vista,27690,25472,1271,240,40,103,27126
California,Yucaipa,53264,12397,22160,4259,597,2727,42140
California,Washington,53,0,29,19,0,5,53
California,Warner Valley,0,0,0,0,0,0,0
California,Warm Springs,1903,528,641,269,84,74,1596
California,Walker,863,161,432,71,0,74,738
California,Volta,216,117,80,0,0,0,197
California,Volcano,44,0,26,18,0,0,44
California,Vista Santa Rosa,2967,852,1178,131,76,95,2332
California,Vina,210,101,56,37,0,8,202
California,Victor,444,41,168,24,0,0,233
California,Verdi,187,28,113,34,0,0,175
California,Valley Wells,0,0,0,0,0,0,0
California,Valley Home,202,50,85,33,8,10,186
California,Waterloo,719,122,433,63,0,24,642
California,Valley Ford,148,64,0,43,0,0,107
California,Tuttle,63,0,63,0,0,0,63
California,Trowbridge,296,63,151,11,2,7,234
California,Trona,37,9,13,0,0,0,22
California,Trinity Village,279,94,86,42,0,39,261
California,Trinity Center,161,20,75,10,15,36,156
California,Tres Pinos,662,116,312,39,17,19,503
California,Topaz,234,75,43,0,0,9,127
California,Topanga,7449,1706,3558,739,85,240,6328
California,Tooleville,309,38,134,33,24,13,242
California,Tonyville,881,503,78,79,25,46,731
California,Timber Cove,149,58,74,12,0,5,149
California,Three Rocks,210,127,57,0,0,26,210
California,Tuttletown,941,118,459,40,36,148,801
California,Waukena,215,45,97,2,4,2,150
California,Wawona,196,77,45,13,17,0,152
California,West Rancho Dominguez,22932,8355,6460,1538,774,1328,18455
California,Lake Arrowhead,9765,1948,4658,929,172,385,8092
California,Hesperia,93609,25208,32633,6883,1877,3020,69621
California,Grand Terrace,12482,3445,4855,1353,181,604,10438
California,Crestline,9381,2407,3724,1160,90,434,7815
California,Mountain Ranch,1306,290,661,195,27,117,1290
California,Shasta Lake,10142,2460,3465,1550,160,426,8061
California,Montgomery Creek,61,24,6,14,0,17,61
California,Clear Creek,226,12,96,11,5,8,132
California,Clay,1083,202,546,109,0,88,945
California,Clarksburg,442,73,167,36,40,17,333
California,Cherokee Strip,191,24,97,0,0,23,144
California,Cherokee,139,57,40,19,0,6,122
California,Chalfant,999,426,265,116,67,46,920
California,Centerville,366,107,169,27,0,11,314
California,Cedarville,360,74,151,58,1,23,307
California,Cedar Slope,0,0,0,0,0,0,0
California,Zayante,939,259,322,105,8,19,713
California,Yolo,429,127,128,63,9,27,354
California,Yettem,441,178,66,0,0,10,254
California,Yankee Hill,301,83,154,27,14,6,284
California,Woodlands,1743,63,1323,17,24,109,1536
California,Woodbridge,3865,707,1976,317,90,156,3246
California,Wilsonia,0,0,0,0,0,0,0
California,Whitley Gardens,164,43,86,18,0,0,147
California,West Park,1035,320,351,33,62,32,798
California,West Goshen,567,163,201,36,0,5,405
California,Weott,271,98,125,0,0,28,251
California,Colton,54415,16256,18438,3561,984,2080,41319
California,Cedar Ridge,1037,151,491,185,8,63,898
California,Loma Linda,24078,7926,8997,1592,357,1355,20227
California,Muscoy,13726,4299,4319,517,206,307,9648
California,Mill Valley,14343,2298,7114,1255,180,764,11611
California,Tara Hills,5405,1749,2018,330,174,252,4523
California,Deer Park,906,127,498,88,28,18,759
California,Winters,7132,1594,3086,463,204,311,5658
California,Canyon Lake,11106,2308,5255,802,186,633,9184
California,Clearlake Oaks,2279,438,1159,284,86,85,2052
California,French Camp,3857,1858,1133,287,119,105,3502
California,Mammoth Lakes,8091,3438,2075,972,189,129,6803
California,Woodcrest,17310,4644,7668,1108,199,750,14369
California,Corona,165355,44310,67761,10845,2694,5309,130919
California,Cabazon,3367,1226,738,226,164,349,2703
California,Bakersfield,375699,102829,133890,25631,6559,12433,281342
California,Le Grand,1726,507,586,144,12,88,1337
California,Fair Oaks,31002,7043,13757,3356,373,1576,26105
California,Ladera Heights,7090,1841,2702,739,136,532,5950
California,Isleton,583,149,244,84,2,25,504
California,Eureka,27020,9336,8298,3363,584,1243,22824
California,Boron,2312,745,660,320,64,95,1884
California,South Taft,1526,285,539,260,31,71,1186
California,San Mateo,104035,27996,43588,7965,1038,4358,84945
California,El Granada,5819,978,2972,564,121,153,4788
California,Lathrop,21393,5614,8842,1148,214,696,16514
California,Rancho Mirage,18075,3259,9580,2165,147,1969,17120
California,Yosemite Lakes,5647,971,3064,349,23,229,4636
California,San Anselmo,12567,2565,6060,1249,162,429,10465
California,Montara,2692,624,1488,71,48,125,2356
California,Westmont,33723,13233,7194,2596,894,1203,25120
California,Beckwourth,214,35,45,41,15,54,190
California,Brentwood,60446,13346,27137,3797,735,2784,47799
California,Roseville,133049,29795,56632,12151,1895,6840,107313
California,Barstow,23812,6890,5742,2696,570,1160,17058
California,Apple Valley,72359,17160,28200,6834,1023,3315,56532
California,Rancho Calaveras,7035,1606,2659,937,143,248,5593
California,Suisun City,29379,8606,11253,2471,286,1241,23857
California,Seaside,34077,10607,11813,2347,463,1530,26760
California,San Ardo,554,166,146,19,11,28,370
California,Pacific Grove,15567,3644,6652,1713,216,1016,13241
California,Greenfield,17276,5420,5311,395,305,464,11895
California,Concow,743,138,338,119,14,24,633
California,Valley Center,9059,2014,4540,536,118,361,7569
California,Poway,49842,10121,23231,3522,696,2069,39639
California,Imperial Beach,27290,9174,7778,2887,586,1118,21543
California,Pleasant Hill,34785,9580,14687,2997,310,1421,28995
California,Fairbanks Ranch,2901,659,1325,103,0,179,2266
California,Running Springs,4296,911,1606,613,61,190,3381
California,Orland,7541,1446,3248,568,83,226,5571
California,San Bernardino,215182,74432,59039,15463,5214,7557,161705
California,Vallecito,183,88,56,19,0,13,176
California,El Rio,6505,2083,2056,386,191,185,4901
California,Fillmore,15598,4448,6048,947,168,546,12157
California,Salton Sea Beach,355,173,121,43,0,0,337
California,Chino,87735,27497,30692,9024,2325,2857,72395
California,East Richmond Heights,3214,754,1272,512,36,310,2884
California,Sunnyside-Tahoe City,1222,321,484,113,6,22,946
California,Loyalton,1149,400,331,69,46,72,918
California,Williams,5223,1363,2146,253,150,157,4069
California,Delleker,514,126,143,71,0,42,382
California,Carpinteria,13550,2994,6023,1652,104,595,11368
California,Mi-Wuk Village,1133,149,508,180,36,106,979
California,Rowland Heights,50602,13986,23295,2879,567,2391,43118
California,Arvin,21005,6307,7246,284,259,303,14399
California,San Jacinto,47474,13023,16480,3705,1170,1465,35843
California,Arnold,2605,357,1350,474,106,95,2382
California,La Riviera,10851,3952,3606,1226,135,402,9321
California,Galt,25675,5845,10692,1858,292,1022,19709
California,Dorrington,205,43,121,21,6,14,205
California,Porterville,59797,17476,18546,4221,1288,2598,44129
California,Riverdale Park,1301,388,337,81,108,33,947
California,Newman,11119,2484,4066,1124,94,408,8176
California,Escondido,151115,43566,55331,12672,2326,6222,120117
California,Encinitas,62713,15064,28337,4991,722,2848,51962
California,Coronado,23620,6095,11259,1683,213,962,20212
California,California City,13646,4280,4346,1480,376,432,10914
California,Camp Pendleton South,11459,1949,5014,208,0,0,7171
California,Monterey,28512,9741,10323,2810,409,1331,24614
California,Chualar,1442,492,481,9,11,23,1016
California,Mount Shasta,3284,646,1314,688,14,140,2802
California,Mount Hebron,78,7,26,0,0,30,63
California,Carmel Valley Village,4293,714,2096,523,55,284,3672
California,Lake San Marcos,4890,671,2312,563,23,765,4334
California,Bucks Lake,15,7,0,8,0,0,15
California,Belden,0,0,0,0,0,0,0
California,Shoshone,13,0,5,6,2,0,13
California,Dixon Lane-Meadow Creek,2760,401,1382,275,19,153,2230
California,Vandenberg AFB,3379,588,1556,111,18,0,2273
California,Summerland,923,180,473,165,71,34,923
California,Soledad,25597,9945,6962,2465,754,566,20692
California,Derby Acres,380,72,144,44,13,21,294
California,Yreka,7551,1975,2314,922,102,546,5859
California,El Paso de Robles (Paso Robles),31656,7130,13594,2639,636,1392,25391
California,Lancaster,159662,53127,51530,9513,2490,5090,121750
California,Hidden Valley Lake,6044,945,2735,668,38,393,4779
California,Willowbrook,22402,8251,5749,851,483,609,15943
California,Parlier,15120,4750,4787,679,299,455,10970
California,Lemoore Station,7063,1688,3193,42,24,80,5027
California,Sebastopol,7666,2204,2852,1041,87,378,6562
California,Cantua Creek,273,52,84,29,0,24,189
California,Ridgemark,3062,612,1652,199,20,166,2649
California,Escalon,7509,1623,3031,741,259,263,5917
California,August,8774,2930,2391,427,199,329,6276
California,Shingletown,2272,449,1061,331,9,214,2064
California,Cottonwood,3289,826,1192,275,91,71,2455
California,Montague,1517,397,568,209,27,37,1238
California,McCloud,1072,250,490,82,6,98,926
California,Georgetown,2668,388,1380,136,47,134,2085
California,Granite Hills,2833,525,1469,371,10,203,2578
California,Fallbrook,33021,7953,14234,2554,424,1437,26602
California,Spreckels,385,127,211,38,0,0,376
California,San Lucas,472,136,149,6,10,20,321
California,Del Monte Forest,4197,976,2246,256,46,306,3830
California,Carmel-by-the-Sea,3855,557,1990,436,13,385,3381
California,Lexington Hills,2603,383,1409,193,30,57,2072
California,East Foothills,6278,1606,3015,343,51,266,5281
California,Sutter,2994,693,1371,144,36,131,2375
California,Live Oak,8622,2332,2788,811,162,391,6484
California,Etna,735,125,315,69,14,34,557
California,Lake Nacimiento,2884,516,1272,244,54,165,2251
California,Mentone,9847,2887,3639,995,126,368,8015
California,Big River,1145,186,430,170,13,149,948
California,Cazadero,288,82,129,33,4,9,257
California,Castle Hill,1145,228,617,72,0,43,960
California,Monterey Park,60792,17320,26895,3740,788,3903,52646
California,La Puente,40268,13400,13394,2445,1039,1720,31998
California,Hawaiian Gardens,14411,4832,4823,734,276,487,11152
California,Ceres,47975,12818,17325,2996,631,1702,35472
California,Santa Cruz,64273,32642,17331,5672,584,1715,57944
California,Biola,1451,538,423,24,21,52,1058
California,Taft Heights,2424,742,637,189,0,99,1667
California,California Pines,488,95,223,53,0,60,431
California,California Hot Springs,36,0,17,10,0,6,33
California,Butte Valley,510,101,210,110,0,46,467
California,Butte Meadows,53,0,0,53,0,0,53
California,Butte Creek Canyon,931,34,475,163,0,139,811
California,Paramount,54776,18971,16789,3359,1363,1666,42148
California,Burnt Ranch,338,68,211,25,4,22,330
California,Buck Meadows,51,17,26,0,0,8,51
California,Buckhorn,2246,384,1068,341,33,156,1982
California,Brooktrails,3709,848,1153,430,91,207,2729
California,Brookdale,2345,833,930,300,55,31,2149
California,Bridgeport,464,170,230,42,0,22,464
California,Boulevard,445,26,261,129,0,0,416
California,Boonville,852,243,375,76,0,59,753
California,Bonny Doon,3009,805,1476,243,21,95,2640
California,Bodega,473,138,250,73,0,0,461
California,Bloomfield,387,143,130,89,16,9,387
California,Blacklake,892,120,558,24,0,153,855
California,Blackhawk,9860,1936,5936,322,20,196,8410
California,Buena Vista,526,65,243,41,26,63,438
California,Big Lagoon,118,7,66,19,0,14,106
California,San Fernando,24585,8238,8716,1207,703,912,19776
California,South El Monte,20727,7170,6689,999,361,1029,16248
California,Squirrel Mountain Valley,1159,221,574,126,0,122,1043
California,McKittrick,127,29,56,24,0,0,109
California,Frazier Park,2570,511,932,294,124,221,2082
California,Edwards AFB,2571,225,1233,14,7,0,1479
California,South San Francisco,67294,19255,28559,4685,735,3625,56859
California,San Carlos,30080,5599,14392,2286,222,1165,23664
California,Burlingame,30459,7356,13545,2201,274,1211,24587
California,Inyokern,740,142,397,45,0,119,703
California,Tahoe Vista,1288,289,572,89,33,45,1028
California,French Gulch,441,88,213,59,3,30,393
California,Fall River Mills,273,124,0,35,9,59,227
California,Moss Beach,3799,753,1840,138,44,74,2849
California,Santa Monica,92078,35195,30484,10351,1229,3430,80689
California,Santa Barbara,91325,31304,32777,8796,1398,4081,78356
California,Buellton,5092,679,2399,662,44,306,4090
California,Santa Maria,105483,29931,35456,5923,2038,3528,76876
California,Wheatland,3747,1023,1499,395,41,113,3071
California,Linda,19314,5107,6385,1519,429,664,14104
California,Challenge-Brownsville,864,211,514,35,0,0,760
California,Yorba Linda,67815,13609,34772,3799,469,2372,55021
California,Laguna Niguel,65652,13903,32436,5889,629,2280,55137
California,Garden Grove,174010,52405,68988,11581,2740,7567,143281
California,West Hollywood,36384,21707,8368,3126,401,1491,35093
California,West Covina,107242,31469,42313,7195,1791,4848,87616
California,South Pasadena,25824,7121,10794,1846,120,832,20713
California,South Gate,95103,33297,30068,4418,2507,2985,73275
California,Guadalupe,7350,2044,2570,281,96,337,5328
California,Big Creek,188,26,74,10,0,6,116
California,Bieber,178,23,99,15,0,21,158
California,Berry Creek,1241,310,563,180,24,77,1154
California,Richfield,272,21,122,3,9,22,177
California,Reliez Valley,3575,542,1794,419,19,256,3030
California,Redwood Valley,1376,244,667,165,22,37,1135
California,Redcrest,23,0,20,0,0,3,23
California,Red Corral,1930,421,971,111,135,105,1743
California,Rackerby,189,68,65,19,7,4,163
California,Proberta,165,23,53,30,0,18,124
California,Princeton,297,55,158,36,6,24,279
California,Potter Valley,437,124,211,39,0,22,396
California,Potrero,625,158,261,54,0,0,473
California,Poso Park,2,0,0,2,0,0,2
California,Posey,0,0,0,0,0,0,0
California,Richvale,99,15,45,14,0,25,99
California,Ponderosa,0,0,0,0,0,0,0
California,Marysville,12282,3343,4208,1283,301,716,9851
California,Westminster,91417,25421,39175,6609,1474,4330,77009
California,East San Gabriel,15932,4536,6471,974,195,915,13091
California,Diamond Bar,56434,14587,26593,3175,243,2378,46976
California,Compton,97301,35574,27621,4648,2337,3674,73854
California,Carson,92517,30217,33750,6493,1733,4580,76773
California,Bell,35809,12743,11064,1507,856,1248,27418
California,Arcadia,58207,13392,27773,3471,585,2929,48150
California,Acton,7185,1551,3677,590,69,309,6196
California,Woodland,59044,14819,23844,4918,1244,2345,47170
California,Avalon,3763,827,1702,251,4,119,2903
California,Moorpark,36274,8962,17145,2222,286,959,29574
California,Plumas Lake,7367,1472,2989,415,74,180,5130
California,Rio Oso,406,80,147,46,14,16,303
California,Smith River,632,185,121,29,58,36,429
California,Snelling,101,23,46,21,0,2,92
California,Thornton,1038,309,336,70,25,48,788
California,Thermal,1359,302,573,53,74,13,1015
California,Teviston,1027,160,447,45,12,0,664
California,Terminous,411,89,190,73,0,42,394
California,Tahoma,867,240,345,82,14,41,722
California,Swall Meadows,218,11,177,20,0,10,218
California,Sun Village,13516,3853,4783,825,433,404,10298
California,Tarpey Village,3390,832,1361,300,71,132,2696
California,Sunny Slopes,80,0,30,10,23,17,80
California,Sunnyside,4451,1260,1772,291,23,185,3531
California,Sultana,1030,336,205,40,6,27,614
California,Sugarloaf Village,10,0,10,0,0,0,10
California,Sugarloaf Saw Mill,0,0,0,0,0,0,0
California,Sugarloaf Mountain Park,0,0,0,0,0,0,0
California,Strawberry CDP (Tuolumne County),5,0,4,0,0,1,5
California,Strawberry CDP (Marin County),5759,1552,2215,846,55,195,4863
California,Stonyford,136,50,58,16,0,12,136
California,Stirling City,307,103,101,0,0,0,204
California,Stevinson,331,141,127,55,0,0,323
California,Stevenson Ranch,19364,4287,8467,1464,215,731,15164
California,Spring Valley Lake,7744,1709,3797,505,68,289,6368
California,Spring Valley CDP (San Diego County),31591,8392,12074,2791,566,1151,24974
California,Spring Valley CDP (Lake County),1081,244,386,126,0,130,886
California,Spaulding,110,0,34,24,0,52,110
California,South Monrovia Island,7192,2534,2308,452,155,280,5729
California,Soda Springs,21,21,0,0,0,0,21
California,Soda Bay,941,310,356,196,14,25,901
California,Weedpatch,2238,749,605,70,147,46,1617
California,Catheys Valley,794,197,466,28,0,32,723
California,Mira Monte,6912,1920,2774,931,98,507,6230
California,Black Point-Green Point,1655,318,909,151,36,46,1460
California,Benton,313,64,138,64,2,24,292
California,Bend,457,54,310,12,0,48,424
California,Benbow,161,51,51,42,0,8,152
California,Bell Canyon,2391,451,1319,58,19,78,1925
California,Bella Vista,2614,607,1167,286,15,152,2227
California,Bear Valley CDP (Mariposa County),203,35,60,41,0,0,136
California,Bear Valley CDP (Alpine County),58,7,36,0,0,0,43
California,Bear Creek,157,95,29,26,0,7,157
California,Bayview CDP (Humboldt County),2617,766,752,377,56,188,2139
California,Bayview CDP (Contra Costa County),1954,529,800,145,0,131,1605
California,Bass Lake,500,70,315,10,21,54,470
California,Bangor,372,35,233,45,9,26,348
California,Sheridan,1250,383,517,73,0,62,1035
California,Ballico,401,127,153,45,9,0,334
California,Baker,607,157,169,58,27,10,421
California,Auburn Lake Trails,3499,514,1902,234,48,203,2901
California,Aspen Springs,67,0,40,0,0,0,40
California,Artois,292,55,104,44,0,17,220
California,Anza,3151,617,1454,109,163,157,2500
California,Antelope,47326,12159,18827,3218,620,1739,36563
California,Anchor Bay,314,19,216,42,0,37,314
California,Alto,765,175,494,36,0,0,705
California,Alta,485,58,287,37,18,28,428
California,Allensworth,527,215,113,27,21,6,382
California,Allendale,1362,236,779,122,0,57,1194
California,Alleghany,30,30,0,0,0,0,30
California,Ballard,473,145,208,41,3,25,422
California,Alhambra Valley,739,117,397,46,3,34,597
California,Sierra Brooks,299,38,118,86,0,10,252
California,Sierra Village,330,61,88,139,0,0,288
California,Castaic,18921,4202,8386,1170,331,603,14692
California,Cassel,176,0,113,0,0,63,176
California,Caspar,812,116,427,47,0,45,635
California,Casmalia,111,8,74,10,0,7,99
California,Carnelian Bay,463,182,211,52,0,18,463
California,Carmet,0,0,0,0,0,0,0
California,Canby,497,168,157,31,0,30,386
California,Camptonville,162,28,95,7,5,6,141
California,Campo,3482,692,1291,292,42,140,2457
California,Camp Nelson,0,0,0,0,0,0,0
California,Camino Tassajara,3798,503,1768,189,13,163,2636
California,Camino,1799,354,1002,152,0,39,1547
California,Sierra City,152,26,93,0,0,33,152
California,Camanche Village,620,79,338,75,0,30,522
California,Calpine,216,34,128,32,0,0,194
California,Calpella,562,113,257,65,0,46,481
California,Callender,1583,490,589,206,0,46,1331
California,Smith Corner,664,301,247,8,0,0,556
California,Smartsville,163,63,30,24,0,4,121
California,Sky Valley,2430,573,1216,191,39,149,2168
California,Sisquoc,148,31,59,19,0,3,112
California,Silver Lakes,5966,876,3028,516,19,314,4753
California,Sleepy Hollow,2200,520,1210,108,0,37,1875
California,Silver City,0,0,0,0,0,0,0
California,Silverado Resort,937,41,584,77,11,119,832
California,Sierraville,103,3,56,44,0,0,103
California,Camanche North Shore,1029,277,369,170,8,0,824
California,Alderpoint,157,68,53,9,27,0,157
California,Albion,302,204,10,62,0,26,302
California,Airport,1222,413,323,80,86,15,917
California,Rose Hills,2612,739,1106,206,60,128,2239
California,Rolling Hills,896,210,510,55,0,7,782
California,Rodriguez Camp,87,50,10,0,7,0,67
California,Robinson Mill,35,19,0,0,0,16,35
California,Robbins,321,55,156,28,0,32,271
California,River Pines,607,209,165,32,87,81,574
California,Ripley,408,85,139,14,24,31,293
California,Buttonwillow,1591,277,570,54,28,44,973
California,Woodside,5541,925,2931,352,53,164,4425
California,Blythe,19581,7136,5301,2091,618,831,15977
California,Emerald Lake Hills,4594,966,2455,254,0,191,3866
California,Colma,1450,501,530,94,43,51,1219
California,Rough and Ready,828,34,274,190,0,116,614
California,Broadmoor,5286,1629,2517,178,28,247,4599
California,Planada,4418,1291,1580,273,119,170,3433
California,Tobin,0,0,0,0,0,0,0
California,Taylorsville,244,28,137,0,0,9,174
California,Lake Almanor Peninsula,416,89,216,49,5,48,407
California,Greenville,1108,346,338,237,22,52,995
California,Penn Valley,1424,289,592,163,71,39,1154
California,Grass Valley,12932,3464,3529,2280,208,1503,10984
California,Woodacre,1303,180,602,274,15,152,1223
California,Tamalpais-Homestead Valley,11261,2187,5329,1256,44,341,9157
California,San Geronimo,466,191,75,62,27,0,355
California,Ross,2309,463,1189,168,12,57,1889
California,Lucas Valley-Marinwood,6841,1441,3161,672,72,261,5607
California,Winton,11761,2910,3999,557,335,265,8066
California,Rouse,2420,727,695,154,0,23,1599
California,Ruth,145,26,72,26,0,16,140
California,Rutherford,72,22,50,0,0,0,72
California,Ahwahnee,2461,539,1340,251,0,78,2208
California,Agua Dulce,3728,717,2109,264,36,87,3213
California,Adin,201,52,83,16,0,24,175
California,Acampo,294,126,132,0,0,0,258
California,Acalanes Ridge,889,96,478,43,0,0,617
California,Shelter Cove,501,210,230,11,12,38,501
California,Shell Ridge,1281,209,736,109,0,23,1077
California,Shasta,1804,420,905,174,16,71,1586
California,Seville,691,172,195,14,7,16,404
California,Sereno del Mar,82,23,39,20,0,0,82
California,Sequoia Crest,28,0,28,0,0,0,28
California,Sea Ranch,1161,65,723,189,0,76,1053
California,Seacliff,3201,643,1504,453,34,92,2726
California,Scotia,602,185,160,52,13,24,434
California,Saticoy,1201,333,409,44,16,29,831
California,Saranap,6492,1569,3220,446,15,137,5387
California,Santa Susana,1050,278,484,105,0,46,913
California,Sattley,77,43,0,34,0,0,77
California,Santa Rosa Valley,3180,708,1877,119,0,137,2841
California,Santa Nella,2508,736,895,124,12,46,1813
California,Santa Margarita,1252,360,497,198,47,0,1102
California,San Simeon,583,35,278,94,0,19,426
California,San Pasqual,1932,566,926,113,26,70,1701
California,San Miguel CDP (San Luis Obispo County),2807,649,929,241,79,53,1951
California,San Miguel CDP (Contra Costa County),2993,325,1724,178,47,102,2376
California,Samoa,284,161,41,31,0,25,258
California,Salmon Creek,20,0,20,0,0,0,20
California,Oxnard,207568,65597,70113,13553,3413,6827,159503
California,Golden Hills,9407,1953,4235,679,92,306,7265
California,Aguanga,835,109,437,45,58,84,733
California,Mohawk Vista,63,8,31,9,0,0,48
California,Crescent Mills,287,38,110,47,0,15,210
California,La Porte,0,0,0,0,0,0,0
California,Little Grass Valley,0,0,0,0,0,0,0
California,Chinese Camp,206,46,71,0,0,37,154
California,Sonora,4822,1245,1668,616,136,314,3979
California,Twain Harte,2523,417,1318,308,0,185,2228
California,Redway,1199,525,428,14,123,0,1090
California,Rio Dell,3382,864,1153,350,30,232,2629
California,Moss Landing,61,7,44,0,0,10,61
California,Canyondam,66,0,66,0,0,0,66
California,Belvedere,2098,229,1136,133,21,185,1704
California,West Puente Valley,23629,7786,8706,1640,535,1091,19758
California,Colusa,5902,1441,2067,569,144,200,4421
California,Forest Meadows,1516,387,612,64,10,100,1173
California,El Cerrito,5471,1678,1923,604,107,313,4625
California,Idyllwild-Pine Cove,2459,685,1133,273,39,124,2254
California,Winterhaven,210,30,79,12,0,89,210
California,Chowchilla,18533,7242,4981,1846,683,631,15383
California,Parksdale,2493,823,743,170,39,74,1849
California,Cathedral City,54037,16290,19071,4552,1132,2372,43417
California,Fairfax,7591,1659,3585,983,18,340,6585
California,Highgrove,4986,1630,1681,183,114,218,3826
California,Lennox,21329,7909,6628,902,651,389,16479
California,Industry,344,93,127,9,6,8,243
California,La Habra,61910,17667,23194,4742,1042,2729,49374
California,Seal Beach,24364,4675,10835,3154,337,2765,21766
California,Villa Park,5912,1189,3204,236,25,430,5084
California,Meadow Vista,3460,513,1933,356,2,150,2954
California,Hayward,158241,51091,59132,9952,2400,6428,129003
California,Livermore,89027,18829,41624,6760,979,3031,71223
California,Lemon Grove,26767,7297,9163,2956,508,1082,21006
California,Fetters Hot Springs-Agua Caliente,4697,1436,1893,417,54,92,3892
California,Healdsburg,11802,2717,5214,1398,104,386,9819
California,Inglewood,110327,39746,30281,10144,3015,4778,87964
California,Petaluma,60635,14627,26479,5462,788,2605,49961
California,Red Bluff,14132,3724,4130,2027,475,663,11019
California,Laytonville,1175,424,244,175,19,90,952
California,Hollister,37835,10361,14321,2478,475,1139,28774
California,Cerritos,50172,12248,25187,2452,408,2356,42651
California,Artesia,16817,4872,6774,1063,227,1050,13986
California,Azusa,49544,19945,15106,2892,830,1504,40277
California,Baldwin Park,76222,24911,28251,3462,1474,3003,61101
California,Commerce,12933,4468,3908,955,352,642,10325
California,Hidden Hills,1634,299,838,73,9,79,1298
California,Mineral,292,80,112,9,0,4,205
California,Laguna Woods,16228,1340,7694,2875,171,4138,16218
California,Norco,26569,7029,10879,2691,435,1115,22149
California,Temecula,112230,25231,48013,8134,1694,3492,86564
California,Auberry,2476,275,1165,297,40,142,1919
California,Squaw Valley,3449,594,1485,333,62,129,2603
California,Avocado Heights,15903,5006,6152,886,291,692,13027
California,Bellflower,77529,24206,25878,5937,1637,2839,60497
California,Calabasas,24077,5551,11040,1968,337,580,19476
California,Tiburon,9151,1160,5127,843,6,358,7494
California,Prunedale,19584,5109,8566,1085,292,933,15985
California,Grover Beach,13538,3299,4721,1719,274,583,10596
California,Hornbrook,215,60,82,34,6,13,195
California,Fremont,233083,50053,116685,10671,1362,8652,187423
California,Tennant,18,0,8,10,0,0,18
California,Los Altos Hills,8517,1342,5030,322,40,349,7083
California,Monte Sereno,3492,567,1932,108,18,126,2751
California,Saratoga,30886,5101,17655,1267,196,1601,25820
California,Sunnyvale,152323,37156,71686,8232,1472,4718,123264
California,Cotati,7470,2204,2923,725,13,279,6144
California,Forestville,3685,1188,1341,621,86,128,3364
California,Graton,1877,438,678,277,0,48,1441
California,Occidental,833,135,476,151,0,18,780
California,Corning,7535,1751,2650,554,52,388,5395
California,Yuba City,66388,14010,27703,6324,998,2929,51964
California,Riverside,323935,110295,107318,23777,6230,12170,259790
California,Berkeley,120926,60417,35830,7779,1186,3117,108329
California,Loma Rica,3088,509,1278,229,0,84,2100
California,Gustine,5774,1739,2526,317,71,256,4909
California,Pacifica,39065,10312,16944,3752,440,1577,33025
California,Dustin Acres,590,127,200,71,31,16,445
California,Ford City,4365,1234,1244,276,138,175,3067
California,Kernville,1007,149,399,189,0,133,870
California,Lower Lake,1595,307,715,298,46,16,1382
California,Lagunitas-Forest Knolls,1504,546,669,127,0,8,1350
California,Larkspur,12375,2664,5364,1720,79,686,10513
California,Tomales,253,59,118,56,0,20,253
California,Firebaugh,8295,3021,2417,234,128,413,6213
California,Farmington,89,12,33,0,22,0,67
California,Amesti,2832,646,1133,168,61,125,2133
California,Corralitos,2381,372,1360,155,23,103,2013
California,Lodi,65006,15072,24673,5559,1197,3317,49818
California,Freedom,3719,1246,1290,210,95,123,2964
California,Scotts Valley,11900,2804,5039,1028,228,522,9621
California,Coto de Caza,14931,2730,8207,856,40,362,12195
California,La Palma,15733,4265,7222,1060,209,770,13526
California,Newport Beach,86280,20687,39699,8893,895,4067,74241
California,San Clemente,65045,14471,31301,5056,468,2856,54152
California,Mission Viejo,96124,21385,46602,7758,835,4639,81219
California,Visalia,131066,34080,47100,10035,1508,4805,97528
California,Strathmore,2915,832,785,206,161,115,2099
California,Farmersville,10742,3607,3363,525,98,377,7970
California,Garden Acres,10701,3167,3727,518,103,400,7915
California,Oroville East,7368,1513,3304,801,130,486,6234
California,Chico,91998,37165,26364,8937,1150,4065,77681
California,Rohnert Park,42694,13828,14770,4403,474,1823,35298
California,Glen Ellen,727,178,426,55,68,0,727
California,Clovis,106666,26700,41022,9083,1458,3697,81960
California,Castro Valley,63288,14753,28437,5017,619,3178,52004
California,Cloverdale,8798,1754,4090,740,113,281,6978
California,Lost Hills,1943,591,661,23,51,25,1351
California,Lincoln Village,4768,1422,1736,287,21,208,3674
California,Calwa,1974,530,571,94,9,76,1280
California,Vallejo,120977,37358,42138,11610,2991,5652,99749
California,Burbank,5252,1668,1984,387,140,134,4313
California,Colfax,2029,542,606,297,25,144,1614
California,San Joaquin,4021,1016,1483,88,82,71,2740
California,Shaver Lake,498,69,347,50,3,18,487
California,Alum Rock,11791,3767,4170,772,182,492,9383
California,Fruitdale,899,261,291,116,2,81,751
California,Los Altos,30588,5024,16269,1503,137,1186,24119
California,Milpitas,77457,19176,35731,4050,959,2645,62561
California,Keene,313,36,186,7,0,0,229
California,Morgan Hill,43876,9144,19795,3138,518,1299,33894
California,Carlsbad,113670,24336,51667,10194,1034,4459,91690
California,Hidden Meadows,3386,525,1766,452,0,194,2937
California,Larkfield-Wikiup,8926,2111,3316,1457,49,448,7381
California,Gilroy,55525,14649,20925,4306,1071,1453,42404
California,Cupertino,60614,11491,31158,2318,372,2440,47779
California,Campbell,42470,11182,17780,3962,576,1573,35073
California,Cambrian Park,3094,611,1616,169,23,143,2562
California,Weed,2677,953,588,391,12,272,2216
California,Macdoel,105,44,29,0,0,0,73
California,Greenview,283,53,154,19,7,24,257
California,Dunsmuir,1589,328,643,217,46,106,1340
California,Chula Vista,266468,72083,104966,18428,4111,10461,210049
California,Templeton,7938,1198,3582,815,81,537,6213
California,Mesa Vista,278,60,123,35,8,40,266
California,Vacaville,97943,25727,38069,9757,1793,4008,79354
California,Pajaro,3561,1076,1254,95,31,32,2488
California,Marina,21608,6847,7366,1682,410,1016,17321
California,Gonzales,8402,2530,3094,122,134,179,6059
California,Boronda,1066,416,394,98,0,45,953
California,Aromas,2553,787,1203,194,39,44,2267
California,La Mesa,59562,16595,21556,6997,977,2879,49004
California,Jamul,5384,1158,3042,263,48,231,4742
California,Cayucos,2692,568,1225,464,41,132,2430
California,Magalia,12671,3551,4944,1403,132,934,10964
California,Paradise,26543,5729,10445,3514,482,2195,22365
California,Willits,4893,1332,1414,707,116,425,3994
California,Hickman,566,176,243,44,5,19,487
California,Hughson,7370,1670,2639,469,104,552,5434
California,Cutler,5774,2035,1768,135,32,130,4100
California,Goshen,3316,1061,937,206,208,50,2462
California,Springville,872,117,431,116,0,39,703
California,Kings Beach,2833,1025,952,287,13,34,2311
California,Lincoln,46939,7166,23893,3593,559,2682,37893
California,North Auburn,13707,3318,5493,1427,251,870,11359
California,Bluewater,161,6,57,52,0,22,137
California,Rio Linda,15460,3735,5921,1564,210,779,12209
California,Rialto,102873,31904,35602,5954,2501,2950,78911
California,Orcutt,30493,6873,14057,2424,353,1242,24949
California,Santa Ynez,4401,949,2125,450,54,104,3682
California,Carmichael,64785,16855,24488,7553,1205,3739,53840
California,Florin,49132,15065,16059,4047,1324,2033,38528
California,Vineyard,28315,6355,12222,2168,355,726,21826
California,Corcoran,22301,9293,5498,2479,947,663,18880
California,Stratford,878,257,254,21,20,0,552
California,Laguna Hills,31185,7762,13785,2571,282,1456,25856
California,Alpaugh,1074,295,332,19,30,0,676
California,Wrightwood,4283,725,2004,271,37,153,3190
California,Westley,838,258,356,0,0,0,614
California,Turlock,72335,19665,26614,5746,1536,3234,56795
California,Salida,14658,3983,5767,1045,32,272,11099
California,Talmage,921,357,327,55,20,33,792
California,Home Garden,1643,529,509,126,28,75,1267
California,Guerneville,4808,1355,1725,812,163,277,4332
California,Manton,372,80,144,44,11,12,291
California,Rancho Tehama Reserve,1922,745,507,261,54,132,1699
California,Durham,5863,1415,2682,387,79,356,4919
California,Armona,3795,903,1443,254,69,130,2799
California,Huron,7019,2085,2291,117,147,150,4790
California,Buena Park,82781,24060,32949,5599,1221,3248,67077
California,San Leandro,90103,26471,35131,7384,1484,4603,75073
California,Bowles,194,49,78,0,0,26,153
California,Sanger,24978,7187,7809,1702,677,1203,18578
California,Alhambra,84974,28251,33714,5443,990,4447,72845
California,Bradbury,916,259,450,47,2,49,807
California,Citrus,10771,3686,3629,590,320,528,8753
California,San Andreas,3085,674,1124,355,27,115,2295
California,London,1854,624,472,82,61,31,1270
California,Felton,3810,1044,1878,359,35,48,3364
California,Twin Lakes,5642,1733,1930,557,85,412,4717
California,Bret Harte,5319,1734,1492,253,139,106,3724
California,Modesto,211336,56874,77585,19091,3581,9391,166522
California,Gridley,6585,1483,2347,552,147,222,4751
California,Tehama,445,120,213,49,2,20,404
California,Casa de Oro-Mount Helix,19635,4389,8963,1784,343,860,16339
California,San Diego,1401932,467461,510990,116635,21166,48535,1164787
California,Nuevo,7033,1678,2855,355,99,285,5272
California,Moreno Valley,205034,63487,69878,12917,4305,6257,156844
California,Mecca,7174,2073,2658,158,117,142,5148
California,Lakeview,2566,710,972,119,45,50,1896
California,Lakeland Village,13170,3690,4446,1109,176,465,9886
California,Cherry Valley,7755,1683,3333,675,192,786,6669
California,Linden,1790,283,882,120,17,53,1355
California,Coachella,44849,14608,17053,1577,1004,1084,35326
California,Rosedale,16737,3135,8602,937,104,386,13164
California,Oildale,34723,10139,9106,4833,993,1628,26699
California,Mojave,4230,1482,1232,302,81,107,3204
California,Johannesburg,138,47,8,56,0,0,111
California,North Fair Oaks,14547,4225,5505,881,201,373,11185
California,Hillsborough,11439,1903,6381,396,36,388,9104
California,Highlands-Baywood Park,4564,1011,2348,204,36,172,3771
California,Foster City,33784,6851,16910,1863,309,1299,27232
California,Millbrae,22703,5323,10417,1524,282,1485,19031
California,Wallace,1063,273,409,151,0,185,1018
California,Adelanto,33416,10014,9291,2232,739,783,23059
California,Bloomington,21783,7062,7571,1236,593,1055,17517
California,Needles,4962,1287,1615,506,102,361,3871
California,Camarillo,67543,15856,30343,5237,597,3650,55683
California,Elmira,285,37,113,79,0,0,229
California,Wasco,26708,9571,8706,1396,669,810,21152
California,Stallion Springs,3625,523,1463,344,83,160,2573
California,Rosamond,20028,5030,7631,1526,399,459,15045
California,Randsburg,64,0,15,28,12,9,64
California,Onyx,588,238,158,63,17,42,518
California,Mountain Mesa,1236,285,193,240,0,209,927
California,Menlo Park,33869,8031,14594,2288,256,1179,26348
California,Mettler,138,75,10,15,0,15,115
California,Lake of the Woods,768,23,280,204,73,53,633
California,McKinleyville,16612,4890,5982,1693,192,577,13334
California,Lake Wildwood,5208,568,3316,403,35,330,4652
California,Alta Sierra,7207,1584,3456,624,92,431,6187
California,Kelseyville,3332,653,1440,427,147,130,2797
California,Nevada City,3128,862,965,654,143,215,2839
California,Searles Valley,1646,313,619,162,65,118,1277
California,Redlands,71012,20872,26371,6074,734,3605,57656
California,Lebec,1802,330,752,192,45,134,1453
California,Brisbane,4692,1203,2134,331,103,169,3940
California,Rio Vista,8618,1094,4747,1248,137,719,7945
California,El Cerrito,25203,5977,11878,1659,400,1213,21127
California,Pismo Beach,8116,2040,3646,1048,119,540,7393
California,Cambria,5725,1014,3214,577,52,400,5257
California,Dorris,868,201,316,65,7,62,651
California,Camp Pendleton North,7903,2585,3169,191,16,0,5961
California,Alpine,15233,3545,6768,1192,166,758,12429
California,Stanford,15668,12244,2318,104,3,167,14836
California,Loyola,3364,452,1928,57,24,134,2595
California,Los Gatos,30922,6212,14264,3078,331,1480,25365
California,Gazelle,46,4,29,9,0,4,46
California,San Luis Obispo,47160,24093,12390,3379,538,1646,42046
California,Kirkwood,76,56,20,0,0,0,76
California,Alpine Village,155,67,38,12,4,28,149
California,Fairfield,114101,29333,44966,9247,1975,4461,89982
California,Salinas,156550,51433,49471,7269,2255,5172,115600
California,Bradley,107,31,62,0,0,0,93
California,King City,13834,4829,4670,241,116,249,10105
California,Belmont,27110,5335,13007,2222,249,1032,21845
California,Tulelake,838,166,356,16,2,54,594
California,Palo Alto,67019,15304,31770,4157,413,2804,54448
California,Edgewood,40,0,32,0,0,0,32
California,Oroville,19040,5745,5074,2317,573,1202,14911
California,Crockett,3094,841,1143,478,77,196,2735
California,Biggs,2323,459,926,131,66,70,1652
California,Valle Vista,16879,4071,5913,2257,450,939,13630
California,Homeland,7326,1809,2571,722,78,309,5489
California,East Hemet,20679,5645,6952,1545,617,830,15589
California,Bay Point,25165,8504,7924,1724,761,541,19454
California,McFarland,14456,4071,4980,565,243,275,10134
California,Orangevale,34757,8091,14507,3669,838,1462,28567
California,Riverbank,24237,5712,10241,1596,381,895,18825
California,Wofford Heights,1973,519,724,340,14,301,1898
California,Patterson,21783,6001,8056,1516,342,436,16351
California,Hermosa Beach,19650,6776,7445,1594,295,641,16751
California,Hawthorne,87370,30466,25314,6937,2432,2965,68114
California,Gardena,59924,18071,21885,4939,1543,3088,49526
California,Florence-Graham,64162,22765,19258,2340,1511,1891,47765
California,Cudahy,24016,8763,7315,806,465,409,17758
California,Tehachapi,12753,4499,3588,1839,410,481,10817
California,Charter Oak,9760,3000,3582,690,175,307,7754
California,Palermo,5544,1371,2222,435,106,290,4424
Colorado,Snowmass Village,2824,1653,685,223,0,155,2716
Colorado,Idaho Springs,1886,301,869,344,27,84,1625
Colorado,Avondale,727,201,347,0,0,19,567
Colorado,Granada,660,166,284,33,5,19,507
Colorado,Hillrose,286,64,121,21,13,21,240
Colorado,Manzanola,478,163,166,88,0,24,441
Colorado,Walsenburg,2931,592,1066,410,48,288,2404
Colorado,La Veta,772,110,388,105,5,48,656
Colorado,Swink,766,171,246,93,12,47,569
Colorado,Crowley,314,135,34,98,3,20,290
Colorado,Pierce,1031,208,513,96,14,28,859
Colorado,Springfield,1347,272,511,177,27,102,1089
Colorado,Keystone,978,369,255,310,0,19,953
Colorado,Sugar City,519,237,141,30,18,17,443
Colorado,Romeo,312,101,99,30,4,27,261
Colorado,Eaton,5148,835,2620,319,0,189,3963
Colorado,Evans,20393,5345,6947,1796,405,728,15221
Colorado,La Salle,2539,493,1053,219,8,86,1859
Colorado,Buena Vista,2746,574,1217,235,0,187,2213
Colorado,Brush,5386,1024,2083,675,86,237,4105
Colorado,Fort Morgan,11309,2196,4293,1169,340,552,8550
Colorado,Towaoc,1099,512,162,71,8,32,785
Colorado,Ouray,883,254,400,97,7,62,820
Colorado,Campo,91,11,58,0,0,8,77
Colorado,Walsh,638,68,339,58,11,76,552
Colorado,Eldora,39,14,12,0,13,0,39
Colorado,Foxfield,636,109,393,48,3,16,569
Colorado,Weston,23,3,6,0,7,7,23
Colorado,Wolcott,0,0,0,0,0,0,0
Colorado,Woody Creek,182,19,85,39,0,0,143
Colorado,Castle Pines Village,4701,591,2809,188,12,90,3690
Colorado,Phippsburg,225,40,88,63,0,6,197
Colorado,Watkins,598,123,339,51,0,28,541
Colorado,Castle Pines,10573,1898,5481,489,65,238,8171
Colorado,Del Norte,1539,339,663,230,28,79,1339
Colorado,Bow Mar,893,163,488,35,1,30,717
Colorado,Hugo,683,102,271,77,10,79,539
Colorado,Sawpit,43,5,28,3,0,5,41
Colorado,Glendale,5170,2984,1252,573,65,50,4924
Colorado,Boulder,107360,52998,31390,8375,769,2480,96012
Colorado,Niwot,4106,835,2048,390,0,57,3330
Colorado,Fort Carson,15410,6195,4798,308,85,20,11406
Colorado,Security-Widefield,38134,7365,16638,3372,759,1076,29210
Colorado,Aspen Park,997,181,466,132,0,14,793
Colorado,Golden,20798,8131,6833,2168,345,722,18199
Colorado,Fleming,590,109,267,64,0,36,476
Colorado,Iliff,326,81,140,51,2,3,277
Colorado,Vilas,90,11,19,20,1,3,54
Colorado,Nederland,1385,544,440,150,34,9,1177
Colorado,Gleneagle,6936,1188,3792,618,0,186,5784
Colorado,Deer Trail,478,117,199,59,16,10,401
Colorado,Air Force Academy,6633,4963,863,74,33,14,5947
Colorado,Steamboat Springs,12777,4913,4366,1418,107,398,11202
Colorado,Leadville,2679,661,1090,381,15,115,2262
Colorado,Ovid,216,45,85,29,1,26,186
Colorado,Grand View Estates,674,84,410,24,0,2,520
Colorado,Garden City,208,56,73,35,4,12,180
Colorado,Fairplay,865,248,354,88,0,10,700
Colorado,Brookside,226,27,123,25,0,10,185
Colorado,Dacono,5243,829,2261,441,144,243,3918
Colorado,Severance,4187,525,2383,124,14,71,3117
Colorado,Haswell,60,5,36,5,0,4,50
Colorado,Bethune,180,17,87,13,0,13,130
Colorado,Edgewater,5334,1950,1456,626,180,229,4441
Colorado,Pagosa Springs,2064,459,590,400,39,94,1582
Colorado,Penrose,2990,360,1598,230,29,190,2407
Colorado,Naturita,484,103,231,69,5,40,448
Colorado,Jamestown,195,66,74,31,0,0,171
Colorado,Byers,1307,245,683,87,15,67,1097
Colorado,La Junta,6914,1887,2434,595,81,475,5472
Colorado,Salt Creek,601,273,135,37,24,43,512
Colorado,Vail,5469,2401,2172,328,29,64,4994
Colorado,Craig,8888,1567,3838,969,128,569,7071
Colorado,Collbran,626,376,123,46,9,20,574
Colorado,Stratmoor,5883,1247,2307,626,113,220,4513
Colorado,Gunbarrel,9791,3293,4108,1076,73,187,8737
Colorado,Columbine,25094,4756,12389,2161,189,1091,20586
Colorado,Manassa,1020,252,361,109,17,60,799
Colorado,Englewood,33820,11707,10859,4312,454,1542,28874
Colorado,Arriba,140,21,51,23,6,14,115
Colorado,Julesburg,1259,242,520,134,30,116,1042
Colorado,Otis,530,88,222,34,7,40,391
Colorado,Dinosaur,278,65,115,26,2,11,219
Colorado,Sedgwick,135,31,58,18,3,7,117
Colorado,Silverthorne,4559,1141,2300,153,0,141,3735
Colorado,Kiowa,809,125,368,91,28,45,657
Colorado,Ponderosa Park,3617,734,1793,389,0,135,3051
Colorado,Lakewood,153522,42755,58729,18796,1777,7635,129692
Colorado,West Pleasant View,4691,1882,1353,571,172,119,4097
Colorado,Crook,164,42,46,28,0,18,134
Colorado,Simla,693,155,255,69,0,34,513
Colorado,Coal Creek,388,48,219,33,0,15,315
Colorado,Lincoln Park,3290,617,1716,379,11,192,2915
Colorado,Williamsburg,549,51,293,58,1,34,437
Colorado,Black Forest,14274,2514,8100,669,159,431,11873
Colorado,Central City,731,199,194,148,19,58,618
Colorado,Marble,105,14,68,9,0,4,95
Colorado,Pitkin,100,16,52,4,0,1,73
Colorado,Fort Collins,162511,63472,56010,11790,1098,4338,136708
Colorado,Telluride,1826,641,680,197,0,0,1518
Colorado,Allenspark,401,95,195,40,11,18,359
Colorado,Louisville,20705,4225,9533,1982,81,736,16557
Colorado,Ward,137,37,49,24,0,13,123
Colorado,Fountain,29339,4884,13763,2269,367,430,21713
Colorado,Crested Butte,1332,506,485,85,27,4,1107
Colorado,Estes Park,6297,876,3716,665,42,291,5590
Colorado,Loveland,75395,16309,33045,8269,708,3760,62091
Colorado,Winter Park,650,346,237,37,0,11,631
Colorado,Merino,249,81,87,26,0,0,194
Colorado,Fort Garland,587,149,169,93,6,37,454
Colorado,Kittredge,998,107,402,257,0,8,774
Colorado,Peyton,281,64,99,0,0,17,180
Colorado,Piedra,35,0,28,0,0,0,28
Colorado,Pine Brook Hill,1045,198,665,22,0,15,900
Colorado,Portland,88,7,65,6,0,7,85
Colorado,Raymer (New Raymer),62,12,28,8,0,7,55
Colorado,Redstone,72,7,34,31,0,0,72
Colorado,Redvale,241,35,106,52,11,27,231
Colorado,Rock Creek Park,111,0,75,0,0,0,75
Colorado,Rollinsville,218,14,191,13,0,0,218
Colorado,Saddle Ridge,84,11,54,0,0,0,65
Colorado,St. Ann Highlands,440,64,231,75,0,0,370
Colorado,San Acacio,91,31,31,21,0,8,91
Colorado,Segundo,143,3,92,1,3,18,117
Colorado,Seven Hills,167,0,94,0,0,35,129
Colorado,Shaw Heights,5459,1727,1892,389,177,236,4421
Colorado,Smeltertown,52,6,27,19,0,0,52
Colorado,Snyder,147,36,69,0,0,5,110
Colorado,Peoria,221,54,109,4,0,17,184
Colorado,Cheraw,234,50,65,58,4,19,196
Colorado,Fowler,1311,302,406,218,27,97,1050
Colorado,Haxtun,849,150,345,120,10,49,674
Colorado,Rifle,9600,1617,4305,754,66,289,7031
Colorado,Arvada,117251,26411,52777,11757,871,5153,96969
Colorado,Montrose,19096,3453,8589,2196,291,1140,15669
Colorado,Cortez,8637,2091,2983,1049,119,463,6705
Colorado,Fruitvale,8021,1245,3836,664,82,527,6354
Colorado,Eads,823,159,281,59,3,94,596
Colorado,Victor,429,122,190,67,9,21,409
Colorado,Red Feather Lakes,443,25,261,68,0,47,401
Colorado,Southern Ute,137,38,71,14,3,8,134
Colorado,Gunnison,6322,3460,1449,623,59,177,5768
Colorado,Branson,76,9,27,14,0,11,61
Colorado,Denver,693417,243201,224867,71025,10840,22871,572804
Colorado,Crawford,277,44,113,33,5,19,214
Colorado,Franktown,107,8,78,10,0,11,107
Colorado,Crestone,89,10,0,47,12,8,77
Colorado,Beulah Valley,646,89,311,139,0,60,599
Colorado,Hartman,83,13,47,2,0,3,65
Colorado,Holyoke,2407,461,1044,177,56,110,1848
Colorado,Tabernash,400,224,123,0,0,0,347
Colorado,Stonewall Gap,40,1,27,2,0,10,40
Colorado,Sugarloaf,393,78,222,93,0,0,393
Colorado,Sunshine,223,0,153,0,0,0,153
Colorado,Eckley,310,45,131,16,2,6,200
Colorado,Dillon,1169,299,484,183,32,28,1026
Colorado,Yampa,452,71,216,49,0,22,358
Colorado,South Fork,332,32,206,35,7,17,297
Colorado,Basalt,3955,855,1665,685,41,68,3314
Colorado,Aspen,7234,3030,2057,1232,19,79,6417
Colorado,Paoli,71,27,39,5,0,0,71
Colorado,Ridgway,1060,274,474,145,0,25,918
Colorado,Yuma,3482,550,1710,200,17,307,2784
Colorado,Log Lane Village,1224,231,628,86,10,43,998
Colorado,Thornton,134588,31719,53326,11881,2137,3660,102723
Colorado,Keenesburg,1380,287,575,170,2,29,1063
Colorado,Greeley,103773,28548,37647,9954,1379,4188,81716
Colorado,Erie,22965,3773,11155,1316,210,525,16979
Colorado,Calhan,817,109,378,108,10,33,638
Colorado,Gold Hill,124,64,39,0,0,21,124
Colorado,Sanford,935,144,445,42,4,22,657
Colorado,Montezuma,78,31,34,0,0,0,65
Colorado,Alamosa,9780,3843,2739,826,116,392,7916
Colorado,Sedalia,113,24,26,37,0,12,99
Colorado,Cheyenne Wells,989,176,399,73,4,87,739
Colorado,Empire,297,64,142,47,0,9,262
Colorado,Tall Timber,179,0,158,0,0,15,173
Colorado,Towner,18,2,11,2,0,0,15
Colorado,Trail Side,148,13,84,0,0,0,97
Colorado,Twin Lakes CDP (Adams County),7586,2229,2795,706,190,343,6263
Colorado,Twin Lakes CDP (Lake County),185,22,82,49,0,6,159
Colorado,Upper Bear Creek,1013,125,694,34,0,22,875
Colorado,Vineland,273,80,101,16,12,0,209
Colorado,Valdez,14,6,0,8,0,0,14
Colorado,Downieville-Lawson-Dumont,513,187,220,28,0,19,454
Colorado,Valmont,48,34,0,14,0,0,48
Colorado,Weldona,146,27,97,9,0,3,136
Colorado,Poncha Springs,778,166,331,126,17,24,664
Colorado,Platteville,2707,533,1270,219,14,102,2138
Colorado,Milliken,6773,1362,3144,569,41,156,5272
Colorado,Hudson,1722,394,681,213,10,62,1360
Colorado,Gilcrest,951,197,404,73,3,46,723
Colorado,Frederick,12138,1955,6116,777,65,259,9172
Colorado,Aristocrat Ranchettes,1100,232,449,137,0,99,917
Colorado,Vernon,0,0,0,0,0,0,0
Colorado,East Pleasant View,184,98,28,24,0,11,161
Colorado,Peetz,203,41,80,32,2,13,168
Colorado,Monument,7065,1388,3354,425,31,128,5326
Colorado,Jansen,249,43,46,11,0,0,100
Colorado,Jackson Lake,175,48,73,9,0,11,141
Colorado,Idledale,292,118,94,31,0,0,243
Colorado,Idalia,37,9,13,0,0,2,24
Colorado,Howard,829,178,462,70,0,25,735
Colorado,Inverness,1465,598,638,119,0,0,1355
Colorado,Holly Hills,2909,655,1199,417,0,151,2422
Colorado,Hoehne,96,4,69,0,1,0,74
Colorado,Joes,63,0,29,10,9,3,51
Colorado,Hidden Lake,0,0,0,0,0,0,0
Colorado,Hasty,118,5,53,22,0,11,91
Colorado,Guffey,9,0,0,9,0,0,9
Colorado,Goldfield,39,6,21,6,0,0,33
Colorado,Glendale,138,24,47,44,0,0,115
Colorado,Gerrard,118,6,94,18,0,0,118
Colorado,Garfield,6,6,0,0,0,0,6
Colorado,Fulford,0,0,0,0,0,0,0
Colorado,Floyd Hill,1131,291,678,98,0,0,1067
Colorado,Heeney,463,279,79,105,0,0,463
Colorado,Florissant,148,44,104,0,0,0,148
Colorado,Johnson Village,564,208,87,98,50,4,447
Colorado,Laird,52,13,29,10,0,0,52
Colorado,Paragon Estates,876,180,519,63,0,39,801
Colorado,Orchard,115,7,83,2,2,3,97
Colorado,North La Junta,313,67,101,53,16,29,266
Colorado,Norrie,0,0,0,0,0,0,0
Colorado,No Name,53,0,53,0,0,0,53
Colorado,Mulford,407,59,186,68,0,0,313
Colorado,Mountain Meadows,98,9,65,15,0,0,89
Colorado,Morgan Heights,267,10,195,13,0,18,236
Colorado,Kirk,88,7,49,16,0,8,80
Colorado,Midland,404,29,186,17,19,0,251
Colorado,Maybell,34,0,11,13,6,4,34
Colorado,McCoy,41,0,41,0,0,0,41
Colorado,Lynn,57,5,23,0,0,5,33
Colorado,Loma,1161,254,603,71,0,37,965
Colorado,Leyner,0,0,0,0,0,0,0
Colorado,Lewis,121,0,62,50,0,9,121
Colorado,Lazy Acres,868,80,512,170,0,29,791
Colorado,La Junta Gardens,90,19,55,5,0,0,79
Colorado,Maysville,157,22,112,15,0,8,157
Colorado,Lyons,2114,520,883,255,0,38,1696
Colorado,Fairmount,8710,1730,4485,708,19,228,7170
Colorado,Parshall,51,0,51,0,0,0,51
Colorado,Brandon,25,0,25,0,0,0,25
Colorado,Bonanza Mountain Estates,214,50,138,0,0,0,188
Colorado,Blue Sky,15,5,0,0,10,0,15
Colorado,Blende,821,161,302,67,20,98,648
Colorado,Bark Ranch,138,64,59,15,0,0,138
Colorado,Amherst,195,77,70,16,0,0,163
Colorado,Altona,442,54,253,54,0,40,401
Colorado,Alpine,390,81,242,33,0,0,356
Colorado,Indian Hills,1408,254,624,242,0,27,1147
Colorado,Aetna Estates,1475,352,472,60,0,0,884
Colorado,Centennial,109505,22116,53161,9478,746,3304,88805
Colorado,Lone Tree,14209,3099,7118,991,48,359,11615
Colorado,Cimarron Hills,18285,4048,6794,1937,246,597,13622
Colorado,Meridian,3615,914,1630,371,41,128,3084
Colorado,Padroni,97,18,61,14,0,4,97
Colorado,Woodmoor,9117,1639,5317,339,19,44,7358
Colorado,Evergreen,8602,1414,4670,802,66,229,7181
Colorado,Palmer Lake,2684,521,1298,291,0,120,2230
Colorado,Cañon City,16428,3141,6730,2141,266,1184,13462
Colorado,El Moro,275,31,183,6,3,20,243
Colorado,Brick Center,142,52,61,19,0,10,142
Colorado,Cathedral,19,0,15,0,0,4,19
Colorado,Ellicott,839,119,380,88,0,13,600
Colorado,Elbert,193,57,59,30,0,8,154
Colorado,Dove Valley,5597,1424,1812,647,24,87,3994
Colorado,Dotsero,949,324,348,42,48,0,762
Colorado,Divide,87,0,26,32,0,0,58
Colorado,Dakota Ridge,34250,7464,16257,3102,355,839,28017
Colorado,Crisman,128,25,58,15,30,0,128
Colorado,Cotopaxi,0,0,0,0,0,0,0
Colorado,Capulin,227,86,105,12,0,9,212
Colorado,Copper Mountain,371,224,36,111,0,0,371
Colorado,Comanche Creek,295,39,155,37,0,12,243
Colorado,Colona,54,19,0,19,0,16,54
Colorado,Coaldale,418,49,146,53,0,32,280
Colorado,City of Creede,344,106,115,54,8,28,311
Colorado,Cherry Creek,12601,2499,5797,1047,116,251,9710
Colorado,Chacra,541,117,281,20,0,11,429
Colorado,Cattle Creek,1094,277,384,52,0,11,724
Colorado,Catherine,264,54,102,34,0,36,226
Colorado,Conejos,47,0,0,18,0,9,27
Colorado,Frisco,3074,944,1175,645,0,14,2778
Colorado,Alamosa East,1439,372,633,77,46,34,1162
Colorado,Lamar,7606,1880,2620,961,96,444,6001
Colorado,Blanca,446,94,210,17,2,19,342
Colorado,Orchard City,3069,323,1540,440,34,244,2581
Colorado,Ignacio,1282,338,312,196,48,58,952
Colorado,Berkley,11822,3924,3736,1299,271,431,9661
Colorado,Nucla,518,85,213,90,0,46,434
Colorado,New Castle,4767,1008,2124,422,22,120,3696
Colorado,Sherrelwood,19243,5519,6568,2059,474,706,15326
Colorado,Aurora,363550,98742,132261,35279,5732,12680,284694
Colorado,De Beque,459,89,165,75,0,28,357
Colorado,Ken Caryl,33804,6577,15951,3649,242,1000,27419
Colorado,Eldorado Springs,704,210,391,12,37,2,652
Colorado,Rangely,2289,545,1050,143,16,62,1816
Colorado,Stonegate,9511,1428,4584,698,37,246,6993
Colorado,Federal Heights,12645,3623,3726,1266,273,628,9516
Colorado,Commerce City,54795,11926,20675,4730,319,1322,38972
Colorado,Bennett,2202,480,1061,170,30,63,1804
Colorado,Paonia,1374,262,471,271,11,122,1137
Colorado,Atwood,83,36,32,3,0,12,83
Colorado,Cascade-Chipita Park,1260,224,652,201,30,10,1117
Colorado,Superior,13014,2878,6132,960,112,229,10311
Colorado,Strasburg,2705,442,1277,211,46,126,2102
Colorado,Starkville,83,7,25,7,8,14,61
Colorado,Cedaredge,2307,448,1011,303,9,189,1960
Colorado,Perry Park,1917,203,1364,147,13,26,1753
Colorado,Acres Green,2899,671,1470,250,0,51,2442
Colorado,North Washington,553,211,125,60,0,43,439
Colorado,Walden,579,80,297,58,1,28,464
Colorado,Woodland Park,7421,1555,3797,716,21,201,6290
Colorado,Ophir,170,43,78,6,0,0,127
Colorado,Mountain Village,1767,761,546,174,35,9,1525
Colorado,Glenwood Springs,9894,2622,3964,1092,92,471,8241
Colorado,Sterling,13775,4003,4463,1623,290,797,11176
Colorado,Lakeside,8,5,0,3,0,0,8
Colorado,Applewood,8308,1725,3847,707,69,344,6692
Colorado,Roxborough Park,9452,1451,5321,446,9,112,7339
Colorado,Highlands Ranch,105147,19478,52309,7076,466,2430,81759
Colorado,Battlement Mesa,4735,890,2281,287,53,188,3699
Colorado,Clifton,20572,4720,7121,3010,313,901,16065
Colorado,Westcreek,179,0,118,12,0,6,136
Colorado,The Pinery,11754,1683,6807,605,39,261,9395
Colorado,Colorado City,2300,497,859,320,27,55,1758
Colorado,Delta,8768,1760,3119,1405,99,874,7257
Colorado,Mountain View,614,180,211,111,13,15,530
Colorado,Manitou Springs,5280,1116,2538,676,58,156,4544
Colorado,Rico,174,68,47,29,4,6,154
Colorado,Wheat Ridge,31323,8933,12070,3677,318,1835,26833
Colorado,Ramah,156,27,83,6,2,7,125
Colorado,Westminster,112747,28495,46439,11409,1387,4083,91813
Colorado,Lafayette,28002,6610,12012,3218,224,744,22808
Colorado,Granby,1805,416,762,266,0,106,1550
Colorado,Genoa,108,12,35,17,7,14,85
Colorado,El Jebel,4167,1400,1801,241,59,80,3581
Colorado,Leadville North,2031,632,895,390,53,24,1994
Colorado,Mancos,1742,436,589,222,8,83,1338
Colorado,Kremmling,1684,434,691,119,4,94,1342
Colorado,Rockvale,516,71,296,58,0,41,466
Colorado,Edwards,10071,3189,4255,658,67,101,8270
Colorado,Bayfield,2612,475,1117,219,0,143,1954
Colorado,Sheridan Lake,95,14,26,12,0,2,54
Colorado,Dove Creek,673,62,381,50,7,29,529
Colorado,Avon,6529,1733,2417,734,115,0,4999
Colorado,Morrison,388,46,155,89,0,74,364
Colorado,Mount Crested Butte,967,449,326,115,19,19,928
Colorado,Coal Creek,2157,327,1290,266,23,50,1956
Colorado,Lake City,454,36,256,50,2,25,369
Colorado,Wellington,8571,1510,3635,702,30,189,6066
Colorado,Hot Sulphur Springs,809,162,373,32,0,40,607
Colorado,Florence,3890,668,1711,616,50,199,3244
Colorado,Minturn,1090,448,426,76,15,31,996
Colorado,Eagle,6816,1486,2842,503,0,47,4878
Colorado,Ordway,1472,495,429,195,44,98,1261
Colorado,Akron,2083,531,813,173,61,130,1708
Colorado,Westcliffe,378,123,121,62,5,37,348
Colorado,Blue River,666,167,304,62,0,5,538
Colorado,Timnath,2922,291,1669,38,0,20,2018
Colorado,Oak Creek,894,216,309,143,6,51,725
Colorado,Parker,52563,10076,24040,3576,335,851,38878
Colorado,Louviers,307,62,133,33,0,10,238
Colorado,Larkspur,257,63,103,37,7,15,225
Colorado,Carbondale,6712,1220,3119,555,110,216,5220
Colorado,Redlands,9036,951,4873,966,32,623,7445
Colorado,Grand Junction,61479,16366,22097,7663,975,3525,50626
Colorado,Kim,85,11,48,10,1,1,71
Colorado,Flagler,467,102,187,39,0,60,388
Colorado,Monte Vista,4169,951,1480,388,65,276,3160
Colorado,Hotchkiss,932,159,381,54,8,56,658
Colorado,Littleton,47035,11803,19409,5491,505,2075,39283
Colorado,Seibert,119,21,52,27,0,17,117
Colorado,Black Hawk,138,57,61,7,0,8,133
Colorado,Red Cliff,366,111,151,44,0,12,318
Colorado,Meeker,2591,276,1028,354,5,173,1836
Colorado,Cripple Creek,1136,220,328,360,8,63,979
Colorado,Norwood,619,147,233,112,10,21,523
Colorado,Antonito,645,164,182,104,18,71,539
Colorado,Green Mountain Falls,592,162,235,115,3,42,557
Colorado,Burlington,3626,547,1816,304,91,208,2966
Colorado,Arboles,313,31,147,51,16,19,264
Colorado,Salida,5642,1153,2464,733,49,436,4835
Colorado,Mead,4523,745,2220,236,37,67,3305
Colorado,Longmont,93244,22735,36909,9876,1145,3759,74424
Colorado,Grover,180,34,99,10,4,3,150
Colorado,Windsor,25232,3778,12509,1846,297,711,19141
Colorado,Fort Lupton,8022,1787,3329,678,71,309,6174
Colorado,Brighton,39054,10305,15230,3233,400,1203,30371
Colorado,Ault,2178,437,819,251,35,69,1611
Colorado,Limon,1269,160,566,168,16,105,1015
Colorado,Laporte,2411,321,1231,325,25,104,2006
Colorado,Fruita,13145,2541,5724,1311,76,795,10447
Colorado,Dolores,877,300,256,95,5,31,687
Colorado,Two Buttes,41,0,31,4,0,4,39
Colorado,Fraser,1717,827,503,79,25,0,1434
Colorado,Elizabeth,1127,207,521,118,9,38,893
Colorado,Center,2188,610,685,209,90,58,1652
Colorado,Georgetown,1168,329,414,231,3,75,1052
Colorado,Kit Carson,272,54,86,19,0,23,182
Colorado,Greenwood Village,15677,3303,7950,1197,76,419,12945
Colorado,Nunn,577,95,268,68,2,35,468
Colorado,Grand Lake,250,45,123,52,0,13,233
Colorado,Lochbuie,6036,1244,2510,589,26,169,4538
Colorado,Firestone,13109,1857,6362,992,67,396,9674
Colorado,Las Animas,2065,464,712,278,49,199,1702
Colorado,Rye,185,18,101,21,0,13,153
Colorado,Pueblo,109985,31536,35021,14792,1675,6251,89275
Colorado,Hooper,53,2,30,7,0,8,47
Colorado,Genesee,3766,483,2258,257,0,150,3148
Colorado,Colorado Springs,457502,114276,182434,48292,6448,16960,368410
Colorado,Olathe,1882,463,617,220,36,121,1457
Colorado,Johnstown,14278,2024,7456,1013,123,290,10906
Colorado,Gypsum,7079,1216,2841,1115,155,233,5560
Colorado,Columbine Valley,1221,149,791,40,0,40,1020
Colorado,Olney Springs,539,222,154,90,7,20,493
Colorado,Bonanza,2,0,0,2,0,0,2
Colorado,Hayden,1791,414,777,167,17,137,1512
Colorado,Pueblo West,31860,6319,14918,2846,195,1038,25316
Colorado,Holly,970,158,415,49,8,68,698
Colorado,Loghill Village,604,64,444,44,0,11,563
Colorado,Rocky Ford,3824,885,1380,419,88,293,3065
Colorado,Sheridan,6056,1952,1666,1047,55,239,4959
Colorado,Alma,387,131,133,39,4,0,307
Colorado,Silverton,490,130,199,68,0,34,431
Colorado,La Jara,835,156,286,85,28,72,627
Colorado,Aguilar,485,90,199,80,17,33,419
Colorado,Vona,103,8,60,6,1,4,79
Colorado,Stratton,650,150,271,36,0,40,497
Colorado,Orchard Mesa,6601,1411,2822,771,143,359,5506
Colorado,Durango,18321,6345,6680,1964,44,686,15719
Colorado,Palisade,2686,560,935,435,49,184,2163
Colorado,Cokedale,102,3,61,17,0,0,81
Colorado,San Luis,741,156,212,121,27,109,625
Colorado,Trinidad,8043,2204,3167,882,135,501,6889
Colorado,Silver Cliff,614,140,190,105,11,15,461
Colorado,Boone,235,70,97,26,4,12,209
Colorado,Pritchett,104,22,47,10,4,1,84
Colorado,Wray,2430,380,862,305,38,177,1762
Colorado,Breckenridge,4936,2936,1161,457,0,0,4554
Colorado,Saguache,526,110,181,140,9,18,458
Colorado,Moffat,135,34,42,35,3,2,116
Colorado,St. Mary's,516,73,172,151,0,0,396
Colorado,Wiley,309,64,156,28,10,15,273
Colorado,Wiggins,1102,159,542,77,14,38,830
Colorado,Northglenn,38918,10091,13930,4086,654,1533,30294
Colorado,Kersey,1760,421,770,113,25,23,1352
Colorado,Silver Plume,163,41,67,19,2,8,137
Colorado,Cherry Hills Village,6600,832,3772,249,54,105,5012
Colorado,Berthoud,6518,1105,3041,992,16,174,5328
Colorado,Castle Rock,59680,10340,28015,5025,343,1395,45118
Colorado,Silt,3091,842,1143,268,5,96,2354
Colorado,Parachute,1242,220,475,117,35,49,896
Colorado,Welby,16352,4637,4644,2042,426,627,12376
Colorado,Todd Creek,4286,675,2504,178,10,78,3445
Colorado,Derby,9084,2351,2874,782,223,236,6466
Colorado,Broomfield,66120,14690,30839,5129,489,2080,53227
Connecticut,Willimantic,17184,9137,3032,1613,359,530,14671
Connecticut,East Haven,28860,8617,10573,3149,270,1978,24587
Connecticut,Woodmont borough,1698,495,672,230,7,77,1481
Connecticut,East Hartford,50453,17272,16114,5495,788,2169,41838
Connecticut,Groton Long Point borough,499,73,331,40,1,22,467
Connecticut,West Simsbury,2523,367,1371,148,7,194,2087
Connecticut,Litchfield borough,1244,181,470,239,4,183,1077
Connecticut,Northwest Harwinton,3244,576,1675,293,60,86,2690
Connecticut,Crystal Lake,2231,444,1139,94,49,125,1851
Connecticut,Salmon Brook,2438,457,1110,331,26,112,2036
Connecticut,Westbrook Center,2075,576,1053,305,18,74,2026
Connecticut,Mansfield Center,913,273,360,40,40,23,736
Connecticut,Essex Village,2595,554,1470,178,68,96,2366
Connecticut,Georgetown,1824,306,769,293,0,97,1465
Connecticut,Bridgeport,146417,56022,39767,12598,3134,6140,117661
Connecticut,Pawcatuck,5249,1245,1906,780,58,360,4349
Connecticut,Niantic,2872,514,1363,524,1,182,2584
Connecticut,New London,27032,12536,5936,2909,593,952,22926
Connecticut,Weatogue,2788,561,1388,172,11,122,2254
Connecticut,Southwood Acres,7715,1739,3494,649,20,509,6411
Connecticut,Sherwood Manor,5438,1382,2327,544,24,389,4666
Connecticut,Long Hill,4191,1769,1187,495,28,302,3781
Connecticut,Fenwick borough,69,5,55,3,0,6,69
Connecticut,Rockville,7332,3125,1229,1095,73,410,5932
Connecticut,North Granby,1657,353,913,97,1,12,1376
Connecticut,Danbury,84479,25973,31523,6932,1236,3810,69474
Connecticut,Waterbury,108672,38032,29416,10539,2274,5689,85950
Connecticut,Madison Center,2519,313,960,492,19,245,2029
Connecticut,Wauregan,1321,281,532,73,0,56,942
Connecticut,Quinebaug,1327,426,680,59,0,24,1189
Connecticut,Moosup,3943,1412,1244,457,22,138,3273
Connecticut,East Brooklyn,1350,437,493,94,23,97,1144
Connecticut,Norwalk,88436,25410,35568,7538,980,4091,73587
Connecticut,East Hampton,2760,642,1203,241,0,140,2226
Connecticut,Clinton,3453,978,1355,471,5,168,2977
Connecticut,Darien,21759,4028,10491,900,66,667,16152
Connecticut,Woodbury Center,1449,268,601,234,0,63,1166
Connecticut,North Haven,23786,5332,11502,1603,228,1443,20108
Connecticut,Hazardville,4896,1286,1826,496,42,368,4018
Connecticut,Naugatuck borough,31481,8692,12504,2822,185,1714,25917
Connecticut,Kensington,8190,1498,3981,824,15,679,6997
Connecticut,Storrs,16516,15336,518,233,14,284,16385
Connecticut,Coventry Lake,2749,895,897,464,72,81,2409
Connecticut,Oxoboxo River,2906,524,1304,363,0,200,2391
Connecticut,Tariffville,1391,480,555,107,24,17,1183
Connecticut,Hartford,123628,55521,24442,11593,2908,4647,99111
Connecticut,Collinsville,3514,484,1715,437,11,183,2830
Connecticut,West Haven,54918,20400,16129,5870,768,2248,45415
Connecticut,Cheshire Village,6484,1315,3042,534,19,475,5385
Connecticut,North Grosvenor Dale,1271,323,524,88,0,38,973
Connecticut,Heritage Village,4143,515,1864,732,7,966,4084
Connecticut,New Britain,72839,27843,20552,5638,1069,3114,58216
Connecticut,Ansonia,18860,5814,6289,1988,226,1066,15383
Connecticut,Broad Brook,4766,1067,1733,496,86,204,3586
Connecticut,Terramuggus,1136,277,704,24,0,55,1060
Connecticut,Bethlehem Village,1798,397,812,297,49,60,1615
Connecticut,Gales Ferry,862,145,449,80,14,18,706
Connecticut,Falls Village,478,108,195,46,10,49,408
Connecticut,Cos Cob,6959,1649,2968,584,38,230,5469
Connecticut,Conning Towers Nautilus Park,9749,3574,3568,314,46,249,7751
Connecticut,Cannondale,29,3,24,2,0,0,29
Connecticut,Byram,4216,937,1715,441,168,145,3406
Connecticut,Brooklyn,965,411,260,125,99,53,948
Connecticut,Baltic,1182,337,359,145,44,59,944
Connecticut,Wilton Center,824,235,295,110,18,39,697
Connecticut,Stafford Springs,4947,1606,1588,658,69,224,4145
Connecticut,Colchester,5048,1303,1755,738,62,304,4162
Connecticut,Deep River Center,2448,718,883,335,0,99,2035
Connecticut,West Hartford,63127,17234,26403,4651,427,3163,51878
Connecticut,Canaan,1227,443,272,174,70,102,1061
Connecticut,Portland,5572,1456,2133,534,47,586,4756
Connecticut,Ridgefield,7963,1113,3774,784,13,458,6142
Connecticut,Bantam borough,735,160,302,90,17,82,651
Connecticut,Thompsonville,8439,2998,2113,1249,161,442,6963
Connecticut,Guilford Center,2618,618,1077,441,7,87,2230
Connecticut,Meriden,59864,19383,20895,6133,757,3649,50817
Connecticut,Shelton,41155,9570,19254,3694,146,2640,35304
Connecticut,Danielson borough,3983,1263,1205,485,105,234,3292
Connecticut,Wethersfield,26267,6366,11968,2026,85,1599,22044
Connecticut,Wallingford Center,18322,5274,6935,2000,258,1314,15781
Connecticut,Jewett City borough,3411,1000,930,409,0,219,2558
Connecticut,New Preston,908,101,560,127,0,27,815
Connecticut,Milford city (balance),52349,13253,23364,5040,342,2912,44911
Connecticut,Bristol,60308,17243,22303,6346,604,3360,49856
Connecticut,Stratford,52279,14087,21894,4660,403,3263,44307
Connecticut,Higganum,1496,147,885,167,0,30,1229
Connecticut,Norfolk,496,123,168,113,0,20,424
Connecticut,Manchester,29899,10280,9512,3079,293,1249,24413
Connecticut,Lakeville,1154,248,488,169,0,27,932
Connecticut,Greenwich,13303,3446,5555,1294,273,443,11011
Connecticut,Glenville,2499,611,1286,109,18,156,2180
Connecticut,Suffield Depot,1334,470,436,142,2,88,1138
Connecticut,Glastonbury Center,7742,1816,3102,982,121,518,6539
Connecticut,Blue Hills,2753,1141,661,320,130,162,2414
Connecticut,South Windham,1533,415,545,113,0,65,1138
Connecticut,Simsbury Center,6091,1108,3151,496,21,279,5055
Connecticut,Plainfield Village,2113,429,867,252,112,188,1848
Connecticut,Westport,27840,5058,13718,1554,161,1218,21709
Connecticut,Old Greenwich,6819,1025,3417,288,29,112,4871
Connecticut,Stamford,129026,38188,51138,10138,2191,5117,106772
Connecticut,South Coventry,1117,255,579,65,10,57,966
Connecticut,Old Mystic,3513,623,1739,374,37,177,2950
Connecticut,Mystic,4221,912,2159,433,4,337,3845
Connecticut,Groton,9109,3046,2715,1396,99,228,7484
Connecticut,Winsted,7367,2354,2575,1011,83,342,6365
Connecticut,Noank,1487,344,742,183,0,94,1363
Connecticut,South Woodstock,1181,283,557,143,0,61,1044
Connecticut,Newtown borough,1949,377,916,192,0,85,1570
Connecticut,Orange,13937,2774,7299,646,50,852,11621
Connecticut,New Haven,130529,60583,27959,11215,1942,4417,106116
Connecticut,Poquonock Bridge,2450,942,683,91,19,82,1817
Connecticut,Saybrook Manor,1103,288,496,132,7,37,960
Connecticut,Bethel,9659,2536,3424,1238,203,436,7837
Connecticut,Pemberwick,4114,1104,1743,329,0,246,3422
Connecticut,Middletown,46473,17071,15541,4742,345,2123,39822
Connecticut,Riverside,8414,1469,3932,436,65,310,6212
Connecticut,Durham,2631,672,1150,284,20,113,2239
Connecticut,Putnam,6772,1928,2221,1045,61,484,5739
Connecticut,Chester Center,1653,331,805,171,11,72,1390
Connecticut,Moodus,1610,390,751,85,0,107,1333
Connecticut,Terryville,4900,1231,1853,702,70,309,4165
Connecticut,Oakville,8929,2137,3942,710,60,571,7420
Connecticut,Newington,30323,7963,12599,3210,254,2042,26068
Connecticut,Canton Valley,1525,432,447,325,17,87,1308
Connecticut,Derby,12596,4050,4313,1068,235,748,10414
Connecticut,Branford Center,6413,2022,2466,665,42,435,5630
Connecticut,Trumbull,36174,7358,17734,1777,201,2020,29090
Connecticut,Old Saybrook Center,1881,349,756,353,37,159,1654
Connecticut,Lake Pocotopaug,3413,689,1552,460,13,135,2849
Connecticut,New Hartford Center,1061,304,256,250,0,64,874
Connecticut,Norwich,39567,12099,13100,5039,503,1885,32626
Connecticut,Somers,1887,312,1019,77,9,140,1557
Connecticut,Stonington borough,906,207,409,165,7,61,849
Connecticut,Southport,1664,319,841,180,11,93,1444
Connecticut,Thomaston,1793,582,491,317,0,162,1552
Connecticut,Sharon,724,151,317,84,0,76,628
Connecticut,Watertown,3324,784,1616,302,32,267,3001
Connecticut,Waterford,2796,660,995,389,43,243,2330
Connecticut,Mashantucket,216,71,89,9,0,7,176
Connecticut,Plantsville,1726,464,706,252,0,115,1537
Connecticut,Windsor Locks,12613,3286,5068,1530,172,610,10666
Connecticut,New Milford,6737,2050,2417,895,21,407,5790
Connecticut,Torrington,34737,9148,13426,4436,240,2063,29313
Delaware,Greenwood,1017,212,408,78,30,42,770
Delaware,Blades,1366,351,463,96,20,79,1009
Delaware,Riverview,2684,594,1241,129,0,47,2011
Delaware,Claymont,8676,2608,2981,937,161,393,7080
Delaware,Highland Acres,3645,653,1893,258,7,197,3008
Delaware,Bear,21362,5965,7441,2513,417,592,16928
Delaware,Dagsboro,856,180,362,92,9,55,698
Delaware,Millsboro,4238,891,1698,236,70,304,3199
Delaware,South Bethany,426,53,291,30,5,44,423
Delaware,Slaughter Beach,231,34,132,33,3,15,217
Delaware,Selbyville,2252,521,929,179,51,186,1866
Delaware,Pike Creek,8312,1572,3991,943,34,262,6802
Delaware,Newport,1335,431,310,98,85,51,975
Delaware,Rehoboth Beach,1281,270,783,94,25,73,1245
Delaware,Woodside,164,37,49,57,6,12,161
Delaware,Camden,3469,440,1851,296,73,117,2777
Delaware,North Star,7441,1190,4678,212,23,278,6381
Delaware,Houston,409,75,198,38,10,21,342
Delaware,Millville,1877,389,898,154,31,87,1559
Delaware,Middletown,21250,4473,9046,1119,455,1140,16233
Delaware,Edgemoor,6471,2003,2066,801,26,123,5019
Delaware,Harrington,3667,678,1386,262,0,125,2451
Delaware,Townsend,2332,513,905,151,48,57,1674
Delaware,Rising Sun-Lebanon,4263,824,1702,435,62,92,3115
Delaware,Ardencroft village,207,40,90,43,2,10,185
Delaware,Newark,33352,18460,8971,1843,240,1135,30649
Delaware,Greenville,2333,494,1135,206,19,160,2014
Delaware,Bridgeville,2696,480,1310,245,71,151,2257
Delaware,Delaware City,1719,472,467,280,36,86,1341
Delaware,Little Creek,169,48,71,19,1,8,147
Delaware,Kent Acres,2429,478,797,248,67,125,1715
Delaware,Hartly,59,11,29,2,0,2,44
Delaware,Frederica,995,245,374,69,32,25,745
Delaware,Farmington,100,23,26,9,5,12,75
Delaware,Long Neck,2556,292,1396,298,62,226,2274
Delaware,Ardentown village,259,46,82,55,11,25,219
Delaware,Cheswold,1313,294,441,134,43,116,1028
Delaware,Laurel,4211,1208,765,317,106,119,2515
Delaware,Clayton,3237,806,1308,223,29,71,2437
Delaware,Pike Creek Valley,10664,3302,3775,1294,150,498,9019
Delaware,Felton,1478,393,459,154,29,103,1138
Delaware,Ocean View,2198,302,1320,182,12,137,1953
Delaware,Milford,10835,2828,3977,917,212,674,8608
Delaware,Delmar,1790,505,528,239,17,106,1395
Delaware,Bethel,191,29,106,17,5,15,172
Delaware,Odessa,565,116,274,65,10,30,495
Delaware,New Castle,5359,1767,1984,678,110,324,4863
Delaware,Glasgow,14342,4339,5982,1244,109,306,11980
Delaware,Dover,37331,14217,10115,4059,480,1780,30651
Delaware,Lewes,3118,536,1699,304,51,311,2901
Delaware,Georgetown,7123,2152,2081,534,219,443,5429
Delaware,Fenwick Island,461,34,314,20,7,57,432
Delaware,Leipsic,144,35,49,18,4,15,121
Delaware,Frankford,984,249,317,57,20,57,700
Delaware,Bowers,345,101,130,36,15,26,308
Delaware,Dover Base Housing,3467,393,1835,88,0,34,2350
Delaware,Rodney Village,1370,467,310,212,32,21,1042
Delaware,Wilmington,70904,30171,14267,7493,1232,3676,56839
Delaware,Smyrna,11333,3205,4113,922,177,633,9050
Delaware,Hockessin,13472,2487,7147,678,28,862,11202
Delaware,Arden village,388,119,153,56,13,29,370
Delaware,Viola,165,47,57,22,2,2,130
Delaware,Kenton,208,59,61,37,5,8,170
Delaware,Seaford,7572,1952,2473,981,38,547,5991
Delaware,Milton,2840,596,1087,286,79,254,2302
Delaware,Henlopen Acres,204,35,127,8,0,10,180
Delaware,Ellendale,436,142,124,49,10,20,345
Delaware,Dewey Beach,306,56,184,28,3,24,295
Delaware,Bethany Beach,1006,151,581,56,3,132,923
Delaware,Wilmington Manor,7902,2226,2891,684,112,338,6251
Delaware,Elsmere,6049,2339,1724,833,27,257,5180
Delaware,Brookside,13191,4045,4698,1521,167,522,10953
Delaware,Wyoming,1437,278,480,253,21,59,1091
Delaware,Magnolia,346,113,76,43,26,4,262
Delaware,St. Georges,795,190,409,4,0,44,647
Delaware,Bellefonte,1140,332,510,64,19,35,960
Delaware,Woodside East,2555,861,692,293,144,93,2083
District of Columbia,Washington,684498,325494,164909,50403,12521,25188,578515
Florida,Winter Beach,2340,540,1233,157,0,202,2132
Florida,Duck Key,696,146,315,99,0,97,657
Florida,Big Coppitt Key,2951,749,898,558,36,189,2430
Florida,Westwood Lakes,12121,3074,4635,1268,401,1041,10419
Florida,Westview,11068,3702,3205,1437,198,654,9196
Florida,University Park,26317,9313,9233,2865,522,1450,23383
Florida,Tamiami,57514,16363,21879,6537,1569,3783,50131
Florida,Clewiston,7663,2478,2514,545,302,393,6232
Florida,Raiford,224,61,82,20,0,10,173
Florida,Sharpes,3049,680,1062,548,71,265,2626
Florida,Rockledge,26906,5566,12368,2838,304,1576,22652
Florida,Port St. John,11729,2806,4880,1357,185,660,9888
Florida,Lake Kathryn,1034,402,352,135,11,29,929
Florida,South Miami,12202,3999,4213,1149,314,431,10106
Florida,Fort Pierce North,7070,2616,1803,734,127,446,5726
Florida,Largo,83243,20459,30130,13104,1475,6671,71839
Florida,Gainesville,130790,72472,28494,9944,1609,4002,116521
Florida,Pompano Beach,108855,33169,34333,13551,2677,7205,90935
Florida,Keystone Heights,1653,310,681,153,22,86,1252
Florida,Mount Plymouth,5610,1300,2204,453,223,251,4431
Florida,Graceville,2542,843,639,357,65,211,2115
Florida,Zolfo Springs,1872,329,594,109,39,81,1152
Florida,Pembroke Pines,168260,45109,67485,15793,2629,8543,139559
Florida,Nokomis,3332,848,1088,774,63,317,3090
Florida,Tavernier,2260,608,824,339,40,76,1887
Florida,Fruitville,13780,3203,5705,1545,201,1018,11672
Florida,Kensington Park,4593,1299,1630,448,145,284,3806
Florida,Harbour Heights,3578,710,1632,293,93,180,2908
Florida,Cleveland,3280,714,1378,382,12,477,2963
Florida,Charlotte Harbor,4077,862,1447,441,73,923,3746
Florida,Weston,70220,14161,32773,4660,473,1999,54066
Florida,Homosassa,1987,98,1193,378,0,250,1919
Florida,Citrus Springs,8421,1674,3472,1102,137,563,6948
Florida,Solana,904,208,325,72,8,82,695
Florida,Homosassa Springs,13477,2880,5654,1898,258,1190,11880
Florida,Montverde,1622,328,799,107,3,54,1291
Florida,Groveland,12465,2659,4913,1360,255,588,9775
Florida,Paisley,1338,158,511,206,39,38,952
Florida,Titusville,45483,10859,17890,6106,724,2929,38508
Florida,Crystal River,3092,838,1066,398,16,575,2893
Florida,Washington Park,1799,830,465,113,58,87,1553
Florida,Combee Settlement,6323,2128,1774,986,64,61,5013
Florida,Auburndale,15343,3511,6140,1761,298,782,12492
Florida,Lake Butler,1770,487,461,219,35,80,1282
Florida,The Meadows,4346,489,2291,568,0,749,4097
Florida,Sarasota,56102,16275,19209,8476,1152,4341,49453
Florida,Osprey,7028,952,4331,498,79,308,6168
Florida,North Sarasota,8997,2484,2656,1201,135,501,6977
Florida,North Port,64425,12826,28661,7143,823,4081,53534
Florida,Satellite Beach,10721,1738,5301,961,73,617,8690
Florida,Brooker,337,63,132,39,7,22,263
Florida,Springfield,9475,2449,2434,1507,356,760,7506
Florida,Villas,12036,3153,4755,1934,211,1052,11105
Florida,Gulf Stream,740,105,446,42,2,30,625
Florida,Winter Park,30189,8255,12276,2996,249,1842,25618
Florida,East Palatka,1797,665,380,339,44,135,1563
Florida,Manalapan,280,18,202,27,0,20,267
Florida,Bristol,1025,308,201,188,20,113,830
Florida,Spring Lake,589,106,374,81,5,0,566
Florida,Plantation Island,295,64,48,42,0,0,154
Florida,Chokoloskee,268,0,132,87,0,49,268
Florida,Pretty Bayou,3674,642,1714,450,29,322,3157
Florida,Panama City,36880,9759,11251,5411,947,2646,30014
Florida,Wesley Chapel,55046,12318,23419,4484,659,2009,42889
Florida,Dade City North,3030,1169,751,232,38,133,2323
Florida,Punta Rassa,1908,139,1117,110,0,542,1908
Florida,Cape Coral,178593,37936,77945,21478,2903,11633,151895
Florida,Buckingham,4047,920,1772,423,50,210,3375
Florida,Bonita Springs,53812,9600,28611,4895,643,4137,47886
Florida,Lake City,11977,3173,3246,1886,353,591,9249
Florida,Okahumpka,146,0,89,0,0,57,146
Florida,Mascotte,5552,1568,2085,410,53,154,4270
Florida,Lisbon,345,11,182,72,0,80,345
Florida,Malabar,2990,570,1648,368,20,122,2728
Florida,Pace,23749,4946,10495,2103,506,917,18967
Florida,Gulf Breeze,6383,1050,3184,659,59,432,5384
Florida,Pinellas Park,52291,12351,19269,7365,1171,3992,44148
Florida,Port Charlotte,61204,12085,26164,8035,1104,5947,53335
Florida,Tildenville,1199,140,306,0,0,133,579
Florida,Ojus,17462,3921,7064,1977,551,1034,14547
Florida,Watertown,3507,1081,854,293,153,256,2637
Florida,Astor,1418,275,544,204,34,236,1293
Florida,Webster,671,179,258,84,10,31,562
Florida,Esto,360,82,132,55,2,26,297
Florida,Lakeside,30890,7405,12593,3241,523,1653,25415
Florida,Welaka,677,150,234,84,13,77,558
Florida,South Gate Ridge,6328,1377,2658,912,101,422,5470
Florida,North Bay Village,8198,2573,2886,1125,164,363,7111
Florida,Fort White,667,139,258,75,0,35,507
Florida,Valrico,38169,7711,18165,2937,470,1444,30727
Florida,Ebro,263,39,122,16,11,21,209
Florida,Davenport,4140,1026,1597,253,76,170,3122
Florida,Poinciana,67169,18895,24729,5369,1584,2522,53099
Florida,Branford,796,256,218,71,15,75,635
Florida,Brandon,113279,32550,41545,12449,2108,4722,93374
Florida,Lake Hamilton,1551,408,605,134,40,79,1266
Florida,Mangonia Park,2615,934,618,172,33,67,1824
Florida,Vero Beach South,24082,5612,9523,2800,532,2120,20587
Florida,Laurel Hill,643,126,236,52,24,66,504
Florida,Palm Bay,110271,28008,41929,12761,1587,5783,90068
Florida,Wabasso Beach,1839,217,1259,75,0,253,1804
Florida,Palm Coast,83940,18219,36792,8705,1355,6101,71172
Florida,St. Augustine,14223,5606,4336,1851,110,771,12674
Florida,Upper Grand Lagoon,17045,4506,6899,1455,398,802,14060
Florida,Punta Gorda,19123,2272,11516,2017,157,2245,18207
Florida,Bowling Green,2890,894,908,222,16,57,2097
Florida,McIntosh,376,77,133,72,0,42,324
Florida,Carrollwood,35095,9005,13924,3916,798,1954,29597
Florida,Cabana Colony,2443,475,984,483,33,94,2069
Florida,Brownsdale,384,45,253,27,0,15,340
Florida,Bradley Junction,587,207,198,31,10,50,496
Florida,Black Hammock,1327,172,705,154,0,35,1066
Florida,Berrydale,326,99,112,37,6,17,271
Florida,Bear Creek,1720,474,684,218,0,117,1493
Florida,Bardmoor,9514,2057,4273,835,273,636,8074
Florida,Balm,3745,912,1441,273,125,76,2827
Florida,Avalon,469,133,199,60,0,28,420
Florida,Cedar Grove,3357,790,1204,414,222,185,2815
Florida,Aucilla,175,80,27,52,6,0,165
Florida,Alturas,3673,785,1678,309,75,256,3103
Florida,Allentown,1002,174,472,76,0,91,813
Florida,Alafaya,88542,25585,36292,6610,1427,2184,72098
Florida,Acacia Villas,459,118,123,11,0,0,252
Florida,St. Lucie Village,713,151,339,74,0,27,591
Florida,Manatee Road,2845,570,935,355,37,218,2115
Florida,Lake Butler,18917,3513,9486,510,40,568,14117
Florida,Grant-Valkaria,4099,644,2202,330,20,208,3404
Florida,Fountainebleau,59833,15596,21148,8786,1782,3568,50880
Florida,DeBary,20387,3581,9199,2808,163,1382,17133
Florida,Aripeka,142,29,46,20,24,6,125
Florida,Chumuckla,801,322,267,69,0,91,749
Florida,Clarcona,2615,410,958,344,268,227,2207
Florida,Cobbtown,7,7,0,0,0,0,7
Florida,Heritage Pines,2030,58,1516,57,6,393,2030
Florida,Harold,1162,170,640,87,24,65,986
Florida,Grenelefe,2341,744,782,347,0,183,2056
Florida,Greenbriar,2914,871,1166,419,28,100,2584
Florida,Gardner,298,32,181,30,16,39,298
Florida,Garden Grove,706,127,293,99,23,96,638
Florida,Garcon Point,482,71,307,26,0,0,404
Florida,Fuller Heights,10327,2524,4309,843,141,501,8318
Florida,Fort Green Springs,164,9,118,10,0,0,137
Florida,Fort Green,190,78,102,8,0,0,188
Florida,Fort Denaud,1984,418,1047,319,7,69,1860
Florida,Floridatown,231,58,104,6,0,17,185
Florida,Fleming Island,28531,5457,14466,2129,134,1207,23393
Florida,Flagler Estates,3484,706,1309,409,63,118,2605
Florida,Fidelis,167,15,92,8,0,19,134
Florida,East Milton,13054,4978,3440,2277,276,462,11433
Florida,Dixonville,133,0,114,0,0,19,133
Florida,DeLand Southwest,1004,383,254,105,42,58,842
Florida,DeLand,31289,8538,11465,3564,422,2524,26513
Florida,Day,112,7,70,7,17,0,101
Florida,Dickerson City,123,12,32,9,0,70,123
Florida,Crawfordville,4467,929,2196,323,33,167,3648
Florida,Connerton,4462,1953,1043,670,159,22,3847
Florida,Loxahatchee Groves,3475,1037,1467,340,80,226,3150
Florida,Cutler Bay,44801,11799,15952,5070,1061,1598,35480
Florida,West Park,14924,5629,4194,1182,546,738,12289
Florida,Buenaventura Lakes,34085,10107,11672,3164,999,1371,27313
Florida,Gonzalez,13962,2788,6176,1828,177,853,11822
Florida,Jupiter Island,856,204,434,56,31,81,806
Florida,Jacksonville,878907,247264,303353,98027,18061,40987,707692
Florida,Orange City,11448,1850,4378,2041,190,1102,9561
Florida,Glencoe,1814,495,796,159,40,136,1626
Florida,Flagler Beach,4946,833,2796,437,20,478,4564
Florida,Palmetto,13490,3286,5309,1171,296,1135,11197
Florida,Warm Mineral Springs,5149,617,3252,419,0,748,5036
Florida,Lake Sarasota,4641,1205,2072,387,53,203,3920
Florida,Stock Island,4404,1487,1223,621,158,298,3787
Florida,Anna Maria,869,115,494,31,0,178,818
Florida,Wauchula,4857,1406,1884,163,107,310,3870
Florida,Inverness Highlands North,2954,580,1404,209,25,92,2310
Florida,Hernando,8727,1615,3638,1218,191,997,7659
Florida,Oakland Park,44339,15707,13073,5700,1159,1634,37273
Florida,Miramar,138168,45453,47252,11859,2607,3549,110720
Florida,Lighthouse Point,11109,2170,5721,1160,135,636,9822
Florida,Lauderhill,71328,23981,18762,7858,1548,3693,55842
Florida,Campbell,2095,369,1012,216,29,354,1980
Florida,Mims,6171,1292,2824,641,111,454,5322
Florida,Merritt Island,36797,8253,15756,4507,517,2514,31547
Florida,Bagdad,3474,809,1682,305,8,89,2893
Florida,Belleview,4844,1180,1250,896,158,644,4128
Florida,Micco,8956,1412,4299,1148,178,1516,8553
Florida,Beverly Hills,9381,1866,2880,1488,191,1270,7695
Florida,La Crosse,435,144,145,34,15,33,371
Florida,Cudjoe Key,2030,266,1278,225,33,88,1890
Florida,Sweetwater,21027,5877,6901,2941,799,1329,17847
Florida,Sunny Isles Beach,22171,5258,9125,2919,673,1496,19471
Florida,Palmetto Bay village,24564,5656,11060,1764,225,930,19635
Florida,Ormond-by-the-Sea,7322,1482,3335,1363,64,593,6837
Florida,Miami Gardens,112913,46600,25935,10856,3032,4724,91147
Florida,Marco Island,17692,1793,11609,1455,96,1615,16568
Florida,LaBelle,5075,1320,1734,328,29,401,3812
Florida,Doral,58265,13356,24074,5537,876,1321,45164
Florida,Dania Beach,31810,9954,9843,4353,592,1572,26314
Florida,Crystal Lake,6671,2057,1336,954,212,267,4826
Florida,Southwest Ranches,7880,1993,3820,647,30,321,6811
Florida,Miami Lakes,31050,7991,11490,3371,1121,1409,25382
Florida,Four Corners,38983,10611,15561,3502,1387,1082,32143
Florida,Lee,385,60,159,47,2,15,283
Florida,Avon Park,10386,2543,3409,1212,182,678,8024
Florida,Venice,22601,2972,12631,2626,306,3145,21680
Florida,Bee Ridge,10012,1821,4322,1363,194,1151,8851
Florida,North Key Largo,990,187,574,86,0,102,949
Florida,Marathon,8737,2366,3324,1195,284,524,7693
Florida,Key Colony Beach,569,8,353,154,0,54,569
Florida,West Miami,7373,1897,2521,1178,201,473,6270
Florida,Palmetto Estates,15970,5374,5182,1626,444,723,13349
Florida,Opa-locka,16420,6263,3006,1254,687,597,11807
Florida,Bellview,21269,4679,7649,3324,408,1922,17982
Florida,Wildwood,6557,1154,2142,1029,183,707,5215
Florida,Hilliard,3157,687,1286,294,94,170,2531
Florida,Florida Ridge,21371,5296,7858,2207,302,1910,17573
Florida,Arcadia,7943,2291,2337,984,130,512,6254
Florida,Lake Placid,1932,471,642,200,65,118,1496
Florida,High Springs,5881,1470,2704,529,50,129,4882
Florida,Tamarac,64748,16478,22817,8910,1761,5623,55589
Florida,Sneads,1898,563,460,317,80,143,1563
Florida,Geneva,2759,566,1570,198,0,151,2485
Florida,Winter Springs,35694,8213,16448,3447,473,1661,30242
Florida,Hollywood,151056,42593,51864,19158,4804,8106,126525
Florida,Plantation,92775,24733,35645,10079,1728,4233,76418
Florida,Sea Ranch Lakes village,546,132,270,37,2,33,474
Florida,Marineland,9,8,0,1,0,0,9
Florida,Wilton Manors,12534,5537,3561,1491,349,672,11610
Florida,Inverness,7216,1201,2533,1080,186,1222,6222
Florida,Inverness Highlands South,6288,1423,2742,886,49,488,5588
Florida,Lecanto,6264,1825,2496,568,159,619,5667
Florida,Sugarmill Woods,8851,1002,5186,722,15,945,7870
Florida,Jay,396,78,193,37,7,40,355
Florida,Fort Pierce,44833,14091,12375,5247,1071,2853,35637
Florida,Milton,9771,2345,3509,1178,301,570,7903
Florida,Newberry,5789,1054,2700,260,54,160,4228
Florida,Brent,22056,9668,5398,2512,535,1127,19240
Florida,Sewall's Point,2102,306,1097,233,23,173,1832
Florida,Rotonda,8921,1069,5490,903,88,860,8410
Florida,Samoset,4309,1613,612,999,39,299,3562
Florida,Richmond Heights,11410,3718,3415,1362,343,713,9551
Florida,Princeton,30852,8965,10202,3089,742,672,23670
Florida,Malone,2006,1098,370,227,82,63,1840
Florida,Campbellton,201,79,54,20,4,10,167
Florida,Fern Park,8340,2471,3016,961,301,586,7335
Florida,Molino,1163,231,485,239,25,47,1027
Florida,Haverhill,2249,666,807,229,60,65,1827
Florida,Jupiter,63617,13888,28525,6829,761,3616,53619
Florida,Lake Belvedere Estates,4237,1224,1561,168,34,194,3181
Florida,Clearwater,114015,30012,40930,14361,2664,8426,96393
Florida,Harbor Bluffs,2793,705,1382,353,25,129,2594
Florida,Indian Shores,1292,185,819,98,13,149,1264
Florida,Palm Harbor,61995,13343,28427,6988,678,4972,54408
Florida,Tierra Verde,3557,580,2114,384,60,171,3309
Florida,Miramar Beach,8758,1507,4766,810,132,378,7593
Florida,Paxton,733,114,273,95,8,78,568
Florida,Sky Lake,6119,2137,1990,591,171,422,5311
Florida,Taft,1472,435,395,303,60,78,1271
Florida,New Port Richey East,10161,2651,3619,1489,216,754,8729
Florida,Port Richey,2788,699,1084,426,51,279,2539
Florida,Laguna Beach,4117,616,1988,800,75,184,3663
Florida,Panama City Beach,12683,2645,5913,1538,188,595,10879
Florida,Coral Terrace,25234,6390,9759,3410,721,1736,22016
Florida,Country Walk,17114,3976,7284,1358,263,469,13350
Florida,North Miami,61435,23803,16808,4875,1763,2342,49591
Florida,Starke,5375,1416,1727,678,137,585,4543
Florida,Stuart,16100,4054,5408,2611,386,1241,13700
Florida,Lynn Haven,20768,4300,8684,1860,416,1099,16359
Florida,Hampton,534,77,172,91,23,79,442
Florida,Franklin Park,1031,320,162,90,37,38,647
Florida,Hillsboro Pines,533,199,198,55,0,8,460
Florida,South Patrick Shores,6802,1640,3325,610,56,366,5997
Florida,Astatula,1637,385,705,129,34,51,1304
Florida,Clermont,33520,6773,15707,3181,258,1946,27865
Florida,Lady Lake,15118,2001,7441,1856,267,2059,13624
Florida,Cooper City,35376,8494,15628,2690,340,1177,28329
Florida,Coral Springs,131151,34371,50562,12134,2833,4015,103915
Florida,East Williston,615,192,182,116,0,40,530
Florida,South Brooksville,3944,743,1752,632,95,355,3577
Florida,Weeki Wachee,2,0,2,0,0,0,2
Florida,Crescent City,1514,373,494,227,24,171,1289
Florida,Williston,2683,829,694,350,45,150,2068
Florida,Belleair Beach,1545,241,876,128,34,125,1404
Florida,North Redington Beach,1359,178,793,210,16,106,1303
Florida,Ridgecrest,3401,868,560,484,135,209,2256
Florida,Lake Panasoffkee,3306,505,1402,488,56,422,2873
Florida,Margate,57427,14808,21032,7619,1598,4109,49166
Florida,Fellsmere,5629,1665,1656,347,187,88,3943
Florida,Indian River Shores,4142,184,2832,123,0,831,3970
Florida,Sebastian,24536,4888,11512,2600,224,2222,21446
Florida,Wabasso,585,79,356,22,0,40,497
Florida,West Vero Corridor,8661,1301,3800,1396,89,1591,8177
Florida,Davie,103132,30854,37173,11839,1446,4075,85387
Florida,Lake Lorraine,7095,1435,2867,971,139,530,5942
Florida,Broadview Park,8068,2178,2498,595,365,160,5796
Florida,Cocoa West,6152,1569,1759,1090,99,194,4711
Florida,Altha,598,82,242,63,18,46,451
Florida,Holmes Beach,4198,559,2414,609,18,358,3958
Florida,Butler Beach,4904,878,2805,545,53,337,4618
Florida,Crescent Beach,982,198,501,101,22,90,912
Florida,Sawgrass,4894,876,2485,693,0,435,4489
Florida,Aventura,37780,7607,16532,5679,503,2855,33176
Florida,Brownsville,17155,6632,3312,1610,725,714,12993
Florida,Florida City,12096,4096,2509,896,424,364,8289
Florida,Hialeah Gardens,23959,6777,9087,2615,641,1471,20591
Florida,Ives Estates,22682,7430,7825,2170,565,848,18838
Florida,Kendall,74631,19542,30003,8078,1524,4211,63358
Florida,Miami Beach,91826,28053,31895,13449,3096,3791,80284
Florida,Pinecrest village,19446,4489,9029,1065,239,681,15503
Florida,Pinewood,17027,6545,4156,1883,436,731,13751
Florida,The Crossings,23558,6407,9714,2272,510,962,19865
Florida,Bushnell,3047,651,1328,303,76,294,2652
Florida,South Beach,3538,331,2525,169,0,348,3373
Florida,Vero Beach,16558,3979,6699,2374,294,1339,14685
Florida,Fernandina Beach,12062,2527,5586,1322,94,1266,10795
Florida,Dunnellon,2188,406,814,421,35,184,1860
Florida,Ocala,58598,17775,17161,7461,1043,4166,47606
Florida,Reddick,590,161,125,121,14,41,462
Florida,Cocoa Beach,11539,2311,5381,1639,210,991,10532
Florida,June Park,4281,1183,1746,380,79,478,3866
Florida,Lake Mary,16360,3152,8298,1360,40,938,13788
Florida,Longwood,14591,3956,5836,1733,108,998,12631
Florida,North Lauderdale,43829,14053,12969,3927,1603,1494,34046
Florida,Williamsburg,7967,2083,3101,729,178,767,6858
Florida,Perry,6925,1665,2216,551,201,646,5279
Florida,Miami Springs,14375,3417,6107,1844,208,691,12267
Florida,Madison,2825,1139,646,350,34,162,2331
Florida,Leesburg,22243,5530,7280,2184,387,1735,17116
Florida,Melbourne Village,852,189,422,106,6,53,776
Florida,Fisher Island,106,0,80,26,0,0,106
Florida,Laurel,9477,1704,4416,1382,190,889,8581
Florida,Palm Springs North,5515,1387,2301,550,189,333,4760
Florida,South Daytona,12734,3732,4024,1993,237,1095,11081
Florida,South Palm Beach,1347,206,697,234,19,145,1301
Florida,Pine Lakes,537,95,288,43,18,57,501
Florida,Lazy Lake village,22,20,1,1,0,0,22
Florida,Yulee,12616,2621,5690,1095,185,504,10095
Florida,Ruskin,23477,5847,8403,2356,578,857,18041
Florida,Tarpon Springs,24974,5725,9796,3703,551,1936,21711
Florida,Chiefland,2514,737,694,333,92,117,1973
Florida,Greenacres,40224,11884,13247,4133,961,2318,32543
Florida,St. James City,3437,292,2103,434,10,456,3295
Florida,Wedgefield,7701,1828,3404,488,157,257,6134
Florida,Redington Beach,1397,181,766,211,6,127,1291
Florida,Okeechobee,5638,1332,2082,543,204,308,4469
Florida,Bayport,63,17,0,31,0,0,48
Florida,Mulberry,4047,832,1824,343,67,368,3434
Florida,Cottondale,794,190,294,79,24,45,632
Florida,Tallahassee,190180,91076,48731,15551,2014,5659,163031
Florida,Ocoee,44829,10687,18056,3624,646,1686,34699
Florida,Westville,300,57,99,61,8,12,237
Florida,Noma,218,48,72,36,6,19,181
Florida,Bonifay,2693,622,882,322,60,244,2130
Florida,Fort Meade,6013,1469,2453,376,136,357,4791
Florida,Bartow,19063,5045,6763,1834,401,1111,15154
Florida,Harlem,2442,772,415,340,127,175,1829
Florida,Kissimmee,69833,21891,23268,6231,1942,2373,55705
Florida,Lake Mack-Forest Hills,802,216,329,166,0,32,743
Florida,Howey-in-the-Hills,1462,210,717,165,17,121,1230
Florida,Celebration,9329,2073,4436,805,0,259,7573
Florida,Altoona,100,8,61,7,0,6,82
Florida,Melbourne Beach,3224,542,1728,186,46,247,2749
Florida,Melbourne,80664,22954,26451,12148,1566,5897,69016
Florida,Cocoa,18053,4926,5908,2098,433,946,14311
Florida,West Melbourne,21471,4453,8275,2422,177,1586,16913
Florida,North Miami Beach,45069,15951,13854,4228,1194,2122,37349
Florida,Leisure City,26080,8666,7591,2497,747,942,20443
Florida,Golden Beach,613,122,316,27,8,23,496
Florida,Hastings,892,378,218,116,4,75,791
Florida,West Samoset,7708,2346,2111,564,224,374,5619
Florida,Manasota Key,1141,37,832,151,0,104,1124
Florida,Umatilla,3693,768,1484,302,27,455,3036
Florida,Cape Canaveral,10274,2214,4181,1962,309,851,9517
Florida,Belleair Bluffs,2273,468,1017,361,46,177,2069
Florida,Century,1632,387,494,265,46,228,1420
Florida,Valparaiso,5035,1711,1630,434,103,244,4122
Florida,Roosevelt Gardens,2585,1086,455,302,132,111,2086
Florida,Bay Pines,3202,549,1513,483,51,258,2854
Florida,Treasure Island,6875,988,3680,1003,33,606,6310
Florida,Glenvar Heights,17802,5624,6529,1937,363,1134,15587
Florida,Bay Harbor Islands,5938,1122,2136,928,47,230,4463
Florida,Freeport,2803,368,1307,367,28,176,2246
Florida,Key West,25085,6762,9954,3540,298,1082,21636
Florida,Key Largo,9954,1632,4725,1601,152,469,8579
Florida,Bayshore Gardens,20293,5137,6508,3016,358,1641,16660
Florida,Coleman,541,107,226,46,7,56,442
Florida,Center Hill,890,329,236,87,21,87,760
Florida,Callahan,1414,234,464,210,40,123,1071
Florida,Orchid,438,10,346,49,2,29,436
Florida,Shalimar,892,138,436,110,16,40,740
Florida,Goulding,4297,2058,488,560,145,317,3568
Florida,Ferry Pass,34416,11754,10339,3325,617,1723,27758
Florida,Ensley,22844,5982,7439,3470,498,1561,18950
Florida,Crestview,23663,4987,9017,2491,473,890,17858
Florida,Heathrow,6364,1070,3411,615,0,204,5300
Florida,Ocean City,5949,1780,2009,656,143,367,4955
Florida,Niceville,15050,2915,7215,1045,191,518,11884
Florida,Greenwood,702,194,226,55,1,30,506
Florida,Bunnell,2675,726,788,345,30,312,2201
Florida,Alachua,9794,1966,4196,839,107,272,7380
Florida,Belle Glade,19358,6583,4657,1514,803,972,14529
Florida,Deerfield Beach,79854,23158,26004,10442,2038,5701,67343
Florida,Delray Beach,67353,20949,22825,8599,1461,5110,58944
Florida,Lantana,11405,3951,3682,1162,188,701,9684
Florida,Eagle Lake,2517,510,835,372,60,207,1984
Florida,West Bradenton,4324,1240,1843,384,0,294,3761
Florida,St. Marks,224,34,107,31,3,13,188
Florida,Miami Shores village,10676,3230,4172,679,113,302,8496
Florida,Key Biscayne village,13054,2540,5921,882,68,584,9995
Florida,Kendall West,39491,11332,14610,4144,1631,2021,33738
Florida,Country Club,49684,14154,16464,5671,1886,1597,39772
Florida,Coral Gables,50931,15711,20745,3871,453,2156,42936
Florida,Biscayne Park village,3175,773,1029,314,119,137,2372
Florida,Safety Harbor,17663,3557,7597,2378,129,1178,14839
Florida,Redington Shores,2262,457,1067,349,30,229,2132
Florida,Dunedin,36244,7386,15054,5568,654,3649,32311
Florida,Zephyrhills South,5163,620,2210,775,52,712,4369
Florida,Zephyrhills,14851,2784,6315,1926,272,1462,12759
Florida,Feather Sound,3646,1027,1472,501,33,172,3205
Florida,Hudson,12528,2392,5229,1754,151,1625,11151
Florida,Elfers,12637,3297,4537,1301,233,1226,10594
Florida,Whiskey Creek,5030,976,2333,619,53,389,4370
Florida,Bokeelia,1420,109,898,207,31,133,1378
Florida,Pomona Park,1046,323,327,117,21,58,846
Florida,Timber Pines,5303,317,3435,443,21,1044,5260
Florida,North Brooksville,3161,340,1291,500,88,376,2595
Florida,Brooksville,8027,1773,2744,1121,181,812,6631
Florida,Lake Harbor,24,6,12,0,0,0,18
Florida,Hallandale Beach,39472,10538,13526,5179,1426,3046,33715
Florida,Ocean Ridge,1648,249,843,278,8,146,1524
Florida,Ormond Beach,41907,9138,18015,4676,391,3984,36204
Florida,Eustis,20264,4834,8080,1905,437,1350,16606
Florida,Canal Point,483,164,285,5,0,0,454
Florida,Minneola,11058,2908,4371,750,134,401,8564
Florida,Lauderdale-by-the-Sea,6594,1273,3235,949,110,750,6317
Florida,Hillsboro Beach,1631,184,929,185,38,226,1562
Florida,Coconut Creek,59997,14346,22709,7100,1321,3810,49286
Florida,Oviedo,39599,10203,17449,2392,428,1095,31567
Florida,Chuluota,2582,639,1210,156,0,108,2113
Florida,Altamonte Springs,43426,13492,14049,5908,881,2255,36585
Florida,Fort Walton Beach,21845,5378,8088,2986,372,1515,18339
Florida,Rio,831,191,416,63,0,97,767
Florida,Boulevard Gardens,1567,638,275,126,85,155,1279
Florida,Marianna,7266,2143,1944,874,318,581,5860
Florida,Alford,662,122,222,117,28,53,542
Florida,Orange Park,8680,1994,3435,1195,327,450,7401
Florida,Casselberry,27573,8223,9591,3402,599,1490,23305
Florida,Hawthorne,1670,427,385,277,33,109,1231
Florida,Fort Lauderdale,178783,60139,55297,23552,3798,9251,152037
Florida,Roseland,1269,142,700,196,0,210,1248
Florida,Gifford,9679,2442,3115,797,166,1348,7868
Florida,Ponce de Leon,497,127,144,60,18,52,401
Florida,Woodville,2461,653,1097,272,61,70,2153
Florida,Oak Ridge,23712,8706,6400,2448,595,709,18858
Florida,Orlovista,6574,2301,1757,719,412,191,5380
Florida,Pine Hills,75575,26200,19655,7017,2057,2758,57687
Florida,Azalea Park,14817,5127,4029,2060,285,741,12242
Florida,Windermere,3346,733,1814,241,4,89,2881
Florida,Apopka,50529,12439,20566,4487,685,2114,40291
Florida,Havana,1526,296,643,222,34,188,1383
Florida,Chattahoochee,3103,1473,620,380,53,122,2648
Florida,Waldo,840,322,166,119,12,60,679
Florida,South Pasadena,5071,1035,1510,1122,81,1172,4920
Florida,Fussels Corner,4026,587,2125,500,0,477,3689
Florida,Waverly,922,397,115,53,54,85,704
Florida,Lely Resort,6340,1332,3109,603,26,506,5576
Florida,Immokalee,26773,9735,6597,1828,763,590,19513
Florida,Mexico Beach,1544,202,954,139,6,139,1440
Florida,Istachatta,194,30,70,36,0,29,165
Florida,Callaway,15182,3685,5822,1416,518,918,12359
Florida,Zephyrhills North,2599,463,1101,488,40,230,2322
Florida,Trinity,10646,1790,5934,729,71,503,9027
Florida,Jasmine Estates,21772,5951,7333,2606,555,1430,17875
Florida,Three Oaks,4314,830,2087,278,48,60,3303
Florida,San Carlos Park,17778,5340,6521,1828,340,827,14856
Florida,Pine Manor,5248,1649,689,323,142,101,2904
Florida,Matlacha,620,133,313,76,38,60,620
Florida,Harlem Heights,1930,737,575,86,27,129,1554
Florida,Fort Myers Beach,6966,927,3967,1215,67,642,6818
Florida,Lake Wales,15735,3501,5600,1538,435,1109,12183
Florida,Southchase,15096,3647,6742,1234,262,339,12224
Florida,Belle Isle,6865,1476,3660,445,44,226,5851
Florida,St. Pete Beach,9572,1674,5063,1404,48,793,8982
Florida,Jupiter Farms,12032,2115,6314,876,41,601,9947
Florida,Island Walk,3356,347,2016,401,0,350,3114
Florida,Hosford,804,165,370,122,11,61,729
Florida,Horizon West,32530,6594,14536,1878,191,483,23682
Florida,Homeland,289,70,86,9,0,6,171
Florida,Holley,1523,188,791,154,0,76,1209
Florida,High Point,3704,454,1818,492,60,568,3392
Florida,Cypress Quarters,1455,537,395,136,13,75,1156
Florida,Egypt Lake-Leto,37039,11730,11714,4380,1352,1360,30536
Florida,Cheval,10603,2268,4423,1316,194,274,8475
Florida,Vernon,685,180,204,98,18,60,560
Florida,Chipley,3511,1101,862,472,123,200,2758
Florida,Paradise Heights,539,127,226,60,46,0,459
Florida,Masaryktown,951,128,381,132,11,35,687
Florida,St. Petersburg,259041,82211,85342,33153,4781,15709,221196
Florida,Kenneth City,5017,1450,1670,673,67,446,4306
Florida,Golf village,214,25,149,14,0,24,212
Florida,Cloud Lake,206,63,65,44,7,5,184
Florida,Moore Haven,2551,1042,643,305,15,178,2183
Florida,Sanford,58862,17369,18529,5882,1595,2830,46205
Florida,Wright,22991,6086,8378,3069,408,1329,19270
Florida,Eglin AFB,2083,425,867,67,5,7,1371
Florida,Grand Ridge,770,171,222,124,3,50,570
Florida,Bascom,56,7,33,7,0,8,55
Florida,Warrington,14487,4032,3876,2414,423,982,11727
Florida,Jacob City,228,81,76,37,4,12,210
Florida,Indian Harbour Beach,8401,1749,3733,1145,107,671,7405
Florida,The Villages,77609,2867,58277,6142,524,9463,77273
Florida,Nassau Village-Ratliff,4769,852,2269,492,69,224,3906
Florida,Glen St. Mary,618,114,195,63,14,27,413
Florida,Worthington Springs,435,112,141,42,1,28,324
Florida,Silver Springs Shores,8966,2403,2711,1124,169,776,7183
Florida,Briny Breezes,876,73,549,95,5,138,860
Florida,Boynton Beach,75720,22334,26849,8271,1443,5089,63986
Florida,Westchase,23636,4806,10771,1959,150,852,18538
Florida,Riverview,91190,20830,37267,7906,1690,2953,70646
Florida,Plant City,38119,9157,14577,3837,571,1482,29624
Florida,Palm River-Clair Mel,23627,7163,6712,2896,533,1264,18568
Florida,Lutz,21456,4099,10555,1788,227,779,17448
Florida,Keystone,24632,4237,13126,1450,172,673,19658
Florida,East Lake-Orient Park,28602,8682,8519,2592,763,813,21369
Florida,Caryville,177,46,65,20,5,16,152
Florida,Loughman,4984,2040,1483,627,32,111,4293
Florida,Kathleen,6546,1714,2350,672,130,283,5149
Florida,Jan Phyl Village,6467,2148,2199,513,101,268,5229
Florida,Wahneta,5484,1649,1598,284,76,264,3871
Florida,Wekiwa Springs,23329,5442,10695,1826,103,1237,19303
Florida,Oldsmar,14444,3717,5758,1504,173,778,11930
Florida,Green Cove Springs,7639,1744,2803,1014,54,507,6122
Florida,Highland Park village,197,28,90,28,1,10,157
Florida,Gulfport,12280,3117,4795,2307,236,910,11365
Florida,Cedar Key,773,187,372,119,0,31,709
Florida,Jennings,831,111,263,29,32,42,477
Florida,Lake Worth,37728,13037,10571,4565,969,1594,30736
Florida,Shady Hills,12435,2671,5100,1658,235,841,10505
Florida,Macclenny,6482,1790,2089,699,34,445,5057
Florida,Pine Ridge CDP (Citrus County),10279,1408,6143,570,87,1024,9232
Florida,Bronson,913,210,274,131,30,64,709
Florida,Sebring,10636,2831,3865,1192,277,991,9156
Florida,Southeast Arcadia,7813,2355,2612,574,199,293,6033
Florida,Cortez,4436,683,2219,847,42,490,4281
Florida,Bradenton Beach,929,173,464,153,10,63,863
Florida,Sopchoppy,407,137,118,79,4,32,370
Florida,Weeki Wachee Gardens,1539,266,557,376,23,235,1457
Florida,Penney Farms,678,107,340,55,14,147,663
Florida,Westchester,30210,7920,11997,3717,314,2123,26071
Florida,Surfside,5817,833,2335,831,130,479,4608
Florida,Miami,451214,156737,135138,53360,14261,25326,384822
Florida,Kendale Lakes,58395,14545,23143,7030,1830,3438,49986
Florida,Homestead Base,929,308,67,67,23,0,465
Florida,Homestead,68424,19507,19157,6551,2044,2353,49612
Florida,Hialeah,237285,67601,84749,25524,9257,16286,203417
Florida,Golden Glades,34836,14161,8710,2803,1181,1266,28121
Florida,Villano Beach,2890,516,1664,285,81,134,2680
Florida,St. Augustine Shores,9418,2010,3987,1360,84,914,8355
Florida,South Bradenton,25646,6962,7645,4275,676,1904,21462
Florida,Memphis,8788,2777,2735,1144,55,532,7243
Florida,St. Augustine Beach,6883,1579,3293,607,46,357,5882
Florida,Medulla,9679,2523,3913,836,159,262,7693
Florida,Lake Alfred,5565,1498,2009,453,229,159,4348
Florida,Virginia Gardens village,2504,741,836,362,69,80,2088
Florida,North Weeki Wachee,7853,1378,3970,1067,105,596,7116
Florida,East Lake,32315,5710,16563,2925,355,2297,27850
Florida,Indian Rocks Beach,4223,891,2061,643,20,305,3920
Florida,White Springs,755,165,318,81,35,22,621
Florida,Jasper,4104,2105,810,525,148,167,3755
Florida,Lake Park,8505,2785,2779,797,267,296,6924
Florida,Lake Clarke Shores,3584,659,1485,452,188,311,3095
Florida,Highland Beach,3858,405,2295,371,27,576,3674
Florida,Gun Club Estates,1105,137,361,105,132,146,881
Florida,Wewahitchka,2342,689,733,427,74,136,2059
Florida,Port St. Joe,3465,734,1409,450,36,282,2911
Florida,Taylor Creek,4189,754,1664,673,120,518,3729
Florida,Seffner,8786,1957,3414,916,206,294,6787
Florida,Hillcrest Heights,237,48,108,14,4,19,193
Florida,Cypress Gardens,10358,2261,4665,1022,207,793,8948
Florida,Yankeetown,585,89,267,84,14,41,495
Florida,South Apopka,6081,2237,1329,463,173,309,4511
Florida,Andrews,720,128,382,51,0,85,646
Florida,Pine Castle,11643,3892,3609,922,425,273,9121
Florida,Lockhart,14775,5554,3904,1648,325,335,11766
Florida,Fairview Shores,11254,3409,3389,1231,440,793,9262
Florida,Midway,3301,976,1083,358,21,56,2494
Florida,Progress Village,10136,2883,2984,890,174,485,7416
Florida,Mango,11228,3013,3097,1490,345,557,8502
Florida,Lake Magdalene,29794,7212,12289,3178,859,1578,25116
Florida,Gibsonton,17873,4600,5580,2005,437,699,13321
Florida,Fish Hawk,20054,3201,9090,1129,145,388,13953
Florida,Dover,3001,796,1040,125,148,124,2233
Florida,Bloomingdale,23758,5420,11068,1692,294,807,19281
Florida,Polk City,2203,460,916,205,59,208,1848
Florida,Lakeland,105958,30473,37182,11407,1879,7498,88439
Florida,Inwood,7651,2121,2237,895,229,435,5917
Florida,Frostproof,3176,620,1187,304,209,385,2705
Florida,Orlando,275690,97619,81715,30684,7276,9576,226870
Florida,Captiva,178,38,88,32,0,20,178
Florida,East Bronson,1878,337,663,322,0,217,1539
Florida,Quincy,7512,2626,1930,731,183,534,6004
Florida,Plantation Mobile Home Park,1522,303,557,243,10,125,1238
Florida,Vamo,4862,1138,1732,1064,67,561,4562
Florida,Pebble Creek,8284,1647,3761,751,90,224,6473
Florida,Live Oak,6888,1619,2188,1315,333,460,5915
Florida,Monticello,2256,506,891,204,34,200,1835
Florida,Winter Haven,39615,9954,14339,4175,908,3384,32760
Florida,Highland City,10641,2389,4750,789,81,385,8394
Florida,Dundee,4313,1035,1196,389,201,300,3121
Florida,Grove City,1909,322,781,285,7,291,1686
Florida,Ridge Manor,4606,927,1921,602,47,436,3933
Florida,Hernando Beach,2640,453,1634,260,0,158,2505
Florida,Orangetree,4271,516,2387,282,0,57,3242
Florida,Naples Manor,6735,1886,2387,238,127,315,4953
Florida,Goodland,437,67,279,0,0,0,346
Florida,Gretna,1174,358,334,79,51,117,939
Florida,Lacoochee,1628,440,540,37,61,95,1173
Florida,Olga,2324,586,1023,159,15,136,1919
Florida,Iona,14385,2041,7476,2218,143,1853,13731
Florida,Beacon Square,6873,1476,2524,853,192,576,5621
Florida,Thonotosassa,13966,2984,5122,2046,276,754,11182
Florida,Tampa,376345,126486,116243,40797,8354,15836,307716
Florida,Yalaha,1200,225,767,26,0,110,1128
Florida,Tavares,16199,3218,6544,2471,256,1427,13916
Florida,Mount Dora,13620,2753,5941,1920,124,1184,11922
Florida,Ferndale,622,100,327,0,0,82,509
Florida,Trenton,2211,552,650,258,68,114,1642
Florida,Pittman,246,55,61,49,5,8,178
Florida,Bell,634,238,196,72,4,23,533
Florida,Palm Shores,1181,212,561,136,14,54,977
Florida,Fruitland Park,6598,1348,2775,736,63,446,5368
Florida,Suncoast Estates,4314,1158,1297,617,118,348,3538
Florida,Pahokee,6167,2130,1854,371,199,333,4887
Florida,Limestone Creek,1123,406,359,42,0,121,928
Florida,Boca Raton,95745,25415,41013,9962,903,6195,83488
Florida,Charleston Park,229,102,14,45,40,28,229
Florida,Spring Hill,107855,24366,44451,11401,1814,7633,89665
Florida,Pine Island,13,0,0,13,0,0,13
Florida,Lake Lindsey,17,6,0,0,0,11,17
Florida,Brookridge,4549,717,2163,779,42,615,4316
Florida,Vineyards,3929,529,2568,338,0,293,3728
Florida,South Highpoint,5335,1761,1385,603,155,226,4130
Florida,Belleair Shore,87,14,53,6,0,8,81
Florida,Belleair,4097,778,2048,399,23,401,3649
Florida,Meadow Woods,36190,10624,13632,3063,651,1029,28999
Florida,Maitland,17622,5256,6826,1646,214,854,14796
Florida,Fanning Springs,1045,235,431,138,10,115,929
Florida,Zellwood,3079,468,1735,437,13,228,2881
Florida,Lake Hart,430,118,114,131,0,41,404
Florida,Cypress Lake,13120,2687,5030,2279,30,2029,12055
Florida,Hunters Creek,22770,5317,9968,1891,290,571,18037
Florida,Williston Highlands,1842,340,872,222,96,149,1679
Florida,St. Leo,1164,1136,20,6,0,0,1162
Florida,Odessa,8517,1927,3571,815,89,386,6788
Florida,Land O' Lakes,37007,8358,16905,3295,449,1605,30612
Florida,North Fort Myers,41690,6856,19313,5811,825,5255,38060
Florida,Matlacha Isles-Matlacha Shores,316,44,129,31,0,40,244
Florida,Alva,2724,420,1542,213,32,225,2432
Florida,Lawtey,862,305,276,96,30,29,736
Florida,Lake Buena Vista,4,0,3,1,0,0,4
Florida,Holden Heights,3494,1111,1290,425,71,188,3085
Florida,Mayo,988,390,182,76,46,128,822
Florida,Greensboro,726,134,244,64,19,30,491
Florida,Seminole,18542,3431,8166,2583,169,2231,16580
Florida,Madeira Beach,4284,813,2176,685,53,318,4045
Florida,Bay Lake,71,36,14,2,0,0,52
Florida,Fort Myers Shores,7010,2342,2503,889,76,218,6028
Florida,McGregor,8032,1801,3788,805,15,671,7080
Florida,Page Park,387,106,52,127,26,9,320
Florida,Tangerine,2403,617,1018,246,54,132,2067
Florida,Tangelo Park,2755,965,794,267,68,187,2281
Florida,Gotha,2313,560,1013,73,0,31,1677
Florida,Edgewood,2833,762,1181,301,18,139,2401
Florida,Doctor Phillips,11347,2505,5636,830,113,593,9677
Florida,Christmas,1921,274,1105,247,0,125,1751
Florida,Bithlo,9457,2869,3323,774,201,237,7404
Florida,Wimauma,7621,2081,2408,254,62,191,4996
Florida,Town 'n' Country,85620,25174,31215,8862,1449,4177,70877
Florida,Temple Terrace,26062,9926,8231,2411,355,816,21739
Florida,Citrus Park,26473,6847,10927,2509,444,1108,21835
Florida,Apollo Beach,19457,3268,10247,1438,187,858,15998
Florida,Wausau,422,67,197,25,22,23,334
Florida,Otter Creek,53,8,22,8,0,4,42
Florida,Inglis,1437,276,614,249,42,151,1332
Florida,Horseshoe Beach,95,4,66,8,0,10,88
Florida,Cross City,2123,515,614,269,34,115,1547
Florida,Palmona Park,1234,551,198,155,0,52,956
Florida,Pineland,309,0,252,11,0,46,309
Florida,Sanibel,7224,830,4793,419,98,591,6731
Florida,Bayonet Point,26740,6074,9300,3797,716,2446,22333
Florida,Holiday,21481,5471,8093,2666,314,1434,17978
Florida,New Port Richey,15953,4159,5558,2310,367,1734,14128
Florida,Wellington village,63681,14312,28975,4595,754,2578,51214
Florida,Fort Myers,76591,21799,25925,9420,1459,4479,63082
Florida,Indian Creek village,35,10,21,2,0,0,33
Florida,The Hammocks,60473,16799,23556,5771,1373,2754,50253
Florida,Desoto Lakes,3353,1126,1348,391,31,104,3000
Florida,Ridge Wood Heights,4140,1048,1381,834,106,252,3621
Florida,Siesta Key,5667,656,3303,663,124,592,5338
Florida,Palm Beach,8667,616,5285,1210,61,1066,8238
Florida,El Portal village,2143,666,802,273,11,94,1846
Florida,Port Orange,61601,14754,25924,7255,566,4536,53035
Florida,Three Lakes,16043,4708,5958,1533,119,418,12736
Florida,Sumatra,266,7,140,45,4,0,196
Florida,Mulat,261,106,25,45,19,14,209
Florida,Mount Carmel,203,28,141,0,0,10,179
Florida,Morriston,101,0,78,0,0,0,78
Florida,Moon Lake,4341,1318,1144,647,175,227,3511
Florida,Montura,3821,832,1422,522,84,265,3125
Florida,Midway CDP (Seminole County),1597,558,330,145,53,191,1277
Florida,Midway CDP (Santa Rosa County),17704,3394,7874,1974,196,932,14370
Florida,Meadow Oaks,2513,762,848,321,65,253,2249
Florida,Lloyd,141,16,61,30,14,10,131
Florida,Limestone,187,41,85,19,18,9,172
Florida,Lemon Grove,615,160,246,39,22,37,504
Florida,Lealman,21281,6776,5549,3594,622,1223,17764
Florida,Lamont,87,27,60,0,0,0,87
Florida,Lake Mystic,461,129,134,109,0,8,380
Florida,Lake Mary Jane,2063,328,1306,26,0,143,1803
Florida,Key Vista,1617,241,973,145,10,72,1441
Florida,Kenwood Estates,1340,557,342,49,65,5,1018
Florida,Pierson,1423,274,647,103,7,109,1140
Florida,Holly Hill,12042,3272,3549,1959,277,794,9851
Florida,Royal Palm Estates,3485,1099,1060,272,84,64,2579
Florida,Riviera Beach,34352,11780,9900,3306,705,1764,27455
Florida,Carrabelle,2650,1000,594,412,51,126,2183
Florida,Apalachicola,2477,617,954,286,34,241,2132
Florida,Munson,171,0,100,0,0,38,138
Florida,Lakewood Park,12635,2940,4950,2029,183,887,10989
Florida,Navarre,35540,6641,17381,2618,312,1193,28145
Florida,Nocatee,13266,2011,7373,370,63,211,10028
Florida,Springhill,93,41,46,6,0,0,93
Florida,Seville,612,71,353,36,0,26,486
Florida,San Castle,3917,1333,1334,321,84,157,3229
Florida,Roeville,638,82,397,39,18,0,536
Florida,River Ridge,5191,1133,2132,763,16,566,4610
Florida,River Park,6818,1847,2472,677,183,419,5598
Florida,Rio Pinar,5354,1062,2874,327,66,298,4627
Florida,Raleigh,482,79,122,130,4,16,351
Florida,Quail Ridge,2031,582,840,212,21,66,1721
Florida,Port LaBelle,5000,957,2081,380,69,118,3605
Florida,Point Baker,3460,836,1347,381,105,151,2820
Florida,Pioneer,582,181,171,43,67,25,487
Florida,Pine Level,136,0,63,31,0,10,104
Florida,Pine Air,2691,999,872,253,49,103,2276
Florida,Pea Ridge,4540,1060,2098,345,28,76,3607
Florida,Patrick AFB,1506,326,689,81,5,30,1131
Florida,Pasadena Hills,10216,1973,4533,898,182,574,8160
Florida,Panacea,1001,200,465,119,0,67,851
Florida,Oakleaf Plantation,27252,5055,12936,1375,330,547,20243
Florida,Oakland,2953,678,1305,150,0,83,2216
Florida,North DeLand,1364,323,444,272,54,57,1150
Florida,Oriole Beach,1880,310,815,134,43,116,1418
Florida,Northdale,22529,5614,8916,2792,271,1124,18717
Florida,Navarre Beach,1049,130,602,121,0,95,948
Florida,Palm City,25225,4664,12364,2375,216,2037,21656
Florida,St. Augustine South,5750,1647,2192,919,0,369,5127
Florida,Baldwin,1641,502,482,219,19,74,1296
Florida,Gateway,10513,3102,4447,526,79,552,8706
Florida,Royal Palm Beach village,38344,9009,14925,4169,513,2230,30846
Florida,Palm Springs village,24675,7759,7249,2553,872,1357,19790
Florida,White City,4566,1405,1571,357,19,380,3732
Florida,Fort Pierce South,4389,1047,1846,227,226,197,3543
Florida,Port Salerno,11317,3065,4461,1248,310,834,9918
Florida,Jensen Beach,13477,2975,5952,1628,251,1048,11854
Florida,Hobe Sound,13953,2904,5614,1963,199,1396,12076
Florida,Longboat Key,7233,540,5153,550,19,864,7126
Florida,Big Pine Key,4887,987,2189,678,20,364,4238
Florida,West Perrine,10491,3318,2486,1045,249,451,7549
Florida,Neptune Beach,7080,2146,2946,644,36,363,6135
Florida,New Smyrna Beach,25770,4624,11599,3971,388,2579,23161
Florida,Deltona,89186,21302,35259,10094,1259,4512,72426
Florida,Jacksonville Beach,23203,5785,9540,3192,382,1290,20189
Florida,Atlantic Beach,13398,3502,5453,1652,211,835,11653
Florida,Venice Gardens,8370,1348,4142,1029,93,754,7366
Florida,South Venice,14419,2422,6870,1997,59,1448,12796
Florida,South Sarasota,5316,1081,2405,850,36,320,4692
Florida,Eastpoint,2106,422,1023,178,0,142,1765
Florida,Plantation,5022,403,3286,406,8,793,4896
Florida,Gulf Gate Estates,11017,2135,4226,1821,152,1268,9602
Florida,Englewood,15252,2055,8190,2242,157,1706,14350
Florida,Lehigh Acres,119205,32991,38724,12203,2264,4678,90860
Florida,Lochmoor Waterway Estates,4420,760,2069,620,21,303,3773
Florida,Pine Island Center,2002,271,872,243,57,215,1658
Florida,Tice,5142,1466,1492,608,110,276,3952
Florida,Oak Hill,1775,252,894,297,40,145,1628
Florida,Lake Helen,2746,553,1201,356,21,242,2373
Florida,De Leon Springs,2642,563,1151,215,37,200,2166
Florida,Daytona Beach Shores,4413,601,2282,672,33,639,4227
Florida,Seminole Manor,2889,851,958,417,31,53,2310
Florida,Schall Circle,1446,386,382,120,66,55,1009
Florida,Indian River Estates,6902,1068,3475,885,45,822,6295
Florida,Daytona Beach,66520,23746,17604,9470,1727,4660,57207
Florida,Sarasota Springs,15781,3721,6040,2369,147,1264,13541
Florida,West Little River,33396,12286,8260,3753,1209,1740,27248
Florida,Sunset,15770,3887,6529,1643,251,961,13271
Florida,Spring Ridge,423,74,257,28,0,16,375
Florida,Richmond West,37965,9830,15636,3719,1042,1330,31557
Florida,Parker,4584,1344,1481,628,103,323,3879
Florida,Lower Grand Lagoon,4217,1118,1682,737,31,230,3798
Florida,Palatka,10320,3100,2557,1299,171,801,7928
Florida,Nobleton,138,58,17,26,0,0,101
Florida,Hill 'n Dale,2634,572,907,538,84,79,2180
Florida,Pine Ridge CDP (Collier County),1809,402,836,253,0,82,1573
Florida,Naples Park,6181,1659,2346,942,196,292,5435
Florida,San Antonio,1336,327,567,131,12,62,1099
Florida,Dade City,6966,1970,2010,834,167,526,5507
Florida,Crystal Springs,703,162,284,131,6,45,628
Florida,Everglades,191,24,126,14,1,11,176
Florida,Tyndall AFB,3374,683,1406,64,13,24,2190
Florida,Steinhatchee,737,43,551,39,0,84,717
Florida,South Miami Heights,37861,11408,12394,3689,1773,1941,31205
Florida,Sun City Center,23480,1623,13637,2614,288,4462,22624
Florida,Sunrise,93199,26236,33071,10460,1484,5256,76507
Florida,Winter Garden,42263,9142,19192,3428,261,1795,33818
Florida,Union Park,13254,4554,4328,1220,171,401,10674
Florida,Babson Park,1167,474,424,14,0,78,990
Florida,Asbury Lake,9510,2099,4795,265,195,306,7660
Florida,Yeehaw Junction,320,60,103,119,0,17,299
Florida,St. Cloud,49108,11840,17744,5339,950,2196,38069
Florida,Silver Lake,1719,281,946,123,16,109,1475
Florida,Bay Hill,5066,1177,2870,190,29,245,4511
Florida,Bellair-Meadowbrook Terrace,15117,4037,5406,1449,469,696,12057
Florida,Goldenrod,13162,4714,4312,1489,241,531,11287
Florida,Forest City,14357,3729,5657,1496,251,825,11958
Florida,Mary Esther,4251,1140,1733,419,93,169,3554
Florida,Destin,13469,3314,5857,1471,237,497,11376
Florida,Cinco Bayou,446,168,169,58,5,17,417
Florida,Beverly Beach,481,23,313,85,8,39,468
Florida,West Pensacola,21243,6516,5134,3073,502,2016,17241
Florida,Pensacola,52562,15235,16364,6517,917,2786,41819
Florida,Myrtle Grove,16886,5385,5058,1920,400,1138,13901
Florida,Micanopy,553,209,187,68,0,36,500
Florida,Archer,1336,395,304,175,6,49,929
Florida,Ponce Inlet,3192,469,1853,359,50,301,3032
Florida,Burnt Store Marina,1972,69,1569,157,0,160,1955
Florida,Parkland,30471,5413,15270,1654,125,639,23101
Florida,Pembroke Park,6625,1882,1832,840,149,198,4901
Florida,Black Diamond,753,33,497,73,0,116,719
Florida,Sorrento,343,108,82,0,153,0,343
Florida,Palm Beach Gardens,54528,11435,25124,7099,657,3547,47862
Florida,Port St. Lucie,183762,41335,78265,18056,3199,9970,150825
Florida,Hutchinson Island South,5214,607,3212,471,34,882,5206
Florida,North River Shores,3663,692,1539,431,7,356,3025
Florida,Southgate,7338,1613,2661,1243,76,563,6156
Florida,Eatonville,2341,1132,372,273,56,123,1956
Florida,Conway,13548,3104,6344,1349,104,753,11654
Florida,North Palm Beach village,12899,2635,6027,1641,177,1079,11559
Florida,Jupiter Inlet Colony,440,75,228,36,2,41,382
Florida,Juno Ridge,809,240,235,117,26,32,650
Florida,Juno Beach,3533,411,1838,647,94,442,3432
Florida,Five Points,1303,427,325,244,24,65,1085
Florida,Hypoluxo,2742,547,1325,406,41,174,2493
Florida,Buckhead Ridge,1851,297,952,227,47,235,1758
Florida,Indialantic,2861,577,1324,360,63,139,2463
Florida,Floral City,5308,1040,2152,801,107,581,4681
Florida,Citrus Hills,7492,611,5417,326,14,684,7052
Florida,Glen Ridge,244,78,91,46,4,9,228
Florida,Charlotte Park,2174,343,1287,240,16,246,2132
Florida,Lauderdale Lakes,35254,11973,10969,3150,956,1508,28556
Florida,Willow Oak,6930,2204,1754,768,140,151,5017
Florida,Lakeland Highlands,12376,2415,6251,827,155,511,10159
Florida,Crooked Lake Park,1912,312,745,197,23,97,1374
Florida,Middleburg,13431,2928,5663,1744,213,449,10997
Florida,Atlantis,2079,398,1043,179,25,246,1891
Florida,Layton,132,19,76,20,0,13,128
Florida,Olympia Heights,14536,3816,5521,1811,360,1105,12613
Florida,Medley,1118,270,430,166,30,92,988
Florida,Indiantown village,6938,2230,1854,449,290,342,5165
Florida,Westlake,2,0,0,2,0,0,2
Florida,World Golf Village,16538,1883,8586,1300,200,490,12459
Florida,Woodlawn Beach,2844,247,1623,303,0,99,2272
Florida,Wiscon,699,167,232,152,25,30,606
Florida,Windsor,200,0,200,0,0,0,200
Florida,Whitfield CDP (Santa Rosa County),202,42,120,0,6,29,197
Florida,Whitfield CDP (Manatee County),3504,593,1858,278,19,213,2961
Florida,West Lealman,15076,3370,5548,2774,226,1261,13179
Florida,Westgate,10026,3654,2270,513,191,343,6971
Florida,West DeLand,4310,801,1598,495,45,346,3285
Florida,Waukeenah,179,30,109,0,0,10,149
Florida,Watergate,2810,944,786,415,23,49,2217
Florida,Wallace,2005,507,1151,89,0,51,1798
Florida,Wacissa,349,28,196,25,7,0,256
Florida,Viera West,11116,1532,5248,1216,174,683,8853
Florida,Viera East,11183,1985,5348,929,101,1126,9489
Florida,Verona Walk,2334,163,1703,228,0,192,2286
Florida,University CDP (Orange County),36086,26337,5025,1495,299,620,33776
Florida,University CDP (Hillsborough County),46359,23885,8000,4065,1503,1746,39199
Florida,Trilby,354,71,64,95,24,25,279
Florida,Tiger Point,3122,514,1777,212,0,86,2589
Florida,The Acreage,39656,9195,18160,3278,697,1442,32772
Florida,Ocean Breeze,171,23,73,31,10,34,171
Florida,DeFuniak Springs,6227,1470,2426,776,89,391,5152
Florida,Ona,739,362,259,0,0,34,655
Florida,St. George Island,730,63,528,67,0,46,704
Florida,Goulds,11453,3955,2912,755,545,387,8554
Florida,Palm Valley,21562,3849,10769,2351,140,1141,18250
Florida,Fruit Cove,32994,6159,16521,2307,177,1183,26347
Florida,Ellenton,3820,434,2087,208,87,224,3040
Florida,Bradenton,55059,14560,18872,7184,853,4220,45689
Florida,Gladeview,13296,5711,2164,1172,362,492,9901
Florida,Bal Harbour village,3000,528,1334,265,9,468,2604
Florida,Blountstown,2843,663,825,373,45,385,2291
Florida,Interlachen,1583,378,505,212,39,114,1248
Florida,Pelican Bay,5844,137,4390,446,18,812,5803
Florida,Naples,21564,2945,12339,2150,246,2412,20092
Florida,Naranja,10702,3720,2492,702,339,282,7535
Florida,Lely,3508,587,1527,596,30,540,3280
Florida,Greenville,916,365,162,101,10,88,726
Florida,Zephyrhills West,5281,737,2602,801,55,771,4966
Florida,South Bay,5116,2698,780,752,171,95,4496
Florida,West Palm Beach,108365,36797,33948,12667,2199,6339,91950
Florida,Haines City,23400,6225,8010,1807,260,1112,17414
Florida,Samsula-Spruce Creek,5272,731,3093,523,53,281,4681
Florida,Palm Beach Shores,1128,235,500,187,13,99,1034
Florida,Edgewater,21892,4411,8766,3268,367,1857,18669
Florida,Tequesta village,6011,1204,2667,765,86,582,5304
Florida,Stacey Street,798,339,199,0,48,0,586
Florida,Estero village,32220,3977,19504,2868,331,2143,28823
Florida,Golden Gate,30104,8793,9895,3266,916,732,23602
Georgia,Forest Park,19483,6573,4658,1737,615,972,14555
Georgia,Robins AFB,1464,489,529,27,9,7,1061
Georgia,Trion,2322,537,785,211,46,104,1683
Georgia,Cornelia,4290,796,1331,412,35,282,2856
Georgia,Demorest,2027,851,651,167,32,107,1808
Georgia,Andersonville,240,86,67,16,10,23,202
Georgia,Butler,1989,579,720,150,16,151,1616
Georgia,White,788,184,298,75,43,33,633
Georgia,Crawfordville,564,195,198,41,16,27,477
Georgia,Tyrone,7221,1464,3764,378,41,130,5777
Georgia,Omega,1256,302,389,115,12,76,894
Georgia,Avondale Estates,3135,607,1462,344,42,138,2593
Georgia,Decatur,23054,5284,8427,1733,233,845,16522
Georgia,Edison,1163,268,311,120,40,158,897
Georgia,Leary,628,122,235,61,20,70,508
Georgia,Twin City,1860,605,438,287,51,184,1565
Georgia,Ellijay,2918,537,1197,292,15,181,2222
Georgia,Country Club Estates,8160,2362,2799,930,165,436,6692
Georgia,Panthersville,10581,4275,1956,1341,257,546,8375
Georgia,Nashville,4813,984,1464,636,162,487,3733
Georgia,Quitman,3771,1210,944,312,152,349,2967
Georgia,Kings Bay Base,3348,1766,730,120,42,17,2675
Georgia,Bloomingdale,2726,568,1191,265,50,206,2280
Georgia,Garden City,8936,2835,2258,1108,305,339,6845
Georgia,Thunderbolt,2643,798,880,372,55,216,2321
Georgia,Tybee Island,3093,803,1460,343,2,155,2763
Georgia,Clarkesville,1706,432,630,198,21,138,1419
Georgia,Kingston,490,89,172,84,8,41,394
Georgia,Americus,15659,5986,3713,1437,399,872,12407
Georgia,Palmetto,5089,1524,1433,598,73,265,3893
Georgia,Byromville,529,176,143,57,17,52,445
Georgia,Vinings,13086,5297,4755,1062,167,441,11722
Georgia,Social Circle,4419,952,1930,188,82,374,3526
Georgia,Raoul,2937,947,1008,498,169,48,2670
Georgia,Cedartown,9930,2643,2780,1244,180,667,7514
Georgia,Camak,117,25,34,12,0,26,97
Georgia,St. Marys,17921,3491,7884,1888,318,707,14288
Georgia,Between,328,55,166,38,0,10,269
Georgia,Bethlehem,930,184,364,66,12,23,649
Georgia,Rayle,235,75,55,9,16,17,172
Georgia,Talbotton,875,328,177,93,75,63,736
Georgia,Argyle,217,25,108,28,12,15,188
Georgia,Woodland,297,81,110,21,20,30,262
Georgia,Poulan,729,153,343,49,10,63,618
Georgia,Hazlehurst,4164,1043,1272,388,178,268,3149
Georgia,Wadley,1841,738,450,167,69,138,1562
Georgia,Wrightsville,3666,1490,877,419,125,339,3250
Georgia,Montezuma,3117,1092,973,160,150,226,2601
Georgia,Camilla,5000,1951,1073,597,101,240,3962
Georgia,Pitts,383,117,100,38,17,39,311
Georgia,Attapulgus,571,184,175,52,23,36,470
Georgia,Blue Ridge,1242,257,438,252,27,130,1104
Georgia,McCaysville,1353,275,470,209,45,91,1090
Georgia,Ranger,137,42,45,15,8,9,119
Georgia,Tignall,457,105,131,91,9,81,417
Georgia,East Newnan,1134,410,254,98,141,30,933
Georgia,Trenton,2335,317,994,283,61,141,1796
Georgia,Blakely,4690,1687,988,294,135,371,3475
Georgia,Franklin,1001,343,231,167,18,114,873
Georgia,Stapleton,393,91,119,30,5,29,274
Georgia,East Point,34977,14777,6744,4007,935,1576,28039
Georgia,Centralhatchee,455,98,178,41,4,25,346
Georgia,Millen,2838,682,846,280,208,223,2239
Georgia,Avera,269,89,86,22,4,20,221
Georgia,Lindale,4466,1066,1726,488,20,289,3589
Georgia,Cumming,6027,1644,1805,1063,193,461,5166
Georgia,Arcade,1554,395,649,142,35,91,1312
Georgia,Uvalda,527,146,177,32,7,37,399
Georgia,Talmo,295,62,145,21,0,9,237
Georgia,Warm Springs,510,149,100,90,16,56,411
Georgia,Higgston,474,58,151,25,14,25,273
Georgia,Eton,1094,177,448,140,4,44,813
Georgia,Bishop,358,42,181,9,5,2,239
Georgia,Perry,16031,4288,5297,1633,358,791,12367
Georgia,Warner Robins,74762,19006,27272,6691,1270,3616,57855
Georgia,Dallas,13014,3563,3836,1575,90,592,9656
Georgia,Hilltop,200,35,25,23,27,58,168
Georgia,Maxeys,284,57,131,16,5,26,235
Georgia,Dillard,372,122,157,50,13,15,357
Georgia,Hiram,3897,1036,1612,418,106,164,3336
Georgia,Rocky Ford,209,18,101,23,8,4,154
Georgia,Thomaston,8802,3087,1967,1001,111,760,6926
Georgia,Santa Claus,195,49,84,6,1,4,144
Georgia,Sky Valley,328,23,243,19,0,25,310
Georgia,Clayton,1838,386,524,311,74,320,1615
Georgia,Evans,34379,7376,16515,2013,159,1140,27203
Georgia,Ball Ground,1993,279,1059,186,11,36,1571
Georgia,Woodstock,30362,5041,13459,2979,418,1235,23132
Georgia,Kennesaw,33700,9617,12583,3267,362,1143,26972
Georgia,Arabi,645,163,197,94,16,59,529
Georgia,Cordele,10793,3547,2546,766,331,953,8143
Georgia,Lake Park,855,217,322,116,4,55,714
Georgia,Lincolnton,1823,493,590,176,73,93,1425
Georgia,Walthourville,4095,1352,1083,359,84,184,3062
Georgia,Hahira,2923,507,1081,290,52,151,2081
Georgia,Alston,185,42,80,7,0,25,154
Georgia,Unadilla,3615,1377,777,411,257,197,3019
Georgia,Hull,189,31,81,17,0,9,138
Georgia,Ailey,563,257,158,56,0,29,500
Georgia,Lexington,205,50,72,13,5,16,156
Georgia,Mountain City,1103,233,383,93,83,149,941
Georgia,Sylvania,2805,768,951,253,126,202,2300
Georgia,Shannon,1931,236,815,225,106,63,1445
Georgia,Moody AFB,1191,669,369,21,0,0,1059
Georgia,Carlton,429,125,176,44,2,27,374
Georgia,Ila,405,76,202,27,4,17,326
Georgia,Mount Vernon,2519,768,803,289,81,157,2098
Georgia,Oxford,2109,912,555,138,40,88,1733
Georgia,Chickamauga,3145,847,951,427,36,241,2502
Georgia,Woodbury,1203,525,357,48,29,71,1030
Georgia,Morrow,7238,2801,2349,454,194,133,5931
Georgia,Newton,840,213,265,65,24,67,634
Georgia,Graham,301,76,126,27,0,18,247
Georgia,Sumner,491,121,190,53,11,15,390
Georgia,Rossville,3994,1001,1121,487,94,405,3108
Georgia,Manassas,70,11,30,13,0,6,60
Georgia,Newborn,734,183,260,101,15,34,593
Georgia,Chatsworth,4271,541,1807,519,150,438,3455
Georgia,Pine Mountain,1440,416,393,186,45,96,1136
Georgia,Greenville,1093,373,262,77,53,78,843
Georgia,Gay,87,15,48,3,5,2,73
Georgia,Dexter,643,113,238,66,7,55,479
Georgia,Mansfield,445,64,177,48,8,27,324
Georgia,Brinson,226,40,103,29,3,17,192
Georgia,Bainbridge,12152,3654,3349,1067,240,890,9200
Georgia,Lovejoy,6484,2295,1058,927,146,104,4530
Georgia,Lookout Mountain,1766,345,901,119,8,61,1434
Georgia,Young Harris,1033,773,141,31,0,36,981
Georgia,Lyons,4318,737,1399,497,122,213,2968
Georgia,Cleveland,3834,990,1467,357,6,265,3085
Georgia,Reidsville,2642,388,775,359,164,288,1974
Georgia,Deepstep,125,11,81,3,0,13,108
Georgia,Sunnyside,1121,187,532,75,0,141,935
Georgia,Sunset Village,747,133,324,119,17,41,634
Georgia,Phillipsburg,922,439,148,42,0,43,672
Georgia,Calhoun,16708,3684,5758,1659,531,1113,12745
Georgia,Abbeville,2792,1473,402,505,74,132,2586
Georgia,Pineview,525,192,101,51,22,50,416
Georgia,Lakeview Estates,2697,754,820,64,23,9,1670
Georgia,Fairburn,14708,4765,3678,1514,414,231,10602
Georgia,Lyerly,541,118,210,65,9,61,463
Georgia,Gillsville,227,25,123,11,1,10,170
Georgia,Fort Gaines,1010,333,175,84,55,80,727
Georgia,Jasper,3796,620,1609,539,15,227,3010
Georgia,Ideal,364,111,86,53,19,56,325
Georgia,Dearing,680,151,280,21,45,38,535
Georgia,Norcross,16369,4744,5955,1039,191,317,12246
Georgia,Taylorsville,238,24,124,18,0,16,182
Georgia,Emerson,1685,281,723,183,11,77,1275
Georgia,Nicholls,3870,2226,506,705,77,130,3644
Georgia,Cartersville,20467,4662,7629,2317,483,1025,16116
Georgia,Gainesville,38624,11144,12993,3214,650,1487,29488
Georgia,Sunny Side,160,26,45,17,7,10,105
Georgia,Oakwood,4124,1342,1177,426,190,133,3268
Georgia,Conley,6002,1958,1449,678,221,282,4588
Georgia,Sycamore,868,319,234,62,20,37,672
Georgia,Soperton,3073,887,887,382,121,276,2553
Georgia,Avalon,185,24,65,49,16,3,157
Georgia,Moreland,408,93,165,62,5,23,348
Georgia,Manchester,3977,1164,1209,544,77,221,3215
Georgia,Plains,658,211,137,90,11,130,579
Georgia,Ellaville,1788,470,580,157,39,86,1332
Georgia,Waverly Hall,908,246,293,154,35,72,800
Georgia,Hamilton,1549,397,545,151,30,22,1145
Georgia,Waco,440,89,182,62,8,28,369
Georgia,Broxton,1254,362,455,85,26,86,1014
Georgia,College Park,14819,6374,2850,1224,329,552,11329
Georgia,Adairsville,4792,983,1776,552,113,240,3664
Georgia,Arlington,1656,604,383,122,56,115,1280
Georgia,Jefferson,10693,1873,4607,869,372,540,8261
Georgia,Ludowici,2605,581,1013,235,13,94,1936
Georgia,Midway,2077,566,709,159,48,64,1546
Georgia,Fort Valley,8740,4647,1323,626,339,480,7415
Georgia,Cobbtown,366,66,166,63,6,25,326
Georgia,Sylvester,5926,1945,1525,602,97,325,4494
Georgia,Collins,573,110,179,43,30,45,407
Georgia,Baconton,1001,289,208,108,38,42,685
Georgia,Dublin,15869,5217,4020,1803,440,1127,12607
Georgia,Colquitt,2194,633,676,156,71,179,1715
Georgia,North High Shoals,707,178,323,46,8,35,590
Georgia,Zebulon,1196,276,438,141,30,62,947
Georgia,Tallulah Falls,100,44,51,5,0,0,100
Georgia,Clermont,902,179,475,58,5,51,768
Georgia,Richland,1637,572,482,157,53,179,1443
Georgia,Euharlee,4264,855,1848,498,7,268,3476
Georgia,Bonanza,3421,854,879,555,112,95,2495
Georgia,Aragon,1382,327,465,209,36,52,1089
Georgia,Georgetown,13469,3786,5029,1207,344,474,10840
Georgia,Gordon,2068,592,502,197,88,123,1502
Georgia,White Plains,219,45,80,32,4,27,188
Georgia,Summerville,4339,974,1140,813,110,267,3304
Georgia,Montgomery,4533,931,1697,765,55,255,3703
Georgia,East Ellijay,669,161,154,71,25,54,465
Georgia,Daisy,150,11,59,20,0,11,101
Georgia,Lilly,194,64,50,25,10,12,161
Georgia,Toccoa,8274,1756,3130,1071,158,448,6563
Georgia,Thomasville,18546,5397,5329,2070,834,1188,14818
Georgia,Tifton,16603,6284,4461,1102,315,771,12933
Georgia,Whigham,509,152,155,91,6,47,451
Georgia,Aldora,123,14,33,20,0,6,73
Georgia,Cadwell,489,186,127,55,3,31,402
Georgia,Marshallville,1470,451,386,115,133,93,1178
Georgia,Buena Vista,2104,989,562,122,50,123,1846
Georgia,Madison,4041,1028,1342,473,56,304,3203
Georgia,Lake City,2749,1333,600,122,72,151,2278
Georgia,Fairmount,994,194,330,146,24,58,752
Georgia,Experiment,2853,519,713,403,70,182,1887
Georgia,Plainville,403,79,169,45,10,8,311
Georgia,Shiloh,422,71,216,41,11,10,349
Georgia,Bowersville,465,91,170,55,12,26,354
Georgia,Conyers,15882,5152,3503,2014,282,756,11707
Georgia,Lumpkin,1142,461,245,106,25,77,914
Georgia,De Soto,175,60,29,4,12,11,116
Georgia,Leslie,589,150,198,35,21,14,418
Georgia,Portal,606,127,166,85,54,79,511
Georgia,Sandersville,5616,1571,1409,721,268,542,4511
Georgia,Braselton,10509,1825,5052,605,100,438,8020
Georgia,Bremen,6311,960,2848,530,62,288,4688
Georgia,Metter,3978,1185,1067,423,162,297,3134
Georgia,Union City,20960,7498,4031,2668,421,1064,15682
Georgia,Mount Airy,1281,206,474,109,9,99,897
Georgia,Jesup,9814,2686,2716,1069,538,663,7672
Georgia,Ocilla,3487,1277,749,381,152,264,2823
Georgia,Rest Haven,179,34,85,7,0,0,126
Georgia,Willacoochee,1461,400,461,91,74,126,1152
Georgia,Statham,2633,635,1030,348,79,117,2209
Georgia,Hoboken,762,106,317,71,0,17,511
Georgia,Pembroke,2447,637,684,247,49,59,1676
Georgia,Indian Springs,2650,540,1144,186,22,125,2017
Georgia,Mount Zion,2377,663,894,120,32,89,1798
Georgia,Vernonburg,106,5,69,3,0,5,82
Georgia,Eastman,5209,1672,1572,485,163,290,4182
Georgia,Pavo,598,166,204,66,18,45,499
Georgia,Fort Oglethorpe,9852,1687,3946,1468,50,792,7943
Georgia,Ringgold,3563,905,1186,611,102,203,3007
Georgia,Kingsland,16784,3875,6403,1586,308,388,12560
Georgia,Monticello,2630,552,911,348,70,192,2073
Georgia,Denton,149,27,73,13,3,8,124
Georgia,Leesburg,2982,912,936,328,32,85,2293
Georgia,East Dublin,2725,882,644,202,90,183,2001
Georgia,Pelham,3609,1053,1009,216,97,234,2609
Georgia,Culloden,227,56,93,18,8,20,195
Georgia,Flemington,666,153,296,46,16,8,519
Georgia,Forsyth,4054,947,1164,487,64,324,2986
Georgia,Buckhead,155,24,59,12,8,13,116
Georgia,Stockbridge,28648,9405,9657,2433,488,809,22792
Georgia,Fort Stewart,9326,2004,4069,159,46,35,6313
Georgia,Darien,2500,865,676,294,50,290,2175
Georgia,Sharon,140,52,64,10,8,4,138
Georgia,Covington,13844,4022,3153,1792,463,836,10266
Georgia,Buford,15185,4148,5195,1328,226,981,11878
Georgia,Crawford,943,232,240,95,22,126,715
Georgia,Homerville,2442,617,688,244,71,130,1750
Georgia,Tunnel Hill,1317,290,555,95,36,66,1042
Georgia,Nahunta,775,179,184,110,5,142,620
Georgia,Davisboro,1903,1118,374,248,54,37,1831
Georgia,Flovilla,878,332,279,91,5,59,766
Georgia,Harrison,492,136,182,38,11,36,403
Georgia,Scotland,477,86,193,25,0,31,335
Georgia,Lakeview,5147,1195,1970,614,104,352,4235
Georgia,Temple,4366,1005,1808,318,147,219,3497
Georgia,Fargo,273,38,114,26,4,21,203
Georgia,Springfield,3526,860,1084,616,47,228,2835
Georgia,Canton,27127,6274,10578,2729,383,921,20885
Georgia,Suwanee,19215,4048,8884,1523,223,700,15378
Georgia,Hogansville,3085,819,847,345,150,271,2432
Georgia,Ashburn,3691,919,1261,424,68,220,2892
Georgia,Lilburn,12561,3152,5020,862,121,390,9545
Georgia,Mountain Park,13877,3104,6069,1040,219,578,11010
Georgia,Pearson,2036,705,362,175,98,133,1473
Georgia,Auburn,7303,1718,3062,579,152,225,5736
Georgia,Winder,15827,3884,5055,2144,431,942,12456
Georgia,Fitzgerald,8865,2833,2117,874,362,728,6914
Georgia,Bowdon,2134,642,702,250,46,168,1808
Georgia,Savannah,145342,56566,37062,15013,3264,7335,119240
Georgia,Haralson,165,29,79,25,5,6,144
Georgia,Ochlocknee,633,159,138,92,39,57,485
Georgia,Ty Ty,966,266,294,55,19,59,693
Georgia,Danville,200,74,57,5,5,22,163
Georgia,Oconee,370,44,178,33,6,38,299
Georgia,Dacula,5644,1341,2422,606,92,131,4592
Georgia,Warrenton,1976,757,491,173,51,149,1621
Georgia,Cairo,9528,2494,3185,897,257,809,7642
Georgia,Shady Dale,437,124,136,40,1,5,306
Georgia,Louisville,2628,986,668,140,46,249,2089
Georgia,Reed Creek,2535,490,1299,294,80,162,2325
Georgia,Rockmart,4244,1466,1266,340,69,46,3187
Georgia,Iron City,254,53,99,35,0,39,226
Georgia,East Griffin,1316,238,468,223,33,63,1025
Georgia,Griffin,22725,8067,5422,2600,775,1018,17882
Georgia,Glennville,5078,1490,1497,565,121,362,4035
Georgia,Lumber City,1230,384,334,129,22,126,995
Georgia,Helen,390,64,224,33,6,32,359
Georgia,Parrott,139,13,64,30,0,24,131
Georgia,Vidalia,10473,2439,3669,1001,380,805,8294
Georgia,Screven,1065,286,355,121,37,68,867
Georgia,Warwick,424,155,105,63,5,25,353
Georgia,Irondale,8578,3266,1955,845,46,375,6487
Georgia,Chattanooga Valley,3727,822,1562,519,63,218,3184
Georgia,Jonesboro,4737,2253,919,559,118,179,4028
Georgia,Bronwood,271,75,61,36,30,28,230
Georgia,Dawson,4222,1406,977,369,147,276,3175
Georgia,Washington,3975,1131,1000,523,110,456,3220
Georgia,Rome,36185,10187,11681,3501,1203,2321,28893
Georgia,Gray,3261,794,1196,359,50,226,2625
Georgia,Hinesville,33258,6997,13319,2967,782,842,24907
Georgia,Dasher,859,242,366,70,7,28,713
Georgia,Valdosta,56074,21205,14449,5406,1221,2647,44928
Georgia,Comer,1320,212,619,126,24,54,1035
Georgia,Danielsville,816,147,411,78,5,37,678
Georgia,Martin,546,26,329,48,15,12,430
Georgia,Adrian,558,158,141,67,16,50,432
Georgia,Buchanan,1435,416,399,175,41,116,1147
Georgia,Douglasville,33210,10619,9802,3399,923,1202,25945
Georgia,Climax,178,34,72,24,0,22,152
Georgia,Riverdale,16289,5376,4150,1786,736,381,12429
Georgia,Wrens,2295,650,605,160,52,232,1699
Georgia,Milner,954,197,439,127,7,30,800
Georgia,Smithville,683,174,268,32,12,64,550
Georgia,Dudley,857,202,348,67,6,46,669
Georgia,Montrose,280,72,81,20,3,15,191
Georgia,Dahlonega,6556,3499,1673,331,62,321,5886
Georgia,Morven,775,133,311,42,28,60,574
Georgia,Alma,3474,1041,928,424,162,175,2730
Georgia,Enigma,925,290,296,75,11,56,728
Georgia,Ray City,1076,216,369,98,65,61,809
Georgia,Richmond Hill,12203,2484,4820,1042,137,423,8906
Georgia,Folkston,4951,1591,1448,588,271,180,4078
Georgia,Homeland,939,265,296,107,4,110,782
Georgia,Alapaha,814,284,206,142,32,30,694
Georgia,Carrollton,26397,11181,7143,1705,428,1447,21904
Georgia,Port Wentworth,7946,1653,3419,781,49,224,6126
Georgia,Du Pont,173,49,72,5,3,22,151
Georgia,Sharpsburg,402,70,165,43,13,28,319
Georgia,Grantville,3219,802,1043,358,80,129,2412
Georgia,Newnan,37818,9237,14286,3250,827,1656,29256
Georgia,Senoia,4160,950,2006,132,115,21,3224
Georgia,LaGrange,30412,10545,7850,2575,1208,1736,23914
Georgia,West Point,3554,873,1167,238,285,216,2779
Georgia,Lincoln Park,389,117,99,95,33,45,389
Georgia,Deenwood,2588,626,952,279,16,183,2056
Georgia,Duluth,29239,7307,11915,3072,236,1121,23651
Georgia,Loganville,11665,2820,4807,1031,115,374,9147
Georgia,Hapeville,6581,2537,1540,724,50,268,5119
Georgia,Isle of Hope,2539,456,1259,232,14,69,2030
Georgia,Oak Park,717,138,245,48,28,30,489
Georgia,Candler-McAfee,24022,10545,4731,2413,650,1806,20145
Georgia,Snellville,19631,5095,8065,1884,189,798,16031
Georgia,Tallapoosa,3133,459,1163,511,77,319,2529
Georgia,Hartwell,4411,1272,1268,469,51,466,3526
Georgia,Talking Rock,139,39,60,13,0,3,115
Georgia,Meigs,989,297,253,98,34,73,755
Georgia,Orchard Hill,250,69,72,31,2,19,193
Georgia,Geneva,162,50,43,33,0,25,151
Georgia,Junction City,203,93,41,11,5,25,175
Georgia,Rochelle,961,302,355,119,18,62,856
Georgia,Turin,571,113,281,19,3,11,427
Georgia,Boston,1325,290,441,116,46,87,980
Georgia,Monroe,13370,4361,3174,1486,316,731,10068
Georgia,Irwinton,567,212,162,45,9,46,474
Georgia,Hannahs Mill,3372,640,1413,346,110,184,2693
Georgia,Norwood,242,90,87,24,5,12,218
Georgia,Riddleville,46,19,21,2,1,3,46
Georgia,Tennille,1722,572,375,164,93,159,1363
Georgia,Glenwood,713,293,120,33,13,40,499
Georgia,Berkeley Lake,1994,308,1200,113,13,60,1694
Georgia,Grayson,3658,736,1726,320,39,115,2936
Georgia,Lawrenceville,29401,8355,10140,2732,495,1101,22823
Georgia,Varnell,2156,330,1044,166,43,69,1652
Georgia,Milledgeville,18813,9800,3679,1598,529,852,16458
Georgia,Carl,235,51,121,13,0,9,194
Georgia,Cochran,4869,2001,1155,425,88,333,4002
Georgia,Unionville,2183,1043,304,75,109,133,1664
Georgia,Jeffersonville,1127,288,328,153,59,119,947
Georgia,McIntyre,678,221,230,78,15,42,586
Georgia,Roswell,94257,23277,39908,7553,678,3142,74558
Georgia,Blairsville,625,224,167,80,10,56,537
Georgia,Alpharetta,64672,12542,30242,4801,496,2056,50137
Georgia,Coolidge,416,83,139,31,20,11,284
Georgia,Register,116,13,52,10,0,10,85
Georgia,Statesboro,31001,18497,5279,1685,561,966,26988
Georgia,North Druid Hills,17287,7773,5140,1365,229,787,15294
Georgia,Midville,329,79,94,36,6,31,246
Georgia,Pulaski,309,74,102,33,4,49,262
Georgia,Gresham Park,8694,3667,2061,1008,168,537,7441
Georgia,Pinehurst,423,156,72,68,9,57,362
Georgia,Jakin,197,62,72,21,0,10,165
Georgia,Elberton,4383,1558,1130,528,158,303,3677
Georgia,Martinez,36068,8322,14564,3575,836,1821,29118
Georgia,Fair Oaks,9173,3414,2061,802,208,251,6736
Georgia,Powder Springs,14945,3758,5670,1303,341,748,11820
Georgia,Brooks,509,83,265,38,20,21,427
Georgia,Doerun,649,124,168,54,29,96,471
Georgia,Sparta,1854,567,532,108,43,135,1385
Georgia,Blackshear,3485,944,993,390,231,275,2833
Georgia,Patterson,647,114,299,76,10,43,542
Georgia,Eatonton,6529,1843,2023,623,220,332,5041
Georgia,Waynesboro,5558,1625,1629,300,83,279,3916
Georgia,Doraville,10471,3418,3119,780,142,399,7858
Georgia,Pooler,23102,4821,10201,2093,310,946,18371
Georgia,Skidaway Island,8783,788,5875,441,39,799,7942
Georgia,Sparks,2261,482,713,197,85,141,1618
Georgia,Rhine,499,140,161,52,18,50,421
Georgia,Bowman,849,215,305,78,18,65,681
Georgia,Grovetown,13658,2329,5827,1393,259,296,10104
Georgia,Harlem,3054,771,1062,331,22,138,2324
Georgia,Waleska,727,513,106,17,5,16,657
Georgia,Salem,407,134,143,27,24,28,356
Georgia,St. Simons,14302,1855,7821,1605,128,1062,12471
Georgia,Yatesville,424,116,199,28,0,33,376
Georgia,Remerton,1224,895,137,60,0,0,1092
Georgia,Hoschton,1567,349,709,132,43,73,1306
Georgia,Gumbranch,209,41,80,24,7,20,172
Georgia,Riceboro,641,177,195,98,15,66,551
Georgia,Colbert,624,163,257,80,18,25,543
Georgia,Luthersville,805,252,249,94,39,67,701
Georgia,Byron,5108,930,1798,777,151,477,4133
Georgia,Cuthbert,3581,1037,586,322,243,290,2478
Georgia,Shellman,1147,413,276,78,30,138,935
Georgia,Hephzibah,3973,898,1847,303,48,187,3283
Georgia,Oliver,382,93,137,21,17,14,282
Georgia,Meansville,99,14,47,18,7,4,90
Georgia,Tiger,512,156,185,47,15,67,470
Georgia,Sasser,338,78,123,31,6,16,254
Georgia,Fairview,6518,1398,2648,814,84,304,5248
Georgia,Albany,74631,27590,17350,7586,2686,3981,59193
Georgia,Bartow,268,84,76,44,0,15,219
Georgia,Barnesville,6608,3431,1317,415,137,440,5740
Georgia,Thomson,6603,1997,1611,855,90,463,5016
Georgia,Oglethorpe,1288,491,314,109,46,77,1037
Georgia,Rutledge,928,224,297,105,44,95,765
Georgia,Locust Grove,6540,1465,2152,687,64,424,4792
Georgia,McDonough,24102,7800,6951,2974,397,916,19038
Georgia,Nicholson,1781,429,768,115,28,75,1415
Georgia,Sugar Hill,22314,4926,9561,1836,280,619,17222
Georgia,Lakeland,3271,1083,774,468,50,190,2565
Georgia,Putney,2250,409,839,419,61,165,1893
Georgia,Hampton,7604,2210,2958,641,103,60,5972
Georgia,Newington,276,58,97,33,5,19,212
Georgia,Molena,468,122,110,64,14,48,358
Georgia,Arnoldsville,429,75,187,67,12,17,358
Georgia,Waycross,13836,3418,4057,1497,439,1146,10557
Georgia,Dock Junction,8478,2282,2951,1119,159,427,6938
Georgia,Morgan,2055,1216,366,283,92,58,2015
Georgia,Redan,32357,12032,7456,3976,1120,1309,25893
Georgia,Stone Mountain,6251,2654,1431,498,252,263,5098
Georgia,Mitchell,197,48,81,17,3,8,157
Georgia,Alto,1308,323,539,57,15,40,974
Georgia,Menlo,439,91,177,43,9,26,346
Georgia,Douglas,11556,3776,2525,1124,306,612,8343
Georgia,Royston,2997,629,666,514,114,397,2320
Georgia,Brunswick,16034,5025,3804,2353,437,861,12480
Georgia,Woodville,355,100,100,63,11,31,305
Georgia,Baldwin,3482,844,1266,232,18,115,2475
Georgia,Dalton,33458,8344,12108,2868,829,1728,25877
Georgia,Maysville,2307,494,923,235,23,190,1865
Georgia,Hawkinsville,5310,1993,1107,918,157,455,4630
Georgia,Belvedere Park,15543,6326,3260,2193,394,905,13078
Georgia,Holly Springs,11469,1865,5422,1128,89,193,8697
Georgia,Druid Hills,8244,2541,3862,458,34,201,7096
Georgia,Guyton,2309,375,991,192,18,65,1641
Georgia,Bellville,145,27,88,18,0,12,145
Georgia,Dawsonville,2772,591,1099,281,48,101,2120
Georgia,Cave Spring,1128,229,450,125,43,103,950
Georgia,Woolsey,198,47,111,0,0,12,170
Georgia,Carnesville,743,175,246,116,16,43,596
Georgia,Franklin Springs,900,415,323,44,24,31,837
Georgia,Commerce,6742,1545,2343,898,122,498,5406
Georgia,Lone Oak,79,17,30,10,2,20,79
Georgia,Ellenton,156,30,69,8,15,14,136
Georgia,Fayetteville,17349,3796,7550,2033,238,886,14503
Georgia,Donalsonville,2589,836,623,279,19,232,1989
Georgia,Gumlog,2236,276,1163,212,23,158,1832
Georgia,Summertown,180,42,51,7,11,24,135
Georgia,Whitesburg,743,166,252,70,52,33,573
Georgia,Tarrytown,44,7,8,13,2,7,37
Georgia,Toomsboro,508,194,109,57,16,52,428
Georgia,Walnut Grove,1422,416,552,136,15,43,1162
Georgia,Williamson,586,139,262,30,2,30,463
Georgia,Athens-Clarke County unified government (balance),123310,57754,33325,8479,1735,3623,104916
Georgia,Augusta-Richmond County consolidated government (balance),196807,67554,54327,20431,4784,11136,158232
Georgia,Johns Creek,83637,16036,42611,4974,464,1789,65874
Georgia,Milton,38171,8085,18550,2066,303,796,29800
Georgia,Russell,1229,353,260,113,27,25,778
Georgia,Cusseta-Chattahoochee County unified governme,10767,4227,3632,493,64,210,8626
Georgia,Georgetown-Quitman County unified governme,2276,654,726,159,119,265,1923
Georgia,Boykin,52,9,6,19,0,18,52
Georgia,Calvary,110,14,58,0,0,0,72
Georgia,Stillmore,535,164,163,55,9,35,426
Georgia,Sardis,750,226,186,67,26,31,536
Georgia,Sandy Springs,105411,33027,41291,8604,1196,3838,87956
Georgia,Sale City,438,101,186,23,10,21,341
Georgia,Nunez,169,41,64,27,2,15,149
Georgia,Odum,506,95,258,35,4,28,420
Georgia,Pendergrass,487,82,268,48,2,18,418
Georgia,Allentown,123,22,57,5,0,4,88
Georgia,Porterdale,1742,524,498,173,51,111,1357
Georgia,Watkinsville,2871,855,995,310,63,137,2360
Georgia,Chattahoochee Hills,2867,614,1366,226,58,211,2475
Georgia,Canoochee,125,17,80,0,0,10,107
Georgia,Webster County unified governme,2613,502,1112,164,103,208,2089
Georgia,Allenhurst,915,243,290,96,17,54,700
Georgia,Barwick,296,74,92,29,3,30,228
Georgia,Rebecca,237,21,129,13,0,14,177
Georgia,Rentz,285,75,100,41,3,17,236
Georgia,Resaca,960,231,325,130,25,46,757
Georgia,Reynolds,1119,284,320,127,46,101,878
Georgia,Rincon,9863,2020,3563,1051,112,469,7215
Georgia,Alamo,3362,1989,614,277,55,120,3055
Georgia,Morganton,277,44,129,27,1,29,230
Georgia,Cedar Springs,122,10,41,68,0,3,122
Georgia,Coleman,19,0,12,0,0,0,12
Georgia,Seville,116,11,58,14,0,23,106
Georgia,Talahi Island,1406,139,671,171,62,147,1190
Georgia,Tate City,0,0,0,0,0,0,0
Georgia,The Rock,203,47,28,18,0,38,131
Georgia,Yonah,586,63,232,219,0,0,514
Georgia,Echols County consolidated governme,3994,768,1871,376,66,232,3313
Georgia,Stonecrest,53772,20659,11622,6034,1326,1857,41498
Georgia,Tucker,35692,10255,13852,3507,708,1803,30125
Georgia,South Fulton,94912,32890,26291,9632,2098,3423,74334
Georgia,Appling,1010,343,335,66,0,69,813
Georgia,Brookhaven,53140,16212,19365,4109,978,1635,42299
Georgia,Peachtree Corners,42463,11964,17561,3161,555,940,34181
Georgia,Peachtree City,35165,6384,17460,2381,270,1686,28181
Georgia,Sautee-Nacoochee,178,45,102,0,0,10,157
Georgia,McRae-Helena,8538,4122,1998,739,161,281,7301
Georgia,Satilla,376,19,131,39,0,72,261
Georgia,Rockingham,102,18,37,25,0,10,90
Georgia,Perkins,225,128,76,21,0,0,225
Georgia,Norristown,84,50,7,22,0,5,84
Georgia,Crooked Creek,497,89,236,54,0,22,401
Georgia,Dewy Rose,129,0,87,0,0,42,129
Georgia,Dunwoody,49016,10388,21622,3539,455,2016,38020
Georgia,Dutch Island,1013,104,633,29,0,59,825
Georgia,Eagle Grove,0,0,0,0,0,0,0
Georgia,Empire,387,134,162,14,23,40,373
Georgia,Epworth,182,11,171,0,0,0,182
Georgia,Cherry Log,47,14,17,0,16,0,47
Georgia,Hardwick,3431,1339,770,382,173,281,2945
Georgia,Heron Bay,3195,367,1704,155,31,29,2286
Georgia,Howard,0,0,0,0,0,0,0
Georgia,Jenkinsburg,312,63,116,28,4,23,234
Georgia,Knoxville,64,13,37,14,0,0,64
Georgia,Matthews,194,29,94,25,0,0,148
Georgia,Mendes,59,3,19,12,0,10,44
Georgia,Mineral Bluff,335,25,146,11,0,20,202
Georgia,Henderson,1853,496,751,200,150,30,1627
Georgia,Milan,805,138,381,58,14,49,640
Georgia,Macon-Bibb,153490,49274,45114,15003,3609,8697,121697
Georgia,LaFayette,7191,1446,2596,949,310,644,5945
Georgia,Adel,5290,1527,1682,615,93,321,4238
Georgia,Roberta,909,244,240,127,7,74,692
Georgia,Chester,2121,1140,317,396,50,75,1978
Georgia,Vienna,3737,1609,880,291,201,292,3273
Georgia,Claxton,2359,745,564,210,23,197,1739
Georgia,Hagan,1141,229,345,130,14,78,796
Georgia,Mountain Park,625,123,260,114,0,20,517
Georgia,Nelson,1573,257,740,101,5,62,1165
Georgia,Acworth,22336,5153,8967,2024,358,1048,17550
Georgia,Marietta,60410,18311,19183,6766,1248,2278,47786
Georgia,Smyrna,55976,15515,21225,5675,656,1392,44463
Georgia,Dooling,169,59,54,10,0,5,128
Georgia,Austell,7276,2296,1905,883,196,249,5529
Georgia,Mableton,40464,10396,16187,2915,639,1235,31372
Georgia,Canon,1002,272,373,72,39,47,803
Georgia,Wilmington Island,15391,2761,7151,1624,147,987,12670
Georgia,Villa Rica,15124,3778,5171,1535,270,486,11240
Georgia,Roopville,271,66,99,27,3,18,213
Georgia,Woodbine,1585,489,499,125,40,87,1240
Georgia,Lithia Springs,17216,5733,5259,1853,509,438,13792
Georgia,Union Point,1837,542,562,139,44,159,1446
Georgia,Baxley,4697,1067,1571,461,101,358,3558
Georgia,Winterville,1123,258,562,88,22,35,965
Georgia,Edge Hill,14,5,7,0,0,2,14
Georgia,Lula,2880,667,1048,361,74,87,2237
Georgia,Moultrie,14109,4371,3549,1582,657,688,10847
Georgia,Lavonia,2131,595,639,219,65,236,1754
Georgia,Norman Park,1024,255,393,88,29,62,827
Georgia,Chamblee,28748,11181,8481,2106,513,729,23010
Georgia,Clarkston,12762,4076,3973,757,219,357,9382
Georgia,Lithonia,2445,784,370,235,71,98,1558
Georgia,Pine Lake,747,223,238,164,0,37,662
Georgia,North Decatur,17298,6457,5743,2134,122,652,15108
Georgia,Scottdale,10698,3480,3865,742,214,232,8533
Georgia,Whitemarsh Island,7058,1452,3141,445,88,339,5465
Georgia,Girard,188,56,44,7,2,11,120
Georgia,Siloam,399,105,77,62,11,16,271
Georgia,Centerville,7671,1431,3450,572,77,499,6029
Georgia,Greensboro,3356,1183,803,237,144,209,2576
Georgia,Cohutta,539,91,259,50,3,27,430
Georgia,Concord,298,62,118,22,4,21,227
Georgia,Damascus,291,85,68,44,12,27,236
Georgia,Flowery Branch,7151,1622,2897,894,67,260,5740
Georgia,Funston,618,158,209,36,8,33,444
Georgia,Garfield,142,23,84,6,0,8,121
Georgia,Good Hope,364,56,197,27,7,39,326
Georgia,Hiawassee,753,89,280,161,17,177,724
Georgia,Hiltonia,438,192,118,36,8,24,378
Georgia,Ivey,939,195,316,88,6,70,675
Georgia,Jacksonville,80,16,35,13,0,11,75
Georgia,Jersey,78,6,23,26,1,14,70
Georgia,Kite,290,43,75,34,2,16,170
Georgia,Keysville,169,48,60,12,5,9,134
Georgia,Swainsboro,7347,2857,967,836,229,437,5326
Georgia,Chauncey,369,78,129,43,10,20,280
Georgia,Cecil,343,100,73,58,19,36,286
Georgia,Ephesus,316,62,169,29,8,19,287
Georgia,Braswell,455,79,187,42,18,3,329
Georgia,Jackson,4999,1741,1129,423,85,463,3841
Georgia,Surrency,293,102,78,23,8,25,236
Georgia,Brooklet,1751,459,762,185,11,71,1488
Georgia,Vidette,186,41,71,8,7,13,140
Georgia,Atlanta,479655,221478,109407,42397,8126,21986,403394
Georgia,Bogart,1390,380,553,106,38,37,1114
Georgia,Bluffton,68,22,21,4,7,0,54
Georgia,Gibson,696,178,201,120,7,96,602
Georgia,Homer,1269,192,525,131,51,147,1046
Georgia,Offerman,474,73,208,20,8,31,340
Georgia,Bostwick,294,86,138,12,0,7,243
Georgia,Blythe,700,160,308,72,2,19,561
Georgia,Columbus,196670,58318,61678,21033,4386,10087,155502
Georgia,Lenox,789,139,289,107,40,59,634
Georgia,Berlin,679,191,249,52,7,38,537
Georgia,Ambrose,354,64,127,17,1,37,246
Hawaii,Napili-Honokowai,7258,2099,2787,591,66,445,5988
Hawaii,Laie,6111,2589,2047,163,0,115,4914
Hawaii,Kaneohe,33739,8402,14903,2213,287,2455,28260
Hawaii,Kailua CDP (Honolulu County),36662,8655,16716,3275,169,1901,30716
Hawaii,Kaaawa,1181,268,480,153,0,43,944
Hawaii,Makaha Valley,1636,490,443,167,24,52,1176
Hawaii,Hauula,3549,928,1266,245,52,112,2603
Hawaii,Koloa,2859,876,837,173,21,184,2091
Hawaii,Princeville,1952,246,1033,152,0,100,1531
Hawaii,Kekaha,3394,1038,1196,210,20,257,2721
Hawaii,Wailua Homesteads,5900,1452,2525,624,86,419,5106
Hawaii,Wailuku,17354,4193,6792,1747,284,708,13724
Hawaii,Waihee-Waiehu,8802,2821,3149,702,20,497,7189
Hawaii,Mokuleia,1807,479,824,132,54,44,1533
Hawaii,Ewa Gentry,25752,6384,10921,1582,227,837,19951
Hawaii,Waipio,11508,3180,4795,721,177,694,9567
Hawaii,Wheeler AFB,2391,289,1300,106,4,12,1711
Hawaii,Waimea CDP (Hawaii County),11687,2597,4880,713,102,681,8973
Hawaii,Kawela Bay,249,56,126,36,3,8,229
Hawaii,Punaluu,1186,294,470,66,0,72,902
Hawaii,Fern Forest,819,212,258,127,5,19,621
Hawaii,Kahuku,2245,502,914,145,3,77,1641
Hawaii,Pepeekeo,1536,422,510,167,25,152,1276
Hawaii,Haleiwa,4040,1041,1643,275,28,209,3196
Hawaii,Heeia,4669,823,2526,375,0,315,4039
Hawaii,Makaha,8740,2822,2562,786,199,422,6791
Hawaii,Waimalu,13384,3829,5283,1293,339,710,11454
Hawaii,Anahola,2175,728,739,115,13,209,1804
Hawaii,Eden Roc,799,225,189,171,16,47,648
Hawaii,Hawaiian Paradise Park,11479,2543,4977,1072,141,818,9551
Hawaii,Hilo,46284,14561,16390,3750,561,2926,38188
Hawaii,Kurtistown,1319,325,596,158,15,75,1169
Hawaii,Mountain View,3269,598,1209,410,53,179,2449
Hawaii,Hana,956,332,339,22,18,69,780
Hawaii,Kaanapali,922,86,659,113,2,29,889
Hawaii,Kilauea,2579,601,1063,238,45,82,2029
Hawaii,Pahala,1804,446,614,121,0,117,1298
Hawaii,Keaau,2493,866,901,168,16,141,2092
Hawaii,Kapaa,10544,2691,4575,887,23,603,8779
Hawaii,Haiku-Pauwela,8061,1783,3701,764,48,296,6592
Hawaii,Kahului,32312,8839,12272,2395,413,2039,25958
Hawaii,Mililani Town,27926,7153,12383,1813,269,1308,22926
Hawaii,Wahiawa,17422,4937,6453,1465,179,1043,14077
Hawaii,Honaunau-Napoopoo,2457,435,1226,259,0,194,2114
Hawaii,Kaunakakai,3719,866,1564,215,5,304,2954
Hawaii,Kapaau,1770,528,675,156,24,101,1484
Hawaii,Nanawale Estates,1995,519,702,217,43,86,1567
Hawaii,Papaikou,1052,271,349,79,5,80,784
Hawaii,Paukaa,569,163,234,44,4,71,516
Hawaii,Ewa Villages,7118,1532,2681,461,132,505,5311
Hawaii,Kihei,21879,5560,9030,2142,265,981,17978
Hawaii,Waikoloa Village,6412,1162,2690,652,82,204,4790
Hawaii,Halawa,14640,4705,5923,841,127,801,12397
Hawaii,Ewa Beach,14717,3841,5889,896,176,871,11673
Hawaii,Aiea,9439,2290,3813,700,93,593,7489
Hawaii,Ahuimanu,8239,2350,3698,448,79,443,7018
Hawaii,Kukuihaele,349,139,113,28,0,6,286
Hawaii,Kealakekua,1889,488,798,236,14,59,1595
Hawaii,Holualoa,9136,1720,4351,1127,22,327,7547
Hawaii,Hawaiian Ocean View,4891,1000,1544,380,135,211,3270
Hawaii,Fern Acres,1601,448,637,182,23,53,1343
Hawaii,Ainaloa,3342,1113,1016,333,92,136,2690
Hawaii,Schofield Barracks,19796,4730,8364,269,56,55,13474
Hawaii,Pahoa,896,281,330,83,9,64,767
Hawaii,Pearl City,46129,12417,20695,2640,429,2581,38762
Hawaii,Wailua,2742,725,982,274,27,166,2174
Hawaii,Puhi,3911,1003,1529,214,86,237,3069
Hawaii,Kalaheo,5224,1562,2142,364,0,258,4326
Hawaii,Hanamaulu,5422,1550,1987,419,17,250,4223
Hawaii,Waikapu,3483,845,1301,249,28,158,2581
Hawaii,Maunaloa,365,112,106,16,3,5,242
Hawaii,Pakala Village,294,103,92,3,5,45,248
Hawaii,Kahaluu,4339,1317,1743,328,25,312,3725
Hawaii,Paauilo,627,176,241,43,8,55,523
Hawaii,Lihue,7381,2140,2731,645,102,360,5978
Hawaii,Kahaluu-Keauhou,4002,814,1955,460,0,366,3595
Hawaii,Pukalani,7769,1975,3189,942,71,418,6595
Hawaii,Hanalei,267,51,101,30,0,13,195
Hawaii,Poipu,995,154,597,97,5,66,919
Hawaii,Waimea CDP (Kauai County),1952,596,815,139,33,136,1719
Hawaii,Hickam Housing,9258,1189,4657,89,2,18,5955
Hawaii,Iroquois Point,3550,516,1531,271,51,84,2453
Hawaii,Kaneohe Station,11075,3417,4734,143,10,3,8307
Hawaii,Maunawili,2023,365,1101,78,9,141,1694
Hawaii,Waimanalo Beach,3826,1071,1433,383,29,251,3167
Hawaii,Waipio Acres,5443,1559,2299,362,62,258,4540
Hawaii,Whitmore Village,4254,1249,1542,337,19,225,3372
Hawaii,Honomu,424,154,168,18,3,27,370
Hawaii,Kalaoa,11604,3160,5264,877,79,369,9749
Hawaii,Naalehu,972,314,293,53,11,130,801
Hawaii,Orchidlands Estates,3197,878,1145,357,38,73,2491
Hawaii,Paia,2412,789,799,217,12,63,1880
Hawaii,Volcano,3218,1084,1212,405,0,156,2857
Hawaii,Lanai City,2802,649,1217,209,43,302,2420
Hawaii,Puako,884,134,543,75,6,40,798
Hawaii,Kualapuu,1771,438,762,59,0,112,1371
Hawaii,Maalaea,221,31,112,49,4,24,220
Hawaii,Nanakuli,11742,3866,3399,807,149,638,8859
Hawaii,Pupukea,4613,1027,2010,371,29,216,3653
Hawaii,Waialua,3587,1002,1329,253,43,232,2859
Hawaii,Leilani Estates,1708,406,675,275,23,84,1463
Hawaii,Hawi,1312,476,483,76,0,50,1085
Hawaii,Wainaku,1358,346,560,132,46,103,1187
Hawaii,Eleele,2970,738,1212,147,49,125,2271
Hawaii,Waimanalo,6135,2030,1952,332,23,369,4706
Hawaii,Captain Cook,3987,835,1600,339,27,197,2998
Hawaii,Halaula,626,158,264,37,8,26,493
Hawaii,Honalo,2162,519,694,235,57,96,1601
Hawaii,Honokaa,2301,585,926,164,85,182,1942
Hawaii,Kailua CDP (Hawaii County),15268,4038,6107,1301,231,584,12261
Hawaii,Haliimaile,977,389,251,80,3,85,808
Hawaii,Omao,1445,339,570,146,17,109,1181
Hawaii,Hanapepe,2870,863,1262,144,18,122,2409
Hawaii,Kalihiwai,198,53,81,37,7,18,196
Hawaii,Olinda,920,258,339,139,7,51,794
Hawaii,Manele,24,0,22,0,0,2,24
Hawaii,Mililani Mauka,19955,4448,9341,1103,227,587,15706
Hawaii,Ocean Pointe,14037,2495,6516,672,86,387,10156
Hawaii,Olowalu,93,16,20,35,10,5,86
Hawaii,Royal Kunia,14449,3772,7075,452,65,472,11836
Hawaii,Urban Honolulu,350003,107635,137953,29536,3764,20752,299640
Hawaii,Waikele,7062,1601,3397,416,49,347,5810
Hawaii,Wailea,5656,1100,2877,583,116,258,4934
Hawaii,Wainiha,171,26,53,21,0,25,125
Hawaii,Waiohinu,290,123,100,11,0,13,247
Hawaii,West Loch Estate,5177,1331,2345,364,34,182,4256
Hawaii,Ualapue,368,106,152,27,10,17,312
Hawaii,Hawaiian Acres,2981,914,1114,309,108,84,2529
Hawaii,Hawaiian Beaches,4736,1303,1677,405,78,392,3855
Hawaii,Makena,168,17,94,25,0,7,143
Hawaii,Makakilo,20920,5264,8536,1678,194,636,16308
Hawaii,Mahinahina,954,119,563,50,0,22,754
Hawaii,Launiupoko,536,78,320,34,4,18,454
Hawaii,Maili,10792,2897,3786,813,152,397,8045
Hawaii,Waianae,14054,4685,4026,835,247,815,10608
Hawaii,Waikane,482,151,195,46,2,27,421
Hawaii,Waipahu,40427,11795,15472,2009,399,3148,32823
Hawaii,Kapalua,336,55,220,20,1,10,306
Hawaii,Lahaina,13103,3801,4889,888,328,554,10460
Hawaii,Kaumakani,874,228,315,119,0,78,740
Hawaii,Laupahoehoe,508,121,193,42,12,53,421
Hawaii,Lawai,2211,536,932,190,0,155,1813
Hawaii,East Honolulu,47770,9079,24395,3289,281,2787,39831
Hawaii,Haena,157,18,70,35,3,11,137
Hawaii,Kalaeloa,14,4,5,0,0,0,9
Hawaii,Kapolei,21474,5376,8129,1383,293,760,15941
Hawaii,Keokea,2251,462,1066,116,8,92,1744
Hawaii,Ko Olina,1625,314,945,102,46,4,1411
Hawaii,Kula,7541,1654,3709,810,35,246,6454
Hawaii,Discovery Harbour,1140,251,503,119,11,28,912
Hawaii,Makawao,7570,1717,3222,763,81,352,6135
Idaho,Teton,1163,149,474,39,65,32,759
Idaho,Parkline,50,0,22,17,0,6,45
Idaho,Grace,1118,113,623,72,0,74,882
Idaho,Bonners Ferry,2544,463,1103,401,19,165,2151
Idaho,Grangeville,3166,564,1243,532,15,231,2585
Idaho,Cottonwood,871,177,342,91,4,76,690
Idaho,St. Maries,2769,672,1079,341,42,212,2346
Idaho,Payette,7394,1706,3096,933,50,350,6135
Idaho,Bliss,352,84,131,43,7,19,284
Idaho,Dubois,701,190,304,50,0,24,568
Idaho,Fairfield,442,105,140,48,0,17,310
Idaho,Castleford,205,42,86,10,0,17,155
Idaho,Middleton,7115,1488,2700,527,68,214,4997
Idaho,Greenleaf,1298,240,555,89,15,33,932
Idaho,Mountain Home,13998,2734,5916,1454,229,520,10853
Idaho,Spencer,24,0,19,2,0,2,23
Idaho,Glenns Ferry,1319,137,490,200,15,121,963
Idaho,Declo,460,96,199,19,7,18,339
Idaho,Donnelly,58,19,28,6,0,1,54
Idaho,Rexburg,27957,7853,12999,657,15,438,21962
Idaho,Grand View,396,48,158,44,2,57,309
Idaho,Cambridge,220,43,105,28,0,31,207
Idaho,Kellogg,2442,566,856,336,33,98,1889
Idaho,Reubens,71,9,29,10,0,2,50
Idaho,Ashton,1029,174,446,89,19,66,794
Idaho,Idaho City,531,120,174,78,5,41,418
Idaho,Hazelton,739,188,295,63,9,25,580
Idaho,Elk River,135,5,83,28,1,12,129
Idaho,Lewiston,32604,7149,13571,3823,400,1941,26884
Idaho,Carey,714,202,260,61,0,38,561
Idaho,Rupert,5782,1152,2109,694,28,331,4314
Idaho,Pocatello,55162,14930,20038,5718,725,2329,43740
Idaho,Rockland,199,10,123,4,0,16,153
Idaho,New Plymouth,1506,265,561,221,10,97,1154
Idaho,Clark Fork,455,78,163,103,11,31,386
Idaho,St. Charles,129,9,73,7,0,6,95
Idaho,Bancroft,288,35,143,38,0,7,223
Idaho,Wilder,1666,411,591,113,37,49,1201
Idaho,Nampa,91663,21556,33996,9710,1126,3064,69452
Idaho,Inkom,868,106,371,105,0,38,620
Idaho,Arimo,344,35,179,13,0,12,239
Idaho,Minidoka,116,12,60,28,0,2,102
Idaho,Mackay,448,158,157,57,0,31,403
Idaho,Plummer,1230,315,324,149,27,60,875
Idaho,Salmon,3073,677,1274,355,37,263,2606
Idaho,Notus,628,157,315,43,0,3,518
Idaho,Caldwell,53205,11955,18483,4950,743,2095,38226
Idaho,Lewisville,433,100,228,31,11,7,377
Idaho,Kimberly,3759,614,1794,249,48,111,2816
Idaho,Paul,1212,293,568,51,8,57,977
Idaho,Tensed,130,56,24,13,2,10,105
Idaho,Downey,767,95,342,53,9,58,557
Idaho,Emmett,6670,1649,2061,812,106,449,5077
Idaho,Fruitland,5192,857,2027,694,15,289,3882
Idaho,Acequia,180,67,79,15,0,5,166
Idaho,Stites,227,25,109,32,10,24,200
Idaho,McCammon,731,65,376,52,18,42,553
Idaho,Hagerman,1103,150,448,136,32,65,831
Idaho,Gooding,3482,795,1117,541,43,301,2797
Idaho,Soda Springs,2997,505,1217,308,2,177,2209
Idaho,Filer,2736,374,1059,290,22,125,1870
Idaho,Mountain Home AFB,3150,579,1630,36,64,4,2313
Idaho,Moyie Springs,817,139,308,145,19,26,637
Idaho,Moscow,25174,11737,8005,1558,98,685,22083
Idaho,Tyhee,1266,206,599,98,10,32,945
Idaho,Rathdrum,7904,1198,3648,726,88,248,5908
Idaho,Dover,611,91,329,55,0,39,514
Idaho,Kooskia,575,63,248,112,2,60,485
Idaho,Lava Hot Springs,222,34,73,82,0,2,191
Idaho,Roberts,534,125,177,65,7,20,394
Idaho,Clayton,0,0,0,0,0,0,0
Idaho,Malta,184,52,106,3,0,17,178
Idaho,Melba,739,107,234,56,11,38,446
Idaho,Victor,2435,578,729,370,8,96,1781
Idaho,Banks,7,0,0,7,0,0,7
Idaho,Bennington,265,3,109,40,0,21,173
Idaho,Blanchard,181,0,115,19,10,37,181
Idaho,Conkling Park,67,0,64,0,0,3,67
Idaho,De Smet,163,79,11,20,0,9,119
Idaho,Garden Valley,422,142,154,50,0,0,346
Idaho,Menan,740,154,304,51,16,34,559
Idaho,Groveland,865,218,313,90,0,61,682
Idaho,Lowman,25,0,16,5,0,4,25
Idaho,Moreland,1507,317,593,62,48,70,1090
Idaho,Murphy,79,22,51,0,6,0,79
Idaho,Princeton,76,0,44,0,0,21,65
Idaho,Riverside,1156,117,523,126,0,19,785
Idaho,Robie Creek,1418,206,837,152,0,100,1295
Idaho,Rockford,215,57,110,0,0,0,167
Idaho,Rockford Bay,314,22,243,20,4,0,289
Idaho,Smiths Ferry,127,0,71,47,0,9,127
Idaho,Sweetwater,219,40,64,37,0,6,147
Idaho,Yellow Pine,0,0,0,0,0,0,0
Idaho,Hidden Springs,2764,553,1257,150,0,19,1979
Idaho,Elk City,83,19,21,11,0,32,83
Idaho,Lincoln,3748,464,1514,340,0,65,2383
Idaho,Wendell,2721,532,1118,167,28,112,1957
Idaho,Eagle,25075,4776,13453,1297,141,951,20618
Idaho,Orofino,3111,935,1036,523,33,166,2693
Idaho,Paris,587,57,302,54,2,31,446
Idaho,Bovill,298,42,156,27,2,17,244
Idaho,Stanley,91,67,5,14,0,0,86
Idaho,Hansen,1451,217,465,161,24,106,973
Idaho,Marsing,1382,296,428,138,23,78,963
Idaho,Weston,513,69,225,27,0,16,337
Idaho,Arco,667,116,249,109,16,72,562
Idaho,Mullan,782,130,338,52,8,43,571
Idaho,Kamiah,1249,192,469,189,16,106,972
Idaho,Lapwai,1305,460,306,133,13,51,963
Idaho,Culdesac,409,94,134,59,7,17,311
Idaho,Firth,498,101,205,48,5,24,383
Idaho,Fort Hall,3402,963,910,443,38,190,2544
Idaho,Shelley,4370,675,1786,253,126,91,2931
Idaho,Jerome,11503,2249,4289,877,159,415,7989
Idaho,Crouch,96,11,54,15,2,11,93
Idaho,St. Anthony,3507,801,1538,268,51,97,2755
Idaho,Smelterville,687,137,301,80,16,31,565
Idaho,Midvale,199,17,113,7,12,13,162
Idaho,Moore,155,30,55,23,2,26,136
Idaho,Dayton,577,88,205,38,0,18,349
Idaho,Burley,10373,2077,4253,996,33,342,7701
Idaho,Placerville,34,0,24,6,0,0,30
Idaho,Riggins,270,41,163,28,0,25,257
Idaho,Bloomington,202,37,97,11,0,13,158
Idaho,Fernan Lake Village,149,23,67,19,11,11,131
Idaho,Shoshone,1305,252,413,185,23,151,1024
Idaho,Irwin,217,22,128,25,2,8,185
Idaho,Cascade,664,121,213,89,1,78,502
Idaho,Dalton Gardens,2765,476,1495,174,5,148,2298
Idaho,Parker,278,70,136,22,0,17,245
Idaho,Hayden Lake,814,60,512,35,3,23,633
Idaho,Idaho Falls,60147,11744,24050,6109,1006,2619,45528
Idaho,Swan Valley,126,20,54,22,0,9,105
Idaho,McCall,3226,624,1400,484,88,28,2624
Idaho,Arbon Valley,835,177,303,132,8,66,686
Idaho,Parma,2109,424,856,285,18,96,1679
Idaho,Hollister,237,44,84,38,13,25,204
Idaho,Mud Lake,331,70,160,26,0,3,259
Idaho,Driggs,1938,557,715,96,10,84,1462
Idaho,New Meadows,501,95,145,65,0,51,356
Idaho,Georgetown,495,63,249,42,7,19,380
Idaho,Buhl,4345,736,1893,546,135,353,3663
Idaho,Hope,66,4,43,15,0,0,62
Idaho,Juliaetta,586,122,229,92,20,17,480
Idaho,Kendrick,333,56,156,36,7,12,267
Idaho,Onaway,181,19,118,7,0,12,156
Idaho,Weippe,451,62,217,49,8,40,376
Idaho,Drummond,2,0,0,0,0,2,2
Idaho,Kuna,18445,3641,7911,1113,85,194,12944
Idaho,Albion,339,67,157,28,0,6,258
Idaho,Ferdinand,141,35,60,22,0,4,121
Idaho,White Bird,50,0,10,22,0,18,50
Idaho,Sandpoint,8144,1712,3399,1117,86,511,6825
Idaho,Tetonia,435,105,181,37,22,4,349
Idaho,American Falls,4349,741,1795,464,7,298,3305
Idaho,Murtaugh,87,17,42,13,0,7,79
Idaho,Kootenai,960,192,326,136,8,60,722
Idaho,East Hope,124,2,73,22,0,20,117
Idaho,Montpelier,2507,512,1172,198,9,123,2014
Idaho,Sugar City,1649,405,606,66,8,39,1124
Idaho,Osburn,1490,206,709,174,0,115,1204
Idaho,Wallace,895,210,336,189,15,25,775
Idaho,Butte City,76,5,40,22,3,4,74
Idaho,Hayden,14380,3142,6671,1426,200,739,12178
Idaho,Deary,308,46,153,33,2,23,257
Idaho,Troy,911,114,451,62,0,30,657
Idaho,Eden,379,109,143,22,14,28,316
Idaho,Horseshoe Bend,780,187,369,82,8,30,676
Idaho,Newdale,357,57,193,29,0,3,282
Idaho,Ketchum,2761,624,1395,333,0,125,2477
Idaho,Sun Valley,1445,408,713,171,9,89,1390
Idaho,Iona,2451,374,1173,125,0,62,1734
Idaho,Nezperce,512,119,224,45,4,32,424
Idaho,Pinehurst,1402,213,663,199,20,130,1225
Idaho,Wardner,214,41,81,27,4,15,168
Idaho,Weiser,5326,1024,1893,763,188,274,4142
Idaho,Homedale,2605,657,915,257,53,198,2080
Idaho,Rigby,4051,632,1551,326,91,107,2707
Idaho,Leadore,89,34,33,5,0,4,76
Idaho,Ammon,15403,2217,6916,1049,155,599,10936
Idaho,Oakley,920,124,421,37,6,30,618
Idaho,Winchester,290,33,145,42,2,23,245
Idaho,Warm River,0,0,0,0,0,0,0
Idaho,Malad City,2136,365,888,224,38,159,1674
Idaho,Clifton,314,30,116,5,1,22,174
Idaho,Preston,5311,727,2719,304,55,224,4029
Idaho,Twin Falls,48225,9664,19114,5092,771,2005,36646
Idaho,Chubbuck,14728,2347,6684,1233,26,399,10689
Idaho,Dietrich,304,15,157,21,0,23,216
Idaho,Richfield,473,108,181,58,2,21,370
Idaho,Oldtown,217,41,65,51,0,21,178
Idaho,Lost River,0,0,0,0,0,0,0
Idaho,Coeur d'Alene,49609,12043,18792,6651,447,2416,40349
Idaho,Hauser,960,243,363,119,14,14,753
Idaho,Spirit Lake,2228,401,1091,241,20,75,1828
Idaho,Genesee,951,189,495,64,2,11,761
Idaho,Hailey,8259,1539,3742,748,58,181,6268
Idaho,Island Park,184,16,117,27,0,14,174
Idaho,Potlatch,750,127,313,56,17,66,579
Idaho,Heyburn,3271,643,1186,378,15,88,2310
Idaho,Star,8495,1721,3607,680,2,185,6195
Idaho,Garden City,11743,2676,4769,1686,128,672,9931
Idaho,Craigmont,509,73,263,72,2,31,441
Idaho,Meridian,97008,19839,42849,7419,514,3356,73977
Idaho,Council,872,93,395,134,0,67,689
Idaho,Ucon,1361,280,550,81,0,76,987
Idaho,Boise City,224300,63305,85058,24694,1997,8035,183089
Idaho,Franklin,631,117,284,77,0,14,492
Idaho,Hamer,77,25,30,1,0,2,58
Idaho,Ririe,628,150,232,91,0,6,479
Idaho,Basalt,395,66,191,29,0,14,300
Idaho,Blackfoot,11854,2251,4577,1522,50,446,8846
Idaho,Priest River,1888,251,704,285,41,119,1400
Idaho,Challis,797,153,263,182,17,9,624
Idaho,State Line,7,7,0,0,0,0,7
Idaho,Worley,285,92,89,38,4,8,231
Idaho,Oxford,56,4,14,8,0,0,26
Idaho,Ponderay,1179,248,330,225,18,109,930
Idaho,Atomic City,50,3,3,34,2,8,50
Idaho,Athol,1037,165,483,110,28,41,827
Idaho,Harrison,260,41,125,45,0,14,225
Idaho,Post Falls,31945,6139,12662,3747,205,1285,24038
Idaho,Aberdeen,2169,463,689,179,22,144,1497
Idaho,Pierce,486,52,251,40,4,40,387
Idaho,Bellevue,2715,668,1152,192,4,127,2143
Idaho,Peck,145,25,71,17,0,9,122
Idaho,Huetter,165,63,34,33,0,8,138
Illinois,Summit village,11340,3406,3895,525,107,357,8290
Illinois,Streator,12791,3472,4354,1651,147,978,10602
Illinois,Elsah village,704,588,74,13,0,16,691
Illinois,St. Peter village,444,69,197,25,3,29,323
Illinois,Campus village,181,32,77,23,6,1,139
Illinois,Williamson village,198,28,85,21,7,13,154
Illinois,Berlin village,205,53,97,8,3,18,179
Illinois,Shabbona village,996,220,386,134,26,125,891
Illinois,Pinckneyville,5463,2412,1561,527,97,257,4854
Illinois,New Athens village,2239,593,927,169,21,123,1833
Illinois,Peoria,114512,36639,36279,11146,1338,5311,90713
Illinois,Fairview Heights,16360,4584,6666,1617,256,790,13913
Illinois,Albers village,1184,239,550,70,0,29,888
Illinois,Aviston village,2166,523,976,134,3,133,1769
Illinois,Beckemeyer village,1024,264,437,57,0,52,810
Illinois,Riverside village,8810,2195,3955,534,136,328,7148
Illinois,South Chicago Heights village,4105,1422,1077,427,50,241,3217
Illinois,West Point village,139,27,59,19,0,4,109
Illinois,Stickney village,6732,1986,2134,699,179,290,5288
Illinois,Chillicothe,6135,1292,2453,587,79,415,4826
Illinois,Ellisville village,96,35,23,9,0,7,74
Illinois,Hutsonville village,503,97,189,57,9,21,373
Illinois,New Grand Chain village,189,49,65,19,3,12,148
Illinois,Simpson village,72,9,27,4,0,4,44
Illinois,Lebanon,4256,1328,1503,388,36,283,3538
Illinois,Northlake,12351,3548,4383,878,139,595,9543
Illinois,Bridgeport,1957,290,811,214,32,139,1486
Illinois,Byron,3608,770,1436,316,9,239,2770
Illinois,Berwyn,55949,17380,19142,3971,1455,2153,44101
Illinois,Gilberts village,7742,1307,3199,445,0,246,5197
Illinois,Davis village,548,109,254,40,7,32,442
Illinois,Stockton village,2027,543,614,249,30,151,1587
Illinois,Heyworth village,3164,753,1345,232,3,172,2505
Illinois,Nebo village,301,66,103,49,2,31,251
Illinois,Saunemin village,376,61,186,29,0,16,292
Illinois,Country Club Hills,16801,6289,4593,1629,221,1131,13863
Illinois,Sparland village,347,77,129,57,4,32,299
Illinois,Iroquois village,177,46,64,24,0,25,159
Illinois,Joppa village,313,74,110,36,12,11,243
Illinois,Wauconda village,13754,2892,6235,1156,120,460,10863
Illinois,Stonington village,906,188,406,94,3,47,738
Illinois,Capron village,1483,424,452,166,12,40,1094
Illinois,Alsey village,145,19,67,7,3,20,116
Illinois,Knoxville,2988,704,1209,167,62,247,2389
Illinois,Banner village,223,43,104,25,7,8,187
Illinois,Burnt Prairie village,58,6,30,3,0,1,40
Illinois,Lewistown,2349,518,983,250,34,163,1948
Illinois,Eagarville village,154,40,47,18,0,12,117
Illinois,Owaneco village,228,43,110,27,3,4,187
Illinois,Henning village,246,20,127,19,1,11,178
Illinois,Allerton village,312,65,150,31,0,12,258
Illinois,Parkersburg village,198,40,82,24,10,4,160
Illinois,Belgium village,392,115,116,78,7,16,332
Illinois,Rankin village,563,119,214,47,10,42,432
Illinois,Toulon,1276,240,476,159,18,140,1033
Illinois,Eddyville village,77,16,16,6,6,14,58
Illinois,Bushnell,2776,600,1184,253,100,152,2289
Illinois,Industry village,392,90,175,38,5,23,331
Illinois,Cherry Valley village,2895,608,1299,311,50,194,2462
Illinois,Rock Island Arsenal,5,5,0,0,0,0,5
Illinois,Morrisonville village,1167,195,554,118,13,27,907
Illinois,New Berlin village,1553,266,669,155,17,37,1144
Illinois,Millington village,651,127,322,52,0,14,515
Illinois,Bunker Hill,1684,413,627,279,19,126,1464
Illinois,Prospect Heights,16250,3402,7226,1156,289,786,12859
Illinois,Kinmundy,904,188,327,116,12,69,712
Illinois,Carlinville,5610,1549,1809,703,42,280,4383
Illinois,Williamsfield village,461,100,217,34,0,44,395
Illinois,Mill Shoals village,194,36,89,28,1,13,167
Illinois,Morton Grove village,23256,5015,11926,1096,191,1512,19740
Illinois,Liverpool village,142,25,63,32,0,12,132
Illinois,Lawrenceville,4417,828,1844,556,73,311,3612
Illinois,Hopewell village,424,68,253,39,3,9,372
Illinois,Toluca,1344,308,537,172,11,140,1168
Illinois,Eldorado,4240,898,1569,480,128,376,3451
Illinois,Wenona,1026,247,398,63,7,85,800
Illinois,Oregon,3683,803,1494,452,44,212,3005
Illinois,Rochelle,9196,1919,3674,967,85,601,7246
Illinois,Du Bois village,150,29,73,18,2,18,140
Illinois,Bryant village,230,48,97,37,1,12,195
Illinois,Crestwood village,10901,3561,3596,1103,151,1223,9634
Illinois,Hometown,4308,1214,1401,531,13,407,3566
Illinois,Palos Park village,4907,823,2355,456,12,381,4027
Illinois,Alexis village,885,208,359,44,16,80,707
Illinois,Virginia,1323,245,497,190,9,99,1040
Illinois,Lyons village,10566,3303,3748,888,20,397,8356
Illinois,Indian Head Park village,3812,760,1654,458,25,313,3210
Illinois,La Grange village,15632,3417,6739,955,118,634,11863
Illinois,Lynwood village,9316,3020,3262,827,412,212,7733
Illinois,Midlothian village,14718,4510,5492,1364,218,610,12194
Illinois,Golf village,565,93,288,4,0,10,395
Illinois,Norwood village,430,100,159,58,5,24,346
Illinois,Clifton village,1373,334,563,97,15,44,1053
Illinois,Piper City village,862,231,348,66,27,62,734
Illinois,Cornland,61,0,53,8,0,0,61
Illinois,Crab Orchard,232,38,120,38,0,3,199
Illinois,Darmstadt,0,0,0,0,0,0,0
Illinois,Dayton,531,199,236,60,7,13,515
Illinois,Floraville,33,0,0,17,0,16,33
Illinois,Georgetown,501,103,119,79,0,65,366
Illinois,Gilson,158,19,82,43,0,0,144
Illinois,Goofy Ridge,233,68,27,67,10,40,212
Illinois,Grand Detour,484,15,312,22,0,39,388
Illinois,Harrison,766,280,227,32,30,59,628
Illinois,Heritage Lake,1514,286,803,67,0,84,1240
Illinois,Holiday Shores,2613,603,1414,228,0,68,2313
Illinois,Knollwood,1820,533,711,138,7,92,1481
Illinois,Lake Camelot,1834,214,1045,78,0,21,1358
Illinois,Lake Holiday,4534,799,2558,270,0,64,3691
Illinois,Lake Petersburg,553,7,414,45,0,87,553
Illinois,Langleyville,375,14,218,56,0,15,303
Illinois,LaPlace,142,24,71,17,0,17,129
Illinois,Lost Nation,651,30,522,0,0,73,625
Illinois,Como,607,87,404,12,10,39,552
Illinois,Chestnut,83,16,35,0,2,6,59
Illinois,Chemung,619,174,130,47,0,28,379
Illinois,Boody,237,85,56,67,0,0,208
Illinois,Millbrook village,337,82,177,22,0,21,302
Illinois,Monroe Center village,402,67,215,32,0,12,326
Illinois,Havana,3232,624,1232,380,76,283,2595
Illinois,New Milford village,682,166,294,68,8,35,571
Illinois,Port Barrington village,1514,306,786,82,20,37,1231
Illinois,Curran village,252,43,106,29,0,24,202
Illinois,McClure village,348,71,104,53,9,15,252
Illinois,Campton Hills village,11348,1995,5771,629,42,337,8774
Illinois,Kaneville village,375,73,176,42,0,31,322
Illinois,Lovington village,1117,221,511,71,4,86,893
Illinois,Limestone village,1576,387,675,116,2,90,1270
Illinois,Sammons Point village,267,62,117,26,2,7,214
Illinois,Alvan village,312,68,138,28,3,20,257
Illinois,Gibson City,3328,775,1313,372,0,240,2700
Illinois,Lake Ka-Ho village,218,28,79,47,19,10,183
Illinois,Astoria,907,203,285,115,13,90,706
Illinois,Adair,201,17,161,0,0,16,194
Illinois,Annapolis,43,4,29,0,0,0,33
Illinois,Apple Canyon Lake,429,51,301,19,6,17,394
Illinois,Beason,202,35,83,31,0,0,149
Illinois,Plattville village,279,75,110,7,2,17,211
Illinois,East St. Louis,26647,11232,3693,2902,966,1959,20752
Illinois,Sauget village,182,54,61,30,2,15,162
Illinois,Watseka,5202,1198,1914,707,23,573,4415
Illinois,Ridge Farm village,904,213,366,129,20,26,754
Illinois,Belle Rive village,306,59,153,34,1,17,264
Illinois,Tilton village,2621,454,1104,272,10,248,2088
Illinois,Kincaid village,1596,399,648,211,26,90,1374
Illinois,Albion,2034,397,748,278,23,166,1612
Illinois,Nelson village,137,24,45,27,2,11,109
Illinois,West Brooklyn village,133,28,61,16,1,6,112
Illinois,Illiopolis village,890,181,396,65,7,42,691
Illinois,Southern View village,1635,480,489,293,28,132,1422
Illinois,Jerome village,1883,470,738,299,12,115,1634
Illinois,Springfield,116459,34996,38967,13589,1559,6216,95327
Illinois,Lanark,1562,286,667,136,16,85,1190
Illinois,Milledgeville village,1072,329,395,148,7,49,928
Illinois,Kenney village,338,76,156,37,0,32,301
Illinois,Verona village,255,59,104,24,1,7,195
Illinois,Charleston,20632,9888,5380,1703,138,889,17998
Illinois,Christopher,2725,536,913,369,36,207,2061
Illinois,Mendota,7035,1943,2646,612,96,419,5716
Illinois,Seneca village,2596,585,1012,262,84,88,2031
Illinois,Teutopolis village,1837,384,908,72,6,72,1442
Illinois,Virden,3506,775,1391,402,17,268,2853
Illinois,LaSalle,9305,2406,3038,1210,93,555,7302
Illinois,Steward village,318,68,125,52,0,15,260
Illinois,Panola village,26,0,19,0,0,0,19
Illinois,Wellington village,264,50,85,28,0,35,198
Illinois,Stonefort village,346,80,120,23,2,18,243
Illinois,Bement village,1502,315,677,178,6,107,1283
Illinois,Mansfield village,942,171,492,126,7,44,840
Illinois,Malta village,1080,194,474,109,35,46,858
Illinois,Sycamore,17725,4436,6863,1911,179,798,14187
Illinois,White Hall,2321,506,786,476,10,254,2032
Illinois,Wilmington village,113,30,38,23,0,10,101
Illinois,Media village,104,13,41,20,2,3,79
Illinois,Mount Vernon,14804,3952,4610,1946,279,1138,11925
Illinois,Willisville village,644,178,185,88,14,25,490
Illinois,Dallas City,944,170,418,145,13,74,820
Illinois,Argenta village,1140,238,462,90,15,40,845
Illinois,Maroa,1674,330,679,184,22,91,1306
Illinois,Ellis Grove village,292,51,105,40,3,30,229
Illinois,Willowbrook,2082,509,1039,189,25,91,1853
Illinois,Hollowayville village,61,26,22,4,8,0,60
Illinois,Cedarville village,648,114,374,64,1,14,567
Illinois,Rock City village,296,69,119,13,2,9,212
Illinois,Minonk,2208,471,916,158,5,215,1765
Illinois,Shumway village,156,52,60,12,0,7,131
Illinois,Easton village,297,36,158,23,1,19,237
Illinois,Homer Glen village,24467,4974,12857,1234,65,1000,20130
Illinois,Stronghurst village,932,167,411,74,7,74,733
Illinois,Coalton village,334,55,164,35,4,18,276
Illinois,Wonder Lake village,4219,935,1833,228,12,191,3199
Illinois,Oakwood Hills village,2245,574,1047,194,15,33,1863
Illinois,Lakemoor village,6171,1519,2660,396,96,130,4801
Illinois,St. Charles,32772,7494,14835,2814,245,1648,27036
Illinois,Pingree Grove village,7337,1029,3530,486,0,133,5178
Illinois,Algonquin village,30709,6604,14900,2040,198,1152,24894
Illinois,Washington,16556,2859,7798,898,133,954,12642
Illinois,Marine village,947,173,472,78,3,54,780
Illinois,Livingston village,765,131,376,92,2,80,681
Illinois,Grantfork village,343,59,174,20,1,11,265
Illinois,Zion,24047,7696,7344,1883,321,949,18193
Illinois,Waukegan,87571,27693,28753,6448,1580,2557,67031
Illinois,Volo village,4750,748,1796,460,39,260,3303
Illinois,North Chicago,30011,14926,7704,1659,435,688,25412
Illinois,Mettawa village,545,91,310,37,10,26,474
Illinois,Third Lake village,1133,266,607,51,0,31,955
Illinois,Libertyville village,20480,4174,10112,1232,81,983,16582
Illinois,Hawthorn Woods village,8047,1396,4514,178,0,261,6349
Illinois,Farmersville village,667,183,308,41,0,31,563
Illinois,Irving village,326,79,116,61,4,21,281
Illinois,Waggoner village,187,48,53,23,2,4,130
Illinois,Olmsted village,489,73,178,73,12,20,356
Illinois,Leonore village,69,5,30,9,0,8,52
Illinois,Paxton,4279,907,1590,463,62,363,3385
Illinois,Sorento village,467,49,164,88,29,45,375
Illinois,Pocahontas village,733,206,273,79,11,36,605
Illinois,Oakford village,354,82,126,44,3,30,285
Illinois,Rome,1664,242,877,186,8,75,1388
Illinois,Dunlap village,1160,257,543,85,0,19,904
Illinois,Brimfield village,965,308,316,92,4,54,774
Illinois,Kilbourne village,322,78,108,60,1,30,277
Illinois,Lake Catherine,1439,298,534,196,51,149,1228
Illinois,Strawn village,94,27,37,9,5,5,83
Illinois,Grafton,757,162,370,80,3,32,647
Illinois,Hillview village,155,32,48,30,2,1,113
Illinois,Greenfield,1323,349,421,123,39,99,1031
Illinois,Thawville village,236,64,57,27,0,24,172
Illinois,Winchester,1898,406,727,233,46,123,1535
Illinois,Keyesport village,399,93,149,55,0,16,313
Illinois,Bay View Gardens village,408,121,145,47,0,27,340
Illinois,Lena village,2873,580,1331,302,25,171,2409
Illinois,German Valley village,564,103,275,29,5,18,430
Illinois,Flanagan village,1013,201,346,116,5,156,824
Illinois,Grandwood Park,5261,1156,2643,162,62,60,4083
Illinois,Buffalo Grove village,41329,7511,21402,2779,199,1788,33679
Illinois,Bannockburn village,1325,786,372,19,0,21,1198
Illinois,East Cape Girardeau village,517,60,182,43,8,49,342
Illinois,Sparta,4384,1304,1603,502,77,387,3873
Illinois,Reynolds village,506,97,248,38,2,30,415
Illinois,Oak Grove village,589,106,158,123,8,29,424
Illinois,South Roxana village,2172,646,564,219,55,136,1620
Illinois,Vernon Hills village,26259,5239,12265,1889,262,1076,20731
Illinois,Round Lake Park village,8057,1614,3474,483,76,818,6465
Illinois,Round Lake Beach village,27692,7624,10913,1904,241,788,21470
Illinois,Moline,42364,10159,16541,4446,581,2402,34129
Illinois,Brownstown village,933,260,293,99,19,51,722
Illinois,Cordova village,705,150,337,70,0,51,608
Illinois,Hartford village,1688,392,609,153,15,78,1247
Illinois,Granite City,29001,7199,10724,3263,634,1938,23758
Illinois,Worden village,1106,268,383,155,13,36,855
Illinois,Sibley village,300,40,157,29,8,21,255
Illinois,Louisville village,1096,228,489,172,8,32,929
Illinois,Anna,4232,1131,1512,478,21,328,3470
Illinois,Steeleville village,2284,557,835,283,28,164,1867
Illinois,Red Bud,3557,606,1639,336,15,220,2816
Illinois,Manito village,1513,301,649,153,27,91,1221
Illinois,Troy,10356,2014,4742,844,121,428,8149
Illinois,Big Rock village,1318,273,730,73,0,13,1089
Illinois,Ramsey village,1063,279,342,165,0,60,846
Illinois,Cissna Park village,778,129,337,89,2,46,603
Illinois,Cooksville village,169,22,79,22,2,16,141
Illinois,Bellflower village,386,45,183,59,4,22,313
Illinois,Chebanse village,1138,232,475,104,17,35,863
Illinois,Colp village,318,60,88,62,1,14,225
Illinois,Coyne Center,922,194,500,87,0,31,812
Illinois,Andalusia village,1113,246,551,111,18,25,951
Illinois,Maryville village,7955,1433,3853,700,78,674,6738
Illinois,Carbon Hill village,311,66,132,36,3,15,252
Illinois,Browning village,130,30,52,9,0,5,96
Illinois,Buckley village,539,122,240,81,0,28,471
Illinois,New Douglas village,344,37,145,28,10,20,240
Illinois,Metropolis,6184,1308,2203,690,90,664,4955
Illinois,Pontiac,11804,3528,3819,1540,177,719,9783
Illinois,Long Point village,237,43,96,20,4,13,176
Illinois,Dwight village,4130,1053,1703,346,46,316,3464
Illinois,Otterville,126,18,51,12,0,1,82
Illinois,Rockbridge village,173,37,46,10,6,17,116
Illinois,Kane village,285,54,89,58,16,13,230
Illinois,Monticello,5809,949,2773,544,50,334,4650
Illinois,Cambria village,1248,380,341,136,25,55,937
Illinois,Cutler village,384,89,135,50,4,28,306
Illinois,Burnham village,4189,1820,926,370,104,202,3422
Illinois,Melvin village,516,72,201,58,9,35,375
Illinois,Iola village,138,30,54,14,0,3,101
Illinois,Metcalf village,180,43,60,19,4,14,140
Illinois,Vermilion village,245,70,88,31,0,12,201
Illinois,Taylorville,10964,2613,4274,1481,86,849,9303
Illinois,Bone Gap village,187,47,77,10,2,16,152
Illinois,Browns village,129,20,69,19,1,4,113
Illinois,Bentley,20,4,11,2,0,1,18
Illinois,Schaumburg village,74569,17518,33899,5419,810,3373,61019
Illinois,Addison village,37089,9928,14891,2731,388,1541,29479
Illinois,Elmhurst,46331,10246,21032,2340,329,2236,36183
Illinois,Bradley village,15428,3938,5676,1512,167,865,12158
Illinois,Willowbrook village,8576,2051,4010,877,92,546,7576
Illinois,Kankakee,25884,9421,6843,2086,531,1442,20323
Illinois,Chrisman,1306,223,613,121,12,153,1122
Illinois,Momence,3146,1026,1061,322,25,165,2599
Illinois,Ellsworth village,243,48,98,33,10,16,205
Illinois,Concord village,183,29,85,11,2,16,143
Illinois,South Jacksonville village,3194,673,1395,294,84,131,2577
Illinois,Granville village,1232,291,491,192,12,83,1069
Illinois,Maunie village,175,54,72,24,0,8,158
Illinois,Norris City village,1216,240,459,157,10,74,940
Illinois,Tampico village,735,167,299,68,4,56,594
Illinois,Crescent City village,634,160,250,62,4,45,521
Illinois,Martinton village,356,85,146,30,2,9,272
Illinois,Pittsburg village,571,99,303,49,5,21,477
Illinois,St. Elmo,1297,272,519,144,5,126,1066
Illinois,Bishop Hill village,114,17,62,13,5,8,105
Illinois,Union Hill village,58,6,25,0,0,1,32
Illinois,Brookfield village,18858,4591,7814,1465,134,893,14897
Illinois,Spillertown village,272,56,111,23,5,8,203
Illinois,Gilman,1824,330,813,143,33,154,1473
Illinois,Vernon village,101,24,46,5,4,11,90
Illinois,New Boston,519,84,240,72,0,27,423
Illinois,Seaton village,217,43,101,16,8,8,176
Illinois,Griggsville,1465,293,657,94,6,74,1124
Illinois,New Salem village,265,60,122,28,0,18,228
Illinois,Windsor,1256,235,486,117,13,114,965
Illinois,Channahon village,12718,2177,6118,855,96,301,9547
Illinois,Albany village,979,159,470,61,7,99,796
Illinois,Countryside,5997,1622,1941,803,155,324,4845
Illinois,Carthage,2466,475,1027,273,21,233,2029
Illinois,La Harpe,1411,257,634,122,10,109,1132
Illinois,Nauvoo,1146,212,532,100,26,43,913
Illinois,Energy village,1138,186,552,162,15,113,1028
Illinois,Pontoosuc village,94,26,33,18,4,4,85
Illinois,Wapella village,600,144,231,62,20,42,499
Illinois,Mazon village,1002,266,414,84,3,38,805
Illinois,Huey village,211,44,94,46,0,5,189
Illinois,Naples,78,12,26,28,0,2,68
Illinois,Beaverville village,340,66,142,45,2,32,287
Illinois,Newman,774,144,313,117,17,58,649
Illinois,Macedonia village,46,9,27,5,0,0,41
Illinois,Good Hope village,420,88,182,38,9,23,340
Illinois,Chapin village,458,107,167,74,3,23,374
Illinois,Carterville,5848,1299,2382,474,47,337,4539
Illinois,Danforth village,632,120,236,65,19,99,539
Illinois,Donovan village,239,55,96,29,6,11,197
Illinois,Shannon village,761,178,343,37,15,52,625
Illinois,Calumet City,36856,13430,8862,3472,1132,2561,29457
Illinois,Hickory Hills,14018,3665,5861,1076,140,614,11356
Illinois,Melrose Park village,25311,7961,8366,1377,403,987,19094
Illinois,Silvis,7553,2044,2520,771,119,536,5990
Illinois,East Peoria,22876,4809,10374,2419,199,1590,19391
Illinois,Keensburg village,74,5,63,1,0,5,74
Illinois,Lake Barrington village,5069,636,2856,551,59,383,4485
Illinois,Magnolia village,336,74,110,42,11,20,257
Illinois,Hinsdale village,17654,3219,8660,700,89,636,13304
Illinois,Warrenville,13311,3660,5537,1221,154,355,10927
Illinois,Rosiclare,836,156,324,102,16,71,669
Illinois,Cabery village,259,85,90,25,2,13,215
Illinois,Essex village,899,162,437,63,6,23,691
Illinois,Grant Park village,1313,285,651,70,18,60,1084
Illinois,Colfax village,1135,231,398,177,6,83,895
Illinois,Rock Island,38354,12284,12528,4175,540,2083,31610
Illinois,Stanford village,712,179,291,67,9,17,563
Illinois,Hopedale village,911,162,417,72,0,138,789
Illinois,Marquette Heights,2553,610,1077,224,23,100,2034
Illinois,Carpentersville village,38138,10371,14151,1897,503,1024,27946
Illinois,North Aurora village,17653,4119,7760,1593,169,614,14255
Illinois,Fox River Grove village,4899,1280,2148,487,15,70,4000
Illinois,Hebron village,1384,318,592,109,7,43,1069
Illinois,Johnsburg village,6333,1407,3154,379,51,256,5247
Illinois,Union village,509,112,241,23,0,25,401
Illinois,Harvel village,235,53,110,15,4,5,187
Illinois,Ullin village,444,112,145,62,1,44,364
Illinois,Sun River Terrace village,422,121,73,47,9,24,274
Illinois,Chenoa,2037,535,889,159,21,77,1681
Illinois,Murrayville village,526,87,265,42,17,29,440
Illinois,Mount Carmel,7040,1227,3247,840,102,468,5884
Illinois,Kampsville village,372,67,180,22,7,8,284
Illinois,Grand Tower,482,76,191,98,22,47,434
Illinois,Palos Hills,17443,4335,6847,1629,186,1269,14266
Illinois,Richton Park village,13629,5103,3622,1481,388,740,11334
Illinois,Merrionette Park village,2163,620,751,220,29,96,1716
Illinois,Niles village,29640,7817,12603,2053,339,2785,25597
Illinois,Oak Lawn village,56420,15285,22031,4715,579,3702,46312
Illinois,Phoenix village,2020,710,390,227,58,173,1558
Illinois,Schiller Park village,11704,3350,5186,918,83,401,9938
Illinois,Stone Park village,4923,1592,1641,276,121,85,3715
Illinois,Thornton village,2478,841,967,155,21,202,2186
Illinois,Worth village,10728,2850,4052,1384,214,459,8959
Illinois,Arcola,2680,655,891,326,75,117,2064
Illinois,Broughton village,144,35,35,27,6,1,104
Illinois,Plymouth village,442,73,196,67,12,33,381
Illinois,Durand village,1379,281,623,137,3,99,1143
Illinois,Machesney Park village,22906,5681,9936,2047,230,910,18804
Illinois,Plainville village,333,67,119,51,6,18,261
Illinois,Oak Park village,52225,14254,20953,4207,542,1841,41797
Illinois,Hennepin village,792,180,356,70,19,58,683
Illinois,Inverness village,7747,1327,4329,420,31,574,6681
Illinois,Markham,12600,4600,2658,1034,311,981,9584
Illinois,Robbins village,5003,2344,798,321,255,251,3969
Illinois,Westchester village,16573,3975,7645,1167,130,1035,13952
Illinois,Beardstown,5902,1543,1993,606,64,367,4573
Illinois,Chandlerville village,452,82,170,62,5,29,348
Illinois,De Land village,369,77,152,54,3,23,309
Illinois,Batchtown village,199,16,112,34,0,11,173
Illinois,Zeigler,1836,533,498,185,51,166,1433
Illinois,Roberts village,446,107,144,44,15,26,336
Illinois,Germantown village,1180,322,480,99,3,66,970
Illinois,Carlyle,3285,830,1292,444,32,232,2830
Illinois,Summerfield village,405,79,125,52,7,34,297
Illinois,McLean village,793,167,365,60,18,55,665
Illinois,Saybrook village,775,124,322,78,12,43,579
Illinois,Jacksonville,18914,6286,5885,2553,240,1330,16294
Illinois,Bartlett village,41316,8523,20811,1535,462,1534,32865
Illinois,Elgin,113023,30866,44509,7368,1820,3815,88378
Illinois,Lexington,1890,381,903,192,5,70,1551
Illinois,West Chicago,27328,7261,11197,1378,378,736,20950
Illinois,Irwin village,53,13,15,5,0,4,37
Illinois,Bloomington,78331,22083,31436,6206,773,3182,63680
Illinois,Assumption,1142,247,379,127,28,111,892
Illinois,Clinton,7126,1530,2895,877,53,443,5798
Illinois,Lyndon village,638,122,279,62,21,11,495
Illinois,Collinsville,24756,6050,10087,2527,416,1324,20404
Illinois,Redmon village,145,32,73,21,0,14,140
Illinois,Nason,236,60,73,41,8,22,204
Illinois,Pana,5478,1177,2005,635,69,434,4320
Illinois,Ashmore village,814,149,340,110,10,67,676
Illinois,Bonnie village,323,44,142,47,0,21,254
Illinois,Grandview village,1453,436,408,232,25,72,1173
Illinois,Riverton village,3443,910,1096,469,27,109,2611
Illinois,Spaulding village,950,200,500,58,6,34,798
Illinois,Williamsville village,1423,294,635,125,7,53,1114
Illinois,New Bedford village,67,16,32,7,0,6,61
Illinois,Ohio village,513,143,224,49,5,27,448
Illinois,Frankfort village,18850,3757,9780,571,81,650,14839
Illinois,Lockport,25226,5334,10969,2232,87,977,19599
Illinois,Jeisyville village,72,12,39,4,0,5,60
Illinois,Bethany village,1204,154,608,128,12,94,996
Illinois,Sandwich,7617,2190,2579,901,81,385,6136
Illinois,Newark village,1219,290,512,71,15,52,940
Illinois,Carbon Cliff village,1893,429,663,184,34,103,1413
Illinois,Coal Valley village,3635,609,1839,438,44,171,3101
Illinois,Wheeling village,38424,9631,16198,3168,521,1844,31362
Illinois,Godfrey village,17685,3120,8456,1667,165,1225,14633
Illinois,Hampton village,2002,445,937,146,11,98,1637
Illinois,Milan village,5084,1109,1814,877,54,404,4258
Illinois,Le Roy,3576,712,1584,310,9,265,2880
Illinois,Clarendon Hills village,8711,1461,4118,473,46,368,6466
Illinois,Glen Ellyn village,27958,5606,13575,1384,92,1269,21926
Illinois,Itasca village,9042,1944,4372,688,99,476,7579
Illinois,Normal,54808,24266,16995,3362,242,1496,46361
Illinois,Franklin village,626,117,256,88,9,25,495
Illinois,Buda village,641,151,239,75,7,49,521
Illinois,Ladd village,1185,277,567,117,14,57,1032
Illinois,Seatonville village,341,49,167,12,7,21,256
Illinois,Sheffield village,826,163,376,101,6,45,691
Illinois,Loraine village,331,40,138,40,2,32,252
Illinois,DeKalb,42839,21547,10844,2323,396,1148,36258
Illinois,Kirkland village,1816,438,700,165,14,82,1399
Illinois,Cornell village,444,119,168,49,9,21,366
Illinois,Roodhouse,1792,407,655,220,8,101,1391
Illinois,Odell village,1042,238,407,98,9,67,819
Illinois,Camden village,89,2,46,3,0,11,62
Illinois,Martinsville,1289,264,479,112,4,96,955
Illinois,Watson village,835,201,362,69,8,26,666
Illinois,Gladstone village,218,51,73,43,0,15,182
Illinois,Raritan village,60,3,44,8,0,0,55
Illinois,Peotone village,4294,1098,1758,468,29,138,3491
Illinois,Downs village,886,175,409,74,13,29,700
Illinois,Liberty village,412,71,175,35,0,31,312
Illinois,Homer village,1266,225,568,91,7,61,952
Illinois,Middletown village,317,41,128,40,4,29,242
Illinois,Aurora,200660,54549,75556,13134,3362,5625,152226
Illinois,Windsor village,802,164,298,151,9,48,670
Illinois,Baylis village,131,29,41,15,1,14,100
Illinois,Detroit village,76,25,23,4,0,0,52
Illinois,Oconee village,175,35,74,18,3,9,139
Illinois,Crete village,8184,1946,3430,825,239,470,6910
Illinois,Crystal Lawns,2086,446,959,146,53,115,1719
Illinois,Centreville,5059,1754,803,576,157,393,3683
Illinois,Cortland,4087,907,1657,293,33,69,2959
Illinois,Genoa,4878,1280,1783,556,107,140,3866
Illinois,St. Libory village,510,88,299,14,2,25,428
Illinois,Warren village,1198,233,511,140,15,105,1004
Illinois,Washington Park village,3962,1816,725,289,103,281,3214
Illinois,Dupo village,3893,1134,1132,531,69,210,3076
Illinois,Freeburg village,4254,847,2032,428,15,296,3618
Illinois,Edinburg village,1186,251,474,168,7,94,994
Illinois,Bowen village,444,91,203,25,19,24,362
Illinois,Elvaston village,138,20,45,23,8,12,108
Illinois,Hamilton,2875,387,1257,426,46,206,2322
Illinois,Dowell village,473,132,179,34,9,17,371
Illinois,Murphysboro,7951,1716,2639,1135,203,656,6349
Illinois,Vergennes village,202,39,83,23,2,17,164
Illinois,West Peoria,4731,1227,1275,917,30,338,3787
Illinois,Tallula village,488,97,243,33,9,22,404
Illinois,Lenzburg village,491,123,166,67,0,19,375
Illinois,West Salem village,930,173,454,81,28,53,789
Illinois,Toledo village,1322,215,555,111,12,111,1004
Illinois,Casey,2518,447,1040,396,27,252,2162
Illinois,Shelbyville,4527,1008,1872,593,31,296,3800
Illinois,Lake of the Woods,2442,479,914,206,33,140,1772
Illinois,Ludlow village,382,114,100,59,8,34,315
Illinois,Elk Grove Village village,32997,7399,15317,2812,444,1889,27861
Illinois,Glendale Heights village,34280,9446,13609,2459,487,1026,27027
Illinois,Freeman Spur village,321,75,112,58,10,12,267
Illinois,Hurst,846,199,315,116,19,59,708
Illinois,Walshville village,122,37,21,8,0,2,68
Illinois,McCullom Lake village,1148,233,498,98,2,42,873
Illinois,Marengo,8175,1735,3251,834,24,458,6302
Illinois,Donnellson village,172,36,51,25,7,30,149
Illinois,Taylor Springs village,647,151,225,100,7,77,560
Illinois,Ridott village,157,51,45,25,2,3,126
Illinois,El Paso,2820,641,1010,288,53,164,2156
Illinois,Galena,3399,643,1704,308,0,260,2915
Illinois,Nora village,166,55,61,23,0,7,146
Illinois,Emden village,518,52,233,46,0,50,381
Illinois,Long Grove village,7978,1607,4237,328,15,283,6470
Illinois,Riverwoods village,3656,535,2230,105,12,147,3029
Illinois,Round Lake village,18489,4333,7663,1467,113,431,14007
Illinois,Round Lake Heights village,3208,911,1232,168,37,51,2399
Illinois,Venetian Village,2870,640,1301,197,58,132,2328
Illinois,Wadsworth village,3584,797,2047,110,86,119,3159
Illinois,Sherrard village,622,93,332,69,7,25,526
Illinois,Mount Pulaski,1582,287,700,129,12,176,1304
Illinois,Joy village,390,109,177,31,7,19,343
Illinois,North Henderson village,175,29,79,26,0,14,148
Illinois,Barry,1552,271,549,210,22,122,1174
Illinois,Lima village,120,13,80,2,0,9,104
Illinois,Gridley village,1577,275,776,95,0,96,1242
Illinois,Towanda village,491,143,182,56,10,42,433
Illinois,Woodson village,404,62,194,45,8,22,331
Illinois,Marietta village,101,9,56,16,0,4,85
Illinois,Vermont village,777,153,309,100,8,65,635
Illinois,Hidalgo village,120,11,52,9,10,3,85
Illinois,Newton,2766,734,893,340,49,246,2262
Illinois,Willow Hill village,193,64,68,34,8,9,183
Illinois,St. Francisville,538,106,198,80,18,48,450
Illinois,Henry,2478,509,1089,208,19,189,2014
Illinois,Varna village,476,112,204,32,0,34,382
Illinois,Polo,2168,569,851,196,30,124,1770
Illinois,Raleigh village,253,44,108,43,1,23,219
Illinois,Radom village,159,35,73,20,0,15,143
Illinois,Berkeley village,5171,1605,1895,466,87,279,4332
Illinois,Fairview village,433,77,213,39,0,34,363
Illinois,Blue Island,22636,8092,6263,1985,653,1029,18022
Illinois,Thomson village,479,96,215,57,9,48,425
Illinois,Eldred village,156,51,39,40,0,24,154
Illinois,Camp Point village,1136,206,488,135,6,93,928
Illinois,Columbus village,47,18,11,7,1,6,43
Illinois,Carrollton,2461,625,1066,182,40,186,2099
Illinois,Centralia,12538,3209,4030,1658,220,948,10065
Illinois,Irvington village,749,133,327,103,3,38,604
Illinois,Okawville village,1569,383,665,92,24,81,1245
Illinois,Burbank,28947,7579,11775,2251,272,1598,23475
Illinois,Pleasant Plains village,767,142,328,68,0,49,587
Illinois,Thayer village,713,236,253,71,12,32,604
Illinois,Altona village,642,120,238,47,11,41,457
Illinois,Rossville village,1451,352,560,123,14,79,1128
Illinois,Palestine village,1191,279,456,170,12,100,1017
Illinois,Glenwood village,8766,2741,2972,734,172,499,7118
Illinois,Flossmoor village,9427,1784,4333,788,115,415,7435
Illinois,Nokomis,2102,379,886,187,20,160,1632
Illinois,Panama village,250,52,91,15,5,29,192
Illinois,Wenonah village,40,8,25,0,0,0,33
Illinois,Congerville village,575,104,303,27,2,17,453
Illinois,Goodfield village,918,195,491,22,0,20,728
Illinois,Harmon village,127,26,54,12,0,8,100
Illinois,Paw Paw village,764,150,378,98,0,53,679
Illinois,Clear Lake village,191,43,87,20,5,16,171
Illinois,Lynnville village,68,14,38,7,0,4,63
Illinois,Bensenville village,18400,4864,7251,1339,379,984,14817
Illinois,Pesotum village,501,113,233,60,11,18,435
Illinois,Rantoul village,13222,3732,3956,1325,347,759,10119
Illinois,Sidney village,1368,269,578,121,16,38,1022
Illinois,Roselle village,22873,6168,10202,1744,136,771,19021
Illinois,Winfield village,9708,1842,5069,906,46,404,8267
Illinois,Ford Heights village,2755,1147,370,272,101,88,1978
Illinois,Herscher village,1471,283,670,137,12,95,1197
Illinois,Bedford Park village,514,179,172,49,8,27,435
Illinois,Cicero,83147,28992,25258,3665,2334,2209,62458
Illinois,Franklin Park village,18138,5509,7240,1105,354,730,14938
Illinois,Glencoe village,8919,1383,4600,433,17,383,6816
Illinois,Scott AFB,2697,351,1342,27,0,3,1723
Illinois,Smithton village,3980,663,1931,271,9,262,3136
Illinois,Swansea village,13863,3426,6401,883,203,584,11497
Illinois,Forest City village,325,59,125,13,13,15,225
Illinois,Mason City,2364,587,895,209,37,279,2007
Illinois,Dolton village,22927,9161,5560,1895,762,1100,18478
Illinois,Hillcrest village,1265,273,564,92,31,18,978
Illinois,Coffeen,622,133,263,73,2,22,493
Illinois,Pearl village,207,35,90,13,3,10,151
Illinois,Mokena village,20720,4328,10185,1075,63,760,16411
Illinois,Edgewood village,536,56,324,36,2,18,436
Illinois,Effingham,12624,3396,4378,1456,104,769,10103
Illinois,Mason,302,43,127,48,0,25,243
Illinois,Montrose village,244,55,101,18,3,15,192
Illinois,Oquawka village,1558,395,638,188,38,126,1385
Illinois,Oswego village,34383,7588,16358,1685,195,765,26591
Illinois,Forsyth village,2964,473,1638,129,9,199,2448
Illinois,Long Creek village,1548,372,700,145,14,66,1297
Illinois,Mount Zion village,5973,1022,2643,480,100,223,4468
Illinois,Dongola village,799,172,282,42,12,53,561
Illinois,Jonesboro,1935,432,803,206,20,94,1555
Illinois,Mill Creek village,53,14,23,14,0,2,53
Illinois,Marion,17646,4087,6472,2129,161,1287,14136
Illinois,Fidelity village,149,34,43,28,3,5,113
Illinois,Jerseyville,8127,1698,3367,849,120,680,6714
Illinois,Forrest village,1109,217,504,57,23,69,870
Illinois,Vandalia,6914,2544,1998,1025,138,296,6001
Illinois,Colona,4954,953,2348,577,42,141,4061
Illinois,Geneseo,6520,1226,3113,530,40,532,5441
Illinois,Glen Carbon village,12845,2487,5764,1098,100,689,10138
Illinois,Highland,10020,1894,4386,923,170,676,8049
Illinois,St. Jacob village,1392,213,607,152,51,29,1052
Illinois,Reddick village,222,47,93,14,0,14,168
Illinois,Baldwin village,308,88,96,48,3,16,251
Illinois,Rockwood village,28,1,15,5,0,2,23
Illinois,Thebes village,392,67,128,12,6,13,226
Illinois,Fieldon village,201,17,121,13,6,14,171
Illinois,Hillsdale village,538,99,234,56,16,19,424
Illinois,Herrin,12869,3034,4573,1657,191,1058,10513
Illinois,Creal Springs,433,107,152,69,8,22,358
Illinois,Monee village,5124,1462,2222,410,0,192,4286
Illinois,New Lenox village,26032,5879,12148,1401,137,868,20433
Illinois,Steger village,9439,2774,3520,1007,165,406,7872
Illinois,Mount Carroll,1587,360,695,156,8,97,1316
Illinois,De Witt village,202,23,76,38,11,21,169
Illinois,Maple Park village,1482,262,697,118,8,45,1130
Illinois,South Elgin village,22522,5136,9429,1850,136,670,17221
Illinois,Greenwood village,249,41,148,18,2,4,213
Illinois,Holiday Hills village,740,189,323,87,30,34,663
Illinois,McLeansboro,2663,632,1090,212,20,198,2152
Illinois,Macomb,18118,8531,5104,1492,71,827,16025
Illinois,Cypress village,216,61,86,12,2,13,174
Illinois,New Burnside village,155,12,104,17,0,14,147
Illinois,Colchester,1481,412,560,193,13,62,1240
Illinois,Rosewood Heights,4101,808,1943,409,0,203,3363
Illinois,Wilsonville village,690,153,271,91,2,47,564
Illinois,Noble village,621,117,225,101,19,40,502
Illinois,Hamel village,866,146,346,101,8,34,635
Illinois,Pierron village,446,90,190,74,2,34,390
Illinois,Pontoon Beach village,5725,1129,2568,624,15,127,4463
Illinois,Roxana village,1506,324,590,236,11,96,1257
Illinois,Venice,2128,851,339,224,25,149,1588
Illinois,Wood River,10234,2764,3418,1363,219,510,8274
Illinois,Port Byron village,1802,281,863,176,9,67,1396
Illinois,Bellmont village,194,22,99,25,0,12,158
Illinois,Woodland village,332,57,147,44,5,12,265
Illinois,Crainville village,1499,279,700,89,13,103,1184
Illinois,Pittsfield,4375,1176,1661,539,79,290,3745
Illinois,Sailor Springs village,120,29,36,18,0,10,93
Illinois,Trout Valley village,481,115,277,16,0,21,429
Illinois,Fulton,3302,572,1500,350,15,228,2665
Illinois,Trenton,2637,538,1046,283,35,222,2124
Illinois,Elliott village,311,61,132,35,3,20,251
Illinois,Forest Lake,1451,201,812,91,18,15,1137
Illinois,Cobden village,1161,345,428,172,27,50,1022
Illinois,Cairo,2528,835,551,241,118,211,1956
Illinois,Galva,2565,520,1136,310,54,119,2139
Illinois,Alton,26884,8026,7627,3489,571,1967,21680
Illinois,Grayslake village,21195,5494,8952,1867,255,698,17266
Illinois,Highland Park,29731,4668,15615,1945,179,1460,23867
Illinois,Indian Creek village,596,105,274,34,8,19,440
Illinois,Kildeer village,4014,724,2196,172,19,62,3173
Illinois,Edwardsville,24868,9488,8653,1907,201,716,20965
Illinois,Bartelso village,661,139,304,23,0,41,507
Illinois,Old Mill Creek village,166,38,74,14,2,6,134
Illinois,Creve Coeur village,5493,1646,1800,910,96,248,4700
Illinois,Pekin,33371,7931,12978,4001,282,2081,27273
Illinois,Spring Valley,5282,1078,2214,483,108,351,4234
Illinois,Scales Mound village,493,96,218,41,3,25,383
Illinois,Broadwell village,186,30,108,21,0,4,163
Illinois,Elkhart village,422,50,197,46,0,35,328
Illinois,Gifford village,900,142,366,81,6,125,720
Illinois,Bourbonnais village,19526,6304,7360,1481,131,819,16095
Illinois,Beach Park village,13534,2686,6385,795,156,449,10471
Illinois,Gurnee village,30854,7738,13735,2246,224,1246,25189
Illinois,Gages Lake,9862,2504,4487,831,57,219,8098
Illinois,Payson village,1243,230,514,126,12,13,895
Illinois,Tremont village,2099,375,1008,162,32,97,1674
Illinois,Glasgow village,104,17,68,13,0,6,104
Illinois,Mulberry Grove village,592,77,264,48,8,53,450
Illinois,Hoffman village,464,90,233,21,0,28,372
Illinois,Monmouth,9189,3019,3102,799,53,467,7440
Illinois,Mound Station village,140,20,63,18,0,3,104
Illinois,St. David village,634,196,197,50,13,56,512
Illinois,Ste. Marie village,341,80,133,39,0,14,266
Illinois,Yale village,111,18,61,2,2,8,91
Illinois,Sumner,3192,1872,669,292,55,54,2942
Illinois,Davis Junction village,2508,660,1018,194,30,36,1938
Illinois,Oakdale village,166,23,68,16,6,9,122
Illinois,Richview village,280,72,105,33,4,10,224
Illinois,Venedy village,193,34,86,12,2,4,138
Illinois,Alsip village,19179,6173,6438,1422,269,1063,15365
Illinois,Broadview village,7829,2503,1949,1048,106,911,6517
Illinois,Mount Sterling,2227,486,796,274,16,161,1733
Illinois,Des Plaines,58694,14277,26180,4595,744,3737,49533
Illinois,Forest View village,892,189,346,52,21,58,666
Illinois,Hazel Crest village,13729,4704,3529,1371,306,1023,10933
Illinois,Versailles village,576,56,315,65,0,37,473
Illinois,Robinson,7614,2238,2717,989,97,551,6592
Illinois,Columbia,10503,1874,5150,945,25,390,8384
Illinois,East Carondelet village,512,156,185,67,4,19,431
Illinois,Fairmont City village,2519,958,718,192,65,86,2019
Illinois,Mascoutah,8007,1439,3403,792,50,266,5950
Illinois,Bath village,265,57,110,32,10,22,231
Illinois,San Jose village,670,108,377,61,4,14,564
Illinois,Bartonville village,6316,1673,2270,861,10,363,5177
Illinois,Bellevue village,1847,551,726,210,17,77,1581
Illinois,Mapleton village,295,58,128,32,1,5,224
Illinois,Fisher village,1952,337,813,151,18,141,1460
Illinois,Ringwood village,743,140,405,38,2,29,614
Illinois,Lake Forest,19219,4161,9703,844,141,1059,15908
Illinois,Fox Lake Hills,2198,456,1108,340,10,104,2018
Illinois,Indianola village,290,47,141,15,0,15,218
Illinois,Muncie village,174,39,68,14,0,7,128
Illinois,Loami village,1037,241,420,79,5,25,770
Illinois,Quincy,40428,9885,15550,4055,399,2991,32880
Illinois,Ursa village,579,91,285,72,0,21,469
Illinois,Broadlands village,346,81,156,35,6,10,288
Illinois,Pawnee village,2631,548,1078,232,9,140,2007
Illinois,Jeffersonville village,427,73,172,48,11,27,331
Illinois,Johnsonville village,69,18,32,7,0,4,61
Illinois,Wayne City village,1009,164,462,98,9,66,799
Illinois,Cowden village,514,113,211,80,7,18,429
Illinois,Herrick village,361,68,156,27,7,13,271
Illinois,Hoopeston,5229,1128,2236,444,100,349,4257
Illinois,Moweaqua village,1893,317,819,226,34,150,1546
Illinois,Ingalls Park,3200,1250,1009,303,33,73,2668
Illinois,Manhattan village,7813,1625,3290,438,27,245,5625
Illinois,Park Forest village,21699,7605,5643,2419,328,1298,17293
Illinois,Yates City village,739,171,290,75,2,57,595
Illinois,Medora village,410,79,213,18,7,18,335
Illinois,Claremont village,230,33,103,20,3,10,169
Illinois,Fithian village,445,84,244,48,5,15,396
Illinois,Springerton village,119,21,65,7,0,7,100
Illinois,Carmi,4913,807,1878,625,135,507,3952
Illinois,Crossville village,765,120,274,127,12,42,575
Illinois,Grayville,1728,287,697,234,22,113,1353
Illinois,Phillipstown village,54,9,26,2,0,11,48
Illinois,Braidwood,6284,1353,2871,734,101,203,5262
Illinois,Olney,8808,1885,3183,1222,108,693,7091
Illinois,Standard City village,191,34,75,44,2,2,157
Illinois,Royal Lakes village,180,50,71,22,2,19,164
Illinois,Highwood,5361,1474,2148,434,36,156,4248
Illinois,Cuba,1285,325,389,175,19,101,1009
Illinois,Smithfield village,182,34,90,8,0,26,158
Illinois,Leaf River village,548,152,187,68,2,54,463
Illinois,Nashville,3093,566,1245,370,64,298,2543
Illinois,Dakota village,551,144,157,89,5,21,416
Illinois,Roanoke village,2032,357,1014,159,6,105,1641
Illinois,Loda village,324,86,129,36,18,16,285
Illinois,Papineau village,182,50,76,3,3,10,142
Illinois,Johnston City,3485,666,1097,629,127,260,2779
Illinois,Petersburg,2346,567,846,359,21,118,1911
Illinois,Atwood village,1004,200,446,89,11,91,837
Illinois,Cerro Gordo village,1371,284,638,114,9,65,1110
Illinois,Benton,6980,1662,2436,866,63,818,5845
Illinois,Glasford village,1223,259,490,154,14,34,951
Illinois,Millstadt village,3915,832,1707,355,33,240,3167
Illinois,New Baden village,3258,708,1281,260,119,161,2529
Illinois,Shiloh village,13250,2901,6146,965,106,640,10758
Illinois,Athens,2105,382,917,216,3,85,1603
Illinois,West City village,772,123,242,83,33,58,539
Illinois,Salem,7100,1555,2624,761,147,543,5630
Illinois,Greenville,6607,2555,2070,635,64,402,5726
Illinois,Ashkum village,800,155,364,69,8,33,629
Illinois,Junction City village,539,83,218,82,9,24,416
Illinois,Cahokia village,14271,5536,3524,1169,320,677,11226
Illinois,Washburn village,1097,315,368,109,13,74,879
Illinois,East Galesburg village,624,123,318,63,2,40,546
Illinois,North Barrington village,2974,489,1709,169,10,92,2469
Illinois,Tennessee village,126,28,69,15,0,2,114
Illinois,Buncombe village,173,60,41,19,5,18,143
Illinois,Savoy village,8654,2653,3529,498,34,463,7177
Illinois,Dalzell village,736,120,397,69,3,36,625
Illinois,Victoria village,289,80,140,15,8,15,258
Illinois,Wataga village,773,139,391,79,3,33,645
Illinois,Emington village,106,30,40,10,1,5,86
Illinois,South Pekin village,1018,210,385,94,14,52,755
Illinois,Champaign,86791,39233,25432,6080,844,2570,74159
Illinois,Marseilles,5088,922,2062,543,40,296,3863
Illinois,Foosland village,120,28,29,8,0,5,70
Illinois,Green Valley village,750,104,341,63,6,41,555
Illinois,North Pekin village,1384,293,549,169,15,70,1096
Illinois,Bureau Junction village,213,63,66,31,4,8,172
Illinois,Junction village,114,26,68,3,0,3,100
Illinois,Shawneetown,1292,173,440,218,21,109,961
Illinois,Hartsburg village,299,80,132,21,1,35,269
Illinois,Delavan,1668,335,776,129,25,92,1357
Illinois,Morrison,3872,805,1575,415,89,286,3170
Illinois,Sterling,14810,3616,5353,1754,76,950,11749
Illinois,Golden village,646,131,286,49,5,80,551
Illinois,West Frankfort,7905,1936,2388,1335,185,784,6628
Illinois,North City village,717,205,311,71,18,31,636
Illinois,Neoga,1817,360,604,271,39,129,1403
Illinois,Goreville village,1105,171,517,118,14,62,882
Illinois,Dahlgren village,511,81,210,37,15,69,412
Illinois,Tuscola,4630,1004,1870,626,85,317,3902
Illinois,Garrett village,129,23,51,14,2,15,105
Illinois,Ashland village,1367,319,586,156,14,72,1147
Illinois,Posen village,6211,1661,1797,513,49,265,4285
Illinois,Park Ridge,37764,7882,17664,2137,191,2162,30036
Illinois,River Grove village,10148,2247,4614,828,70,397,8156
Illinois,Chicago,2718555,1092416,782865,186592,52088,117214,2231175
Illinois,Bonfield village,419,85,206,24,0,15,330
Illinois,Hanover Park village,38275,9940,16229,2211,450,1132,29962
Illinois,Royal village,307,44,158,18,0,28,248
Illinois,Latham village,403,122,167,35,6,19,349
Illinois,Aledo,3520,823,1447,332,22,346,2970
Illinois,Oakbrook Terrace,2912,867,1261,195,31,174,2528
Illinois,Villa Park village,21893,6034,9050,1494,147,875,17600
Illinois,Ewing village,293,68,142,27,3,19,259
Illinois,Valier village,668,93,271,67,20,27,478
Illinois,Gorham village,206,37,58,28,10,9,142
Illinois,Leland village,859,214,406,48,2,35,705
Illinois,North Utica village,1373,248,648,146,16,53,1111
Illinois,Oglesby,3669,808,1533,366,22,210,2939
Illinois,Peru,9864,2199,3994,978,154,934,8259
Illinois,Cleveland village,287,62,104,44,0,10,220
Illinois,Wood Dale,13848,3729,5802,1207,147,808,11693
Illinois,Barrington Hills village,3916,596,2182,258,54,206,3296
Illinois,Virgil village,400,118,180,10,11,11,330
Illinois,Mackinaw village,2023,346,880,152,11,56,1445
Illinois,Morton village,16731,2641,8483,1162,109,918,13313
Illinois,West Dundee village,7535,1769,3346,542,112,305,6074
Illinois,Harvard,9292,1870,3634,635,135,289,6563
Illinois,Buckner village,422,100,166,63,6,36,371
Illinois,Walnut village,1389,232,670,97,14,92,1105
Illinois,Mattoon,17597,4453,5553,2833,226,1398,14463
Illinois,Danvers village,1108,208,511,107,0,45,871
Illinois,Buckingham village,254,44,109,27,1,14,195
Illinois,Cave-In-Rock village,263,57,91,39,2,17,206
Illinois,East Dubuque,1557,369,654,213,9,87,1332
Illinois,Elizabeth village,819,225,275,123,5,82,710
Illinois,Atlanta,1965,340,876,162,8,84,1470
Illinois,Lincoln,13738,3516,5258,1663,123,925,11485
Illinois,El Dara village,70,23,39,0,0,0,62
Illinois,Dover village,133,32,65,13,0,3,113
Illinois,Malden village,275,76,104,31,3,11,225
Illinois,Tiskilwa village,858,209,322,97,10,47,685
Illinois,Elizabethtown village,261,38,93,41,2,20,194
Illinois,Hopkins Park village,426,123,118,44,10,34,329
Illinois,Arrowsmith village,299,62,123,23,3,18,229
Illinois,St. Anne village,1361,410,475,150,6,74,1115
Illinois,Carlock village,549,99,219,32,5,21,376
Illinois,Thompsonville village,604,86,228,113,8,34,469
Illinois,Huntley village,26486,3639,13707,1789,212,2276,21623
Illinois,Ridgway village,877,135,417,82,4,72,710
Illinois,Kappa village,245,81,82,24,11,7,205
Illinois,Lansing village,28141,9418,9706,2392,216,1616,23348
Illinois,La Grange Park village,13491,2707,6205,847,73,749,10581
Illinois,Maywood village,23810,9160,6475,2203,509,1086,19433
Illinois,Norridge village,14888,3746,6416,844,122,1359,12487
Illinois,Northfield village,5536,1068,2578,524,50,249,4469
Illinois,North Riverside village,6813,2065,2261,670,154,444,5594
Illinois,Hodgkins village,1967,563,581,210,91,136,1581
Illinois,River Forest village,11064,2677,5199,439,53,448,8816
Illinois,Skokie village,64395,15094,29290,3671,804,4163,53022
Illinois,Streamwood village,40413,11464,16878,2881,565,1530,33318
Illinois,Winnetka village,12481,2071,6363,511,60,226,9231
Illinois,Golconda,781,224,259,114,24,58,679
Illinois,Camargo village,595,139,246,85,13,16,499
Illinois,Belknap village,113,33,31,18,0,6,88
Illinois,Rolling Meadows,23229,5961,9283,2054,225,1141,18664
Illinois,Hillside village,8096,2844,2616,764,178,548,6950
Illinois,Forest Park village,14041,5470,4444,1761,307,477,12459
Illinois,Evergreen Park village,19666,5677,7480,1333,258,1099,15847
Illinois,Hecker village,537,91,242,45,1,26,405
Illinois,Arenzville village,465,88,216,37,6,15,362
Illinois,Bellwood village,19112,7071,5388,1465,331,1315,15570
Illinois,Carbondale,25846,15372,5449,1492,221,552,23086
Illinois,Walnut Hill village,140,45,58,13,1,4,121
Illinois,O'Fallon,29277,6290,13400,2047,247,958,22942
Illinois,Fults village,25,5,14,0,1,1,21
Illinois,Darien,22126,5058,10260,2026,154,1388,18886
Illinois,Lake Zurich village,19970,4407,9705,1328,94,480,16014
Illinois,Lomax village,394,82,194,43,2,26,347
Illinois,Percy village,945,233,241,105,26,58,663
Illinois,Orion village,2029,438,884,185,18,142,1667
Illinois,Calumet Park village,8442,2969,1899,1289,284,485,6926
Illinois,East Hazel Crest village,1694,646,570,123,32,113,1484
Illinois,Tower Lakes village,1205,203,643,47,9,32,934
Illinois,Vienna,1490,237,539,228,26,159,1189
Illinois,Blandinsville village,685,175,301,68,7,28,579
Illinois,Sciota village,78,20,25,10,0,7,62
Illinois,Loves Park,24043,5494,9554,2636,313,1402,19399
Illinois,Naperville,147411,31951,72233,7532,835,4510,117061
Illinois,Frankfort Square,8638,2010,3905,748,97,214,6974
Illinois,Diamond village,2707,550,1119,216,14,99,1998
Illinois,Crest Hill,20379,7278,6547,1993,430,1340,17588
Illinois,Coal City village,5427,1116,2511,367,42,304,4340
Illinois,Sigel,399,59,204,19,0,18,300
Illinois,Danville,31554,9656,8548,4042,632,1989,24867
Illinois,Scottville village,109,19,64,9,0,3,95
Illinois,Chesterfield village,206,21,90,14,0,8,133
Illinois,Henderson village,250,60,127,28,0,14,229
Illinois,Calhoun village,171,22,54,72,0,7,155
Illinois,Staunton,5036,1218,2105,553,7,343,4226
Illinois,Mount Olive,1996,412,858,241,5,81,1597
Illinois,Hettick village,131,25,69,14,1,2,111
Illinois,Dorchester village,120,9,84,10,0,5,108
Illinois,Rio village,185,29,108,11,1,12,161
Illinois,Eureka,6114,1574,2507,430,24,516,5051
Illinois,Dix village,362,72,130,76,10,26,314
Illinois,Xenia village,422,74,145,47,2,34,302
Illinois,Prophetstown,2099,575,737,241,17,226,1796
Illinois,La Prairie village,63,13,35,5,0,3,56
Illinois,Little York village,305,103,102,30,2,25,262
Illinois,Kingston village,1270,280,508,121,9,28,946
Illinois,Shorewood village,17026,3512,8296,1072,85,619,13584
Illinois,Cisco village,246,52,101,30,2,21,206
Illinois,Hammond village,485,115,174,60,2,25,376
Illinois,Brussels village,154,52,50,26,2,12,142
Illinois,Hardin village,759,161,309,64,6,73,613
Illinois,Cullom village,650,151,203,71,12,51,488
Illinois,Brookport,882,195,297,142,22,77,733
Illinois,Chadwick village,580,106,294,65,7,35,507
Illinois,Tamaroa village,661,173,212,103,7,35,530
Illinois,Littleton village,143,21,76,14,1,10,122
Illinois,Rushville,2841,759,876,415,37,338,2425
Illinois,Bluford village,672,190,254,47,6,23,520
Illinois,Du Quoin,5818,1364,2052,705,181,507,4809
Illinois,Lake in the Hills village,28832,6789,12689,1846,387,520,22231
Illinois,Richmond village,1880,567,572,244,8,93,1484
Illinois,West York,104,0,76,0,0,0,76
Illinois,Twin Grove,1651,248,1001,72,0,81,1402
Illinois,Westervelt,71,29,0,18,0,0,47
Illinois,West Union,394,59,202,12,0,35,308
Illinois,White Heath,243,78,122,31,0,0,231
Illinois,St. Rose village,462,79,220,17,4,31,351
Illinois,The Galena Territory,1363,115,1028,58,3,96,1300
Illinois,Garden Prairie,231,95,87,0,0,49,231
Illinois,Whiteash,229,41,111,24,4,2,182
Illinois,Secor village,333,64,156,31,0,25,276
Illinois,Perry village,297,63,114,44,1,37,259
Illinois,Pleasant Hill village,1080,215,401,96,14,86,812
Illinois,Ohlman village,112,15,53,9,2,13,92
Illinois,Pearl City village,785,114,360,58,20,37,589
Illinois,Candlewick Lake,4877,1370,1987,277,26,304,3964
Illinois,Seymour,304,97,73,10,40,0,220
Illinois,Rentchler,6,0,0,0,6,0,6
Illinois,Prestbury,1638,118,994,221,19,134,1486
Illinois,Grand Ridge village,630,144,273,47,3,34,501
Illinois,Rutland village,251,44,117,21,13,19,214
Illinois,Somonauk village,2152,494,929,119,11,94,1647
Illinois,Tonica village,725,187,279,61,15,40,582
Illinois,Kell village,174,43,65,23,0,9,140
Illinois,Odin village,1089,212,364,112,12,143,843
Illinois,Arthur village,2622,377,1254,256,33,121,2041
Illinois,Mitchell,1219,400,548,96,0,84,1128
Illinois,Mulkeytown,181,25,79,0,0,24,128
Illinois,Oak Run,607,63,414,33,0,27,537
Illinois,Olive Branch,466,40,230,34,0,43,347
Illinois,Olivet,372,106,154,44,0,7,311
Illinois,Opdyke,249,41,101,37,4,12,195
Illinois,Paderborn,72,0,34,21,0,17,72
Illinois,Penfield,154,25,55,32,5,22,139
Illinois,Peoria Heights village,5910,1581,2021,895,77,293,4867
Illinois,Spring Bay village,445,93,210,63,7,12,385
Illinois,Coleta village,212,32,83,14,1,10,140
Illinois,Erie village,1438,249,637,180,6,77,1149
Illinois,White City village,234,42,108,30,0,17,197
Illinois,Sawyerville village,276,43,106,18,14,18,199
Illinois,Modesto village,212,52,90,27,0,11,180
Illinois,East Gillespie village,214,31,129,19,0,15,194
Illinois,Benld,1616,326,636,236,20,74,1292
Illinois,St. Augustine village,100,12,48,16,1,18,95
Illinois,Maquon village,280,52,121,46,0,14,233
Illinois,London Mills village,374,69,172,42,2,10,295
Illinois,Fayetteville village,338,80,134,42,4,26,286
Illinois,Alorton village,1965,798,247,224,62,106,1437
Illinois,Allenville village,180,23,110,11,0,2,146
Illinois,Patoka village,623,146,220,83,5,37,491
Illinois,Iuka village,517,128,188,73,10,21,420
Illinois,Farina village,630,60,282,97,1,64,504
Illinois,Troy Grove village,261,48,125,25,0,5,203
Illinois,Fairmount village,632,151,278,63,6,43,541
Illinois,Lerna village,266,58,114,16,3,20,211
Illinois,Marshall,3401,545,1406,481,115,195,2742
Illinois,Biggsville village,316,83,136,20,12,33,284
Illinois,Longview village,130,20,47,24,1,13,105
Illinois,Tolono village,3086,607,1212,391,47,94,2351
Illinois,Urbana,42375,24442,10302,2321,182,1369,38616
Illinois,Aroma Park village,813,220,342,43,15,63,683
Illinois,Bloomingdale village,22138,4976,10065,1749,154,1610,18554
Illinois,Lombard village,43904,11764,18522,3140,479,2348,36253
Illinois,Farmer City,1926,280,883,276,20,119,1578
Illinois,Caseyville village,4018,1052,1431,342,91,280,3196
Illinois,Gays village,216,55,115,8,1,10,189
Illinois,Dalton City village,424,74,194,49,2,16,335
Illinois,Campbell Hill village,303,48,141,28,3,16,236
Illinois,Hanaford village,395,81,158,64,3,17,323
Illinois,Prairie du Rocher village,538,142,253,52,0,33,480
Illinois,Earlville,1770,370,786,191,26,114,1487
Illinois,Coulterville village,943,158,381,87,18,106,750
Illinois,Dieterich village,629,95,311,26,8,35,475
Illinois,Pistakee Highlands,3253,770,1521,245,56,160,2752
Illinois,Timberlane village,1044,179,554,39,0,8,780
Illinois,Waterman village,1567,390,684,155,18,48,1295
Illinois,McNabb village,283,79,108,38,0,13,238
Illinois,Waverly,1286,268,538,162,9,71,1048
Illinois,Meredosia village,829,90,403,85,14,67,659
Illinois,Hudson village,2073,418,1075,90,10,42,1635
Illinois,Anchor village,175,45,56,6,4,12,123
Illinois,Manteno village,8652,2288,3751,564,83,465,7151
Illinois,Armington village,370,57,148,41,3,25,274
Illinois,Wheaton,53480,13798,24030,3117,323,2011,43279
Illinois,Romeoville village,39702,10710,15631,2775,522,1337,30975
Illinois,Woodridge village,33493,8808,14547,2469,329,1115,27268
Illinois,Batavia,26282,4770,13016,1655,111,1095,20647
Illinois,Geneva,21799,4689,10439,1660,133,1061,17982
Illinois,Cary village,17871,3832,8511,1398,57,580,14378
Illinois,Wayne village,2345,504,1335,163,5,70,2077
Illinois,Westmont village,25036,7029,9838,2024,278,1472,20641
Illinois,Minier village,1200,227,597,100,15,69,1008
Illinois,East Dundee village,3183,724,1334,433,37,230,2758
Illinois,Elburn village,5823,1165,2254,602,12,108,4141
Illinois,Menominee village,235,30,129,6,0,13,178
Illinois,New Holland village,268,59,112,27,6,23,227
Illinois,Keithsburg,619,154,265,40,10,46,515
Illinois,Time village,10,1,3,4,0,2,10
Illinois,Valley City village,22,5,9,0,0,0,14
Illinois,Golden Gate village,77,24,33,10,2,2,71
Illinois,Milton village,232,37,109,43,0,15,204
Illinois,Kinderhook village,292,27,190,10,4,0,231
Illinois,Hull village,510,111,202,77,6,21,417
Illinois,Viola village,937,199,455,30,13,69,766
Illinois,Matherville village,923,182,367,94,10,30,683
Illinois,Island Lake village,8056,1671,3203,1177,67,288,6406
Illinois,New Haven village,356,62,139,73,8,36,318
Illinois,Equality village,551,136,209,85,9,45,484
Illinois,Hampshire village,5852,1313,2376,428,32,64,4213
Illinois,Fox Lake village,10606,2563,3826,1444,211,815,8859
Illinois,Prairie Grove village,1826,476,889,114,13,58,1550
Illinois,Butler village,202,38,90,14,0,8,150
Illinois,Litchfield,7015,1288,2602,1111,104,572,5677
Illinois,Waynesville village,424,75,214,19,5,42,355
Illinois,Bolingbrook village,74448,20153,31871,4255,606,1947,58832
Illinois,Elwood village,2396,524,955,249,14,175,1917
Illinois,Godley village,651,211,185,106,17,22,541
Illinois,Matteson village,19336,5118,7824,1571,400,943,15856
Illinois,University Park village,7115,2429,1919,536,195,291,5370
Illinois,Joliet,147957,42200,52519,11330,2063,5169,113281
Illinois,Lemont village,16935,3417,8454,924,131,775,13701
Illinois,Hume village,357,46,169,59,1,15,290
Illinois,Kansas village,627,123,224,107,8,64,526
Illinois,Paris,8424,2040,3203,995,79,633,6950
Illinois,Bulpitt village,199,44,84,21,0,15,164
Illinois,Tovey village,514,86,202,49,29,28,394
Illinois,Augusta village,465,113,224,65,0,27,429
Illinois,Caledonia village,221,54,99,11,2,8,174
Illinois,Weldon village,437,62,195,68,0,44,369
Illinois,Warsaw,1482,185,694,177,38,71,1165
Illinois,Gardner village,1375,342,678,139,13,59,1231
Illinois,Bull Valley village,1267,205,762,49,10,45,1071
Illinois,Elmwood,2292,513,983,175,48,110,1829
Illinois,Greenview village,906,192,334,121,8,38,693
Illinois,Old Ripley village,91,8,47,13,0,10,78
Illinois,Exeter village,82,13,38,14,0,3,68
Illinois,Damiansville village,587,182,234,29,1,23,469
Illinois,Kempton village,231,49,96,23,2,6,176
Illinois,Bush village,250,44,104,53,0,7,208
Illinois,Milford village,1320,297,498,121,20,141,1077
Illinois,Onarga village,1079,247,489,63,9,38,846
Illinois,Sheridan village,2628,1676,406,293,32,44,2451
Illinois,Mundelein village,31683,7812,14781,1646,280,1053,25572
Illinois,Standard village,266,63,88,35,1,25,212
Illinois,Lily Lake village,1091,219,575,44,11,30,879
Illinois,Hoffman Estates village,51282,12284,24436,2580,673,1565,41538
Illinois,Burlington village,668,186,332,45,2,14,579
Illinois,Morris,13983,3039,5723,1529,178,718,11187
Illinois,South Wilmington village,911,165,425,55,17,45,707
Illinois,Evanston,75157,27043,25970,5582,920,3176,62691
Illinois,Tilden village,885,162,368,128,7,75,740
Illinois,Freeport,24300,5636,8723,2891,589,1779,19618
Illinois,Germantown Hills village,3478,587,1885,141,0,143,2756
Illinois,Stewardson village,723,127,310,99,9,24,569
Illinois,Strasburg village,473,39,264,39,3,34,379
Illinois,Lakewood Shores,1381,295,532,202,0,103,1132
Illinois,Minooka village,11291,2533,4866,577,58,275,8309
Illinois,Orland Park village,59100,12618,28510,3712,341,4056,49237
Illinois,Karnak village,462,108,157,44,11,40,360
Illinois,Rockdale village,1932,702,664,166,21,51,1604
Illinois,Tinley Park village,56898,13387,24926,4261,476,3534,46584
Illinois,Wilmington,5913,1636,2052,674,97,473,4932
Illinois,McHenry,26740,6191,11752,2180,289,1523,21935
Illinois,Lake Bluff village,5612,1033,3147,229,42,137,4588
Illinois,Lake Villa village,8762,2044,3919,534,19,184,6700
Illinois,Lincolnshire village,7469,1183,3853,400,18,892,6346
Illinois,Lindenhurst village,14495,3479,6469,1114,48,523,11633
Illinois,Symerton village,105,17,32,15,0,7,71
Illinois,Oakland,1053,182,477,117,18,68,862
Illinois,Raymond village,852,171,380,92,12,60,715
Illinois,Lakewood village,3741,677,1927,251,11,106,2972
Illinois,Hindsboro village,434,90,174,70,4,15,353
Illinois,Rockford,147881,43263,46906,15862,2329,8784,117144
Illinois,Bradford village,660,165,262,72,0,39,538
Illinois,Valmeyer village,1320,341,571,124,6,36,1078
Illinois,Pecatonica village,2228,505,911,280,12,87,1795
Illinois,Bondville village,455,123,219,34,6,25,407
Illinois,Ogden village,760,183,318,67,11,36,615
Illinois,Fillmore village,276,34,152,26,1,23,236
Illinois,Philo village,1500,255,791,89,3,48,1186
Illinois,Thomasboro village,1061,262,469,92,10,80,913
Illinois,East Brooklyn village,90,14,62,3,1,1,81
Illinois,Georgetown,3316,795,1232,468,39,269,2803
Illinois,Sidell village,429,51,221,44,12,30,358
Illinois,Westville village,3288,679,1108,467,8,164,2426
Illinois,Kinsman village,140,32,80,3,0,1,116
Illinois,Crystal Lake,40170,9399,18047,2951,256,1590,32243
Illinois,St. Joseph village,4424,717,1905,446,14,228,3310
Illinois,Orient,415,120,158,46,10,44,378
Illinois,Royalton village,1119,192,458,149,28,127,954
Illinois,Ava,602,113,227,85,10,63,498
Illinois,Long Lake,3415,904,1523,213,37,116,2793
Illinois,Smithboro village,216,46,67,17,3,13,146
Illinois,Breese,4453,1005,1790,437,0,399,3631
Illinois,Westfield village,728,141,317,79,6,38,581
Illinois,Altamont,2260,443,885,239,26,216,1809
Illinois,Lisbon village,414,71,168,15,7,11,272
Illinois,Montgomery village,19216,4190,7612,1614,193,229,13838
Illinois,Deer Park village,3668,634,2106,104,0,89,2933
Illinois,Amboy,2455,561,991,166,11,214,1943
Illinois,Waltonville village,418,100,142,58,10,23,333
Illinois,Woodlawn village,642,99,303,38,14,19,473
Illinois,Ashton village,1081,233,449,122,2,63,869
Illinois,Riverdale village,12786,5395,2218,1214,296,623,9746
Illinois,Decatur,72969,21253,23744,8975,967,4706,59645
Illinois,Oreana village,728,125,341,66,0,45,577
Illinois,Hanna City village,1268,234,606,127,6,94,1067
Illinois,Ina village,2495,1425,530,410,21,25,2411
Illinois,Channel Lake,1470,398,496,231,32,90,1247
Illinois,Arlington Heights village,75724,15067,37282,5266,523,4259,62397
Illinois,Antioch village,14305,2903,6284,1010,203,552,10952
Illinois,Elkville village,910,207,320,79,9,64,679
Illinois,Dana village,95,19,44,15,0,4,82
Illinois,Kangley village,220,61,91,28,0,10,190
Illinois,Alma village,327,59,112,49,6,26,252
Illinois,Marissa village,1641,278,683,212,40,128,1341
Illinois,Sullivan,4538,694,1922,592,30,376,3614
Illinois,Brooklyn village,469,221,70,43,24,33,391
Illinois,Madison,3714,1443,733,390,286,260,3112
Illinois,Chester,8410,3677,2295,953,86,446,7457
Illinois,Hinckley village,2083,427,956,212,12,76,1683
Illinois,Boulder Hill,9179,2531,3486,883,133,268,7301
Illinois,Niantic village,459,85,189,44,8,71,397
Illinois,Evansville village,715,188,263,83,2,45,581
Illinois,Ruma village,308,43,155,20,6,14,238
Illinois,Tamms village,658,157,303,28,20,25,533
Illinois,Hooppole village,236,17,136,3,0,4,160
Illinois,Kewanee,12570,3159,4717,1054,152,906,9988
Illinois,Willow Springs village,5696,1356,2681,513,15,260,4825
Illinois,Naplate village,462,139,134,96,7,31,407
Illinois,Western Springs village,13227,1952,7036,374,48,463,9873
Illinois,Palos Heights,12534,2830,5922,918,59,1128,10857
Illinois,Fairfield,5077,989,1902,796,27,439,4153
Illinois,Beecher City village,372,78,144,52,2,22,298
Illinois,Gulf Port village,29,7,19,3,0,0,29
Illinois,Brocton village,383,73,193,40,2,19,327
Illinois,Hainesville village,3656,936,1451,326,58,67,2838
Illinois,Deer Grove village,57,16,32,3,0,4,55
Illinois,Beecher village,4382,1035,1906,401,113,241,3696
Illinois,Cantrall village,223,46,108,6,0,4,164
Illinois,Preston Heights,2565,837,745,252,111,90,2035
Illinois,Hillsboro,6840,2588,2077,962,87,467,6181
Illinois,Deer Creek village,659,104,280,74,2,30,490
Illinois,Mark village,544,142,275,47,10,5,479
Illinois,Bardolph village,328,95,80,59,24,16,274
Illinois,South Beloit,7827,1595,2956,782,55,348,5736
Illinois,Hamburg village,102,16,48,3,0,5,72
Illinois,St. Johns village,257,23,144,16,0,16,199
Illinois,Enfield village,549,95,258,58,6,34,451
Illinois,Belleville,41926,12864,13310,4910,483,2421,33988
Illinois,Palmer village,207,46,98,15,0,12,171
Illinois,Plainfield village,43048,8979,19299,2422,282,1125,32107
Illinois,Manchester village,259,30,138,28,3,15,214
Illinois,Lisle village,23435,6697,9949,1808,165,986,19605
Illinois,Princeton,7662,1531,3306,917,81,613,6448
Illinois,Sugar Grove village,9545,2176,4777,720,152,193,8018
Illinois,Belle Prairie City,69,18,29,2,1,1,51
Illinois,Fairbury,3597,798,1283,483,0,396,2960
Illinois,Kingston Mines village,307,72,130,27,0,20,249
Illinois,Franklin Grove village,955,204,378,82,0,125,789
Illinois,Sheldon village,1305,262,476,236,15,76,1065
Illinois,Wyanet village,1024,237,435,61,5,52,790
Illinois,Metamora village,3835,619,1632,393,16,251,2911
Illinois,Fairmont,2641,1033,620,236,80,122,2091
Illinois,Rock Falls,8911,2197,3248,1102,177,491,7215
Illinois,Carol Stream village,39989,10118,17262,3106,381,1530,32397
Illinois,Humboldt village,500,67,215,73,13,22,390
Illinois,Sherman village,4440,603,2362,336,38,324,3663
Illinois,Ivesdale village,232,37,124,16,1,24,202
Illinois,Savanna,2977,762,1177,247,37,310,2533
Illinois,Braceville village,779,204,316,62,2,26,610
Illinois,Blue Mound village,1142,203,428,134,5,64,834
Illinois,Clay City village,849,162,345,84,0,57,648
Illinois,Bingham village,100,14,24,27,4,9,78
Illinois,Alpha village,555,74,251,58,2,31,416
Illinois,Atkinson,1281,287,515,105,0,47,954
Illinois,Cambridge village,2238,459,1096,164,20,116,1855
Illinois,Woodhull village,817,156,385,54,11,67,673
Illinois,Barrington village,10304,1860,4975,697,112,573,8217
Illinois,Wamac,1178,301,311,185,45,69,911
Illinois,Mahomet village,8327,1699,4232,452,21,337,6741
Illinois,Sadorus village,321,80,124,47,2,20,273
Illinois,Burr Ridge village,10795,1546,6346,558,72,642,9164
Illinois,Downers Grove village,49644,11573,22707,3643,346,2284,40553
Illinois,McCook village,261,72,84,31,3,30,220
Illinois,Mount Prospect village,55127,11392,26244,3095,539,2594,43864
Illinois,Oak Forest,27843,7596,12241,1989,137,1302,23265
Illinois,Olympia Fields village,5055,1273,2026,467,62,503,4331
Illinois,Oak Brook village,8122,1328,4658,410,34,798,7228
Illinois,New Minden village,163,36,100,15,2,4,157
Illinois,Harrisburg,8958,1875,3119,1646,200,612,7452
Illinois,Mount Morris village,2841,715,987,354,19,314,2389
Illinois,Plano,11766,3274,4054,773,191,455,8747
Illinois,Yorkville,19145,4381,7346,1666,98,446,13937
Illinois,Harristown village,1143,219,538,120,27,75,979
Illinois,Macon,1152,250,481,141,7,53,932
Illinois,Warrensburg village,1506,392,523,139,50,43,1147
Illinois,Alto Pass village,278,72,129,37,1,8,247
Illinois,Flora,4842,1039,1595,1006,46,296,3982
Illinois,Andover village,563,108,279,29,0,28,444
Illinois,Annawan,895,192,343,106,15,83,739
Illinois,Deerfield village,18930,3122,9628,1339,83,752,14924
Illinois,Bethalto village,9311,1601,3643,1372,84,735,7435
Illinois,East Alton village,6099,1402,1977,1025,57,448,4909
Illinois,Mendon village,915,165,405,98,17,76,761
Illinois,Mount Auburn village,562,96,282,31,2,27,438
Illinois,Rapids City village,1047,175,581,48,2,42,848
Illinois,Alhambra village,628,154,180,118,0,68,520
Illinois,Green Oaks village,3851,879,2022,106,8,103,3118
Illinois,South Barrington village,4872,591,2622,92,69,271,3645
Illinois,Auburn,4805,1257,1890,507,22,224,3900
Illinois,Princeville village,2073,400,763,179,68,127,1537
Illinois,Mechanicsburg village,729,171,300,62,12,40,585
Illinois,De Soto village,1635,414,566,215,18,87,1300
Illinois,Makanda village,575,115,241,53,15,19,443
Illinois,Lee village,335,89,111,35,0,17,252
Illinois,Sublette village,454,118,194,38,2,30,382
Illinois,Buffalo village,560,116,237,76,0,14,443
Illinois,Chatham village,12535,2183,5684,1383,123,280,9653
Illinois,Poplar Grove village,4757,877,2162,207,31,23,3300
Illinois,Rochester village,3696,596,1676,332,31,144,2779
Illinois,Cedar Point village,296,67,114,38,0,15,234
Illinois,Lostant village,472,107,191,45,3,24,370
Illinois,Central City village,1259,270,470,172,10,46,968
Illinois,Sandoval village,1269,296,432,178,13,31,950
Illinois,Sims village,138,28,56,21,2,15,122
Illinois,Oneida,708,110,315,76,11,26,538
Illinois,Cisne village,598,116,220,92,12,88,528
Illinois,Belvidere,25319,6681,8734,2971,244,1227,19857
Illinois,Ferris village,106,19,58,7,1,9,94
Illinois,Sesser,1737,333,744,178,77,69,1401
Illinois,Addieville village,344,90,135,35,3,18,281
Illinois,Dixmoor village,3657,1356,939,337,67,70,2769
Illinois,Oakwood village,1770,397,599,293,13,82,1384
Illinois,Sleepy Hollow village,3319,724,1776,177,10,161,2848
Illinois,Schram City village,632,160,298,51,0,61,570
Illinois,Tower Hill village,790,173,356,64,5,17,615
Illinois,Winthrop Harbor village,6767,1512,3299,604,8,278,5701
Illinois,Villa Grove,2332,590,963,261,15,138,1967
Illinois,Rockton village,7692,1675,3366,839,92,349,6321
Illinois,Flat Rock village,338,36,174,41,1,19,271
Illinois,Dawson village,667,182,257,81,4,17,541
Illinois,Orland Hills village,7181,1776,3066,373,74,148,5437
Illinois,Wheeler village,175,33,54,15,0,10,112
Illinois,La Rose village,105,17,38,23,3,9,90
Illinois,Northbrook village,33463,5067,18481,1661,202,2216,27627
Illinois,Girard,1862,386,727,230,17,125,1485
Illinois,Ripley village,53,10,17,7,0,7,41
Illinois,Mount Clare village,266,33,121,40,8,18,220
Illinois,Wilmette village,27419,4479,14044,1325,121,1196,21165
Illinois,Stillman Valley village,1091,183,490,105,3,66,847
Illinois,Galatia village,833,178,287,139,30,77,711
Illinois,Hoyleton village,598,174,207,41,10,23,455
Illinois,Kirkwood village,721,115,302,94,16,45,572
Illinois,Oblong village,1313,312,443,176,45,103,1079
Illinois,Canton,13789,4306,4173,2193,213,962,11847
Illinois,Adeline village,111,22,60,2,0,8,92
Illinois,Dunfermline village,388,72,131,64,0,28,295
Illinois,Rose Hill village,84,16,18,26,0,1,61
Illinois,Russellville village,94,17,17,32,2,17,85
Illinois,Forreston village,1651,312,664,184,6,99,1265
Illinois,East Moline,21373,5536,7499,2142,292,1670,17139
Illinois,Muddy village,48,9,13,10,9,2,43
Illinois,Ashley,538,82,206,58,20,46,412
Illinois,Ipava village,491,97,241,25,13,30,406
Illinois,Lacon,1815,415,705,182,45,200,1547
Illinois,Farmington,2454,484,999,289,16,138,1926
Illinois,Avon village,767,181,273,110,8,42,614
Illinois,Palatine village,68847,16711,29766,5258,902,2637,55274
Illinois,Rosemont village,4315,1401,1522,285,51,145,3404
Illinois,South Holland village,21866,6778,7133,1897,413,1285,17506
Illinois,Cherry village,469,108,202,44,0,17,371
Illinois,De Pue village,1651,453,630,102,20,51,1256
Illinois,Mineral village,231,54,101,27,1,23,206
Illinois,Harvey,24599,10359,5312,1718,608,1391,19388
Illinois,Justice village,12919,3959,4189,1106,186,651,10091
Illinois,Kenilworth village,2512,416,1241,107,5,67,1836
Illinois,Lincolnwood village,12539,2488,6417,385,49,957,10296
Illinois,Maeystown village,104,24,37,14,1,1,77
Illinois,Waterloo,10268,1716,4960,803,113,554,8146
Illinois,Wyoming,1365,288,576,125,19,112,1120
Illinois,Lake Summerset,2019,379,1181,156,31,58,1805
Illinois,Roscoe village,10575,1913,4975,711,95,361,8055
Illinois,Shipman,624,174,228,101,2,16,521
Illinois,Creston village,665,221,231,64,9,20,545
Illinois,Stoy village,87,26,41,3,3,4,77
Illinois,Table Grove village,501,82,182,57,1,27,349
Illinois,Compton village,299,51,139,29,3,4,226
Illinois,Divernon village,1098,233,498,90,8,81,910
Illinois,Keenes village,67,9,40,7,0,7,63
Illinois,Mount Erie village,74,10,40,7,2,5,64
Illinois,Leland Grove,1457,201,849,119,3,83,1255
Illinois,Prairie City village,413,87,178,35,3,23,326
Illinois,La Fayette village,207,59,80,20,1,11,171
Illinois,Apple River village,415,88,176,34,6,18,322
Illinois,Winslow village,313,86,109,22,2,20,239
Illinois,Hanover village,645,172,254,87,7,48,568
Illinois,Florence village,61,14,22,11,0,3,50
Illinois,New Canton,363,79,130,67,12,9,297
Illinois,Arlington village,212,55,108,13,1,6,183
Illinois,La Moille village,771,132,381,62,12,29,616
Illinois,Manlius village,347,77,128,45,1,38,289
Illinois,Neponset village,539,110,227,59,5,27,428
Illinois,Jewett village,288,68,111,54,0,21,254
Illinois,Winnebago village,3425,688,1660,224,30,95,2697
Illinois,Findlay village,728,157,349,73,0,27,606
Illinois,Old Shawneetown village,100,30,18,25,3,4,80
Illinois,Orangeville village,803,207,282,88,11,62,650
Illinois,Benson village,496,112,212,36,1,31,392
Illinois,Ottawa,18701,4771,7009,1913,283,1206,15182
Illinois,Basco village,77,7,41,7,1,11,67
Illinois,Bismarck village,614,113,301,33,13,35,495
Illinois,Gillespie,3045,584,1344,338,64,150,2480
Illinois,Nilwood,204,21,118,32,1,9,181
Illinois,Palmyra village,651,166,242,98,5,45,556
Illinois,Harwood Heights village,8552,2327,3905,640,113,403,7388
Illinois,Chicago Heights,30087,10933,8393,1796,694,1596,23412
Illinois,Dixon,15496,4414,5355,2026,248,985,13028
Illinois,Chicago Ridge village,14254,3413,5353,1266,136,633,10801
Illinois,Homewood village,19592,5115,7691,1715,337,1063,15921
Illinois,Roseville village,923,180,359,128,33,101,801
Illinois,Spring Grove village,5792,1016,3315,167,17,161,4676
Illinois,Woodstock,25198,6619,9476,2792,332,1015,20234
Illinois,Witt,896,177,397,106,7,41,728
Illinois,Mound City,653,225,158,95,0,51,529
Illinois,Mounds,926,232,250,107,39,43,671
Illinois,Pulaski village,264,107,71,17,2,37,234
Illinois,Elmwood Park village,24680,6840,9497,2261,477,1414,20489
Illinois,Omaha village,280,30,166,14,3,9,222
Illinois,Park City,7456,2703,1997,439,124,213,5476
Illinois,Coatsburg village,186,49,90,18,1,3,161
Illinois,Glenview village,47333,8804,23370,2650,239,2946,38009
Illinois,Chatsworth,1196,250,455,97,16,97,915
Illinois,Allendale village,698,130,281,62,0,30,503
Illinois,Greenup village,1705,411,586,240,30,126,1393
Illinois,Potomac village,807,181,252,62,17,45,557
Illinois,Clayton village,634,172,219,74,10,43,518
Illinois,Bridgeview village,16440,5082,5783,1396,244,905,13410
Illinois,Carrier Mills village,1938,406,745,227,35,122,1535
Illinois,Galesburg,30986,10101,9258,4011,618,2154,26142
Illinois,Sauk Village village,10516,4314,2427,811,73,349,7974
Illinois,Kaskaskia village,10,4,4,0,0,2,10
Illinois,Ransom village,386,103,156,37,11,12,319
Illinois,Topeka village,106,17,54,20,3,2,96
Illinois,Bluffs village,759,177,306,72,7,18,580
Illinois,Norris village,140,34,45,14,1,21,115
Illinois,Abingdon,3452,963,1110,462,55,204,2794
Illinois,Catlin village,2077,412,866,220,5,151,1654
Illinois,Brighton village,2215,387,950,234,38,129,1738
Indiana,Center Point,303,29,120,51,1,16,217
Indiana,Mount Summit,468,124,184,65,2,18,393
Indiana,Lewisville,408,72,182,27,3,30,314
Indiana,Royal Center,828,176,299,101,0,54,630
Indiana,Madison,11890,3011,4148,1950,190,908,10207
Indiana,Memphis,935,157,485,7,0,21,670
Indiana,San Pierre,65,15,20,30,0,0,65
Indiana,New Haven,16047,3615,6363,1773,174,791,12716
Indiana,Amo,530,93,219,73,8,3,396
Indiana,Etna Green,585,117,274,67,3,29,490
Indiana,Delphi,3139,730,1166,399,50,282,2627
Indiana,Toad Hop,178,78,33,4,0,0,115
Indiana,Vallonia,323,76,127,110,0,10,323
Indiana,Waldron,533,98,251,47,0,90,486
Indiana,West Point,582,43,277,34,0,0,354
Indiana,Wheeler,366,184,97,23,0,37,341
Indiana,Williams,283,78,19,122,0,64,283
Indiana,Fishers,88717,16265,41423,6095,627,2248,66658
Indiana,Westfield,37769,6570,17397,2633,185,1080,27865
Indiana,Fredericksburg,137,63,24,11,0,12,110
Indiana,Fillmore,646,150,284,77,2,41,554
Indiana,Orleans,2249,394,903,307,29,187,1820
Indiana,Albion,2472,676,796,333,43,153,2001
Indiana,Denver,463,101,196,64,8,20,389
Indiana,Evansville,118952,34113,37312,18118,1414,6731,97688
Indiana,Michiana Shores,231,28,137,28,2,18,213
Indiana,Elkhart,52308,14131,15405,6266,1049,2791,39642
Indiana,Advance,459,99,196,57,2,19,373
Indiana,Yeoman,118,38,34,17,1,3,93
Indiana,Montpelier,1837,480,569,283,30,126,1488
Indiana,Poseyville,1070,190,535,93,2,65,885
Indiana,Vincennes,17607,4983,5883,2272,245,1144,14527
Indiana,Burket,158,28,68,12,0,19,127
Indiana,Westphalia,82,33,32,0,9,8,82
Indiana,Chesterfield,2336,568,900,309,17,155,1949
Indiana,Van Bibber Lake,765,284,223,235,0,23,765
Indiana,Larwill,376,92,93,68,8,29,290
Indiana,Holton,548,90,210,73,3,17,393
Indiana,Riley,246,56,87,37,4,14,198
Indiana,Bristol,1577,433,607,175,24,86,1325
Indiana,Norway,560,110,233,87,20,18,468
Indiana,Darmstadt,1272,229,698,111,3,59,1100
Indiana,Arcadia,1370,263,548,143,9,74,1037
Indiana,Fairview Park,1167,270,484,205,13,57,1029
Indiana,Universal,252,53,120,24,0,26,223
Indiana,Newburgh,3253,820,1498,349,24,122,2813
Indiana,Windfall City,736,166,336,67,0,34,603
Indiana,Ingalls,2282,477,919,165,47,44,1652
Indiana,Wingate,248,58,79,47,8,14,206
Indiana,Clermont,1401,297,584,228,13,83,1205
Indiana,Elizabeth,157,32,79,7,0,10,128
Indiana,Aurora,3678,914,1340,413,87,222,2976
Indiana,Hidden Valley,5449,912,2825,347,45,107,4236
Indiana,Francesville,963,208,470,91,10,58,837
Indiana,New Albany,36512,10278,11899,5105,675,2242,30199
Indiana,Crandall,146,22,56,9,0,2,89
Indiana,Alamo,62,22,14,8,2,1,47
Indiana,New Ross,477,76,206,45,0,26,353
Indiana,Brooklyn,1403,254,715,128,15,46,1158
Indiana,Cordry Sweetwater Lakes,1224,199,714,115,0,35,1063
Indiana,Country Squire Lakes,3067,682,1040,593,61,174,2550
Indiana,Whitestown,7220,1082,3144,591,101,92,5010
Indiana,Brownsburg,25264,4815,11265,1813,741,1289,19923
Indiana,Crown Point,29368,6451,13264,2498,181,1803,24197
Indiana,Merom,240,35,98,37,0,14,184
Indiana,Modoc,208,60,55,21,6,14,156
Indiana,Medora,600,92,241,85,8,45,471
Indiana,Jasper,15765,3308,6740,1319,88,977,12432
Indiana,Akron,1196,284,443,120,0,19,866
Indiana,Hebron,3690,889,1452,310,25,123,2799
Indiana,Leo-Cedarville,3767,855,1718,211,14,86,2884
Indiana,Greensboro,148,33,38,9,0,5,85
Indiana,Montgomery,429,91,216,42,0,7,356
Indiana,De Motte,4026,1047,1549,449,59,270,3374
Indiana,Holland,694,160,294,51,4,30,539
Indiana,Hammond,77071,25497,22946,6885,1513,3737,60578
Indiana,Dublin,665,128,325,71,3,47,574
Indiana,Deputy,45,16,29,0,0,0,45
Indiana,Danville,9791,2192,4275,768,108,400,7743
Indiana,West Lebanon,638,128,298,55,8,62,551
Indiana,Clarks Hill,766,139,303,90,15,30,577
Indiana,Georgetown,3231,611,1471,203,31,122,2438
Indiana,Kingman,530,129,213,70,6,20,438
Indiana,North Crows Nest,47,12,23,0,0,0,35
Indiana,Tennyson,282,79,99,41,2,22,243
Indiana,Kingsbury,203,60,99,13,0,13,185
Indiana,Avilla,2204,500,916,220,13,164,1813
Indiana,Greentown,2564,482,1119,262,34,165,2062
Indiana,Leesburg,822,155,351,43,10,28,587
Indiana,Monon,1906,390,694,182,20,107,1393
Indiana,Lynn,1135,230,581,67,12,40,930
Indiana,Pierceton,910,184,353,118,3,69,727
Indiana,Tecumseh,779,108,393,58,0,38,597
Indiana,Dover Hill,13,0,0,13,0,0,13
Indiana,Dubois,127,60,25,0,0,42,127
Indiana,New Goshen,443,47,262,71,0,20,400
Indiana,New Salisbury,498,92,280,0,0,70,442
Indiana,New Trenton,225,10,173,42,0,0,225
Indiana,Notre Dame,6584,6428,48,72,0,36,6584
Indiana,Otwell,351,53,142,83,0,30,308
Indiana,Owensburg,648,86,388,10,0,32,516
Indiana,Painted Hills,627,80,203,161,0,30,474
Indiana,Parkers Settlement,630,69,364,60,0,36,529
Indiana,Point Isabel,181,49,33,41,0,11,134
Indiana,Raglesville,0,0,0,0,0,0,0
Indiana,Ragsdale,220,59,69,59,0,12,199
Indiana,Rolling Prairie,529,85,249,86,0,0,420
Indiana,St. Bernice,451,72,148,64,0,58,342
Indiana,St. Mary of the Woods,881,418,171,42,9,166,806
Indiana,St. Meinrad,731,219,354,43,0,16,632
Indiana,Salt Creek Commons,2125,505,878,129,19,67,1598
Indiana,Scipio,139,0,100,17,0,0,117
Indiana,Scotland,170,19,86,12,0,0,117
Indiana,Shelby,357,85,127,84,0,0,296
Indiana,Shepardsville,177,63,0,47,0,56,166
Indiana,Shorewood Forest,2742,449,1548,144,8,129,2278
Indiana,Sims,111,27,50,10,0,0,87
Indiana,Smithville-Sanders,3285,722,1555,382,15,95,2769
Indiana,Somerset,478,48,263,54,11,38,414
Indiana,Stockwell,385,46,133,85,25,9,298
Indiana,Montmorenci,332,40,190,21,0,0,251
Indiana,Milroy,645,163,298,36,8,67,572
Indiana,Mier,47,0,33,14,0,0,47
Indiana,Metamora,177,40,86,20,0,31,177
Indiana,East Enterprise,192,50,82,51,0,0,183
Indiana,Emison,198,0,129,16,0,29,174
Indiana,Fish Lake,1596,247,817,254,14,106,1438
Indiana,Florence,42,14,0,0,0,0,14
Indiana,Fontanet,286,60,170,35,0,21,286
Indiana,Freelandville,890,188,404,29,0,84,705
Indiana,Freetown,255,32,105,13,0,26,176
Indiana,Hanna,307,35,160,42,0,31,268
Indiana,Harlan,1540,325,565,77,36,81,1084
Indiana,Harrodsburg,795,103,422,49,0,8,582
Indiana,Hatfield,879,150,392,25,29,40,636
Indiana,Hayden,835,232,293,126,0,21,672
Indiana,Dresser,32,19,0,13,0,0,32
Indiana,Herbst,93,0,52,9,0,6,67
Indiana,Hoagland,885,210,339,45,13,103,710
Indiana,Howe,399,139,140,84,0,36,399
Indiana,Hudson Lake,1549,90,806,251,18,22,1187
Indiana,Idaville,555,137,220,31,14,28,430
Indiana,Jalapa,209,0,194,15,0,0,209
Indiana,Kent,72,0,0,40,0,0,40
Indiana,Kimmell,510,134,175,58,0,13,380
Indiana,Lake Holiday,1102,205,642,65,39,27,978
Indiana,Lake Santee,907,80,460,105,0,61,706
Indiana,Laketon,478,132,168,65,0,10,375
Indiana,Landess,53,0,46,0,0,7,53
Indiana,Manilla,315,95,69,43,0,33,240
Indiana,Heritage Lake,3152,809,1628,200,14,106,2757
Indiana,Granger,30815,5021,16514,1333,131,977,23976
Indiana,Spurgeon,143,27,69,23,0,4,123
Indiana,Portage,36859,9848,13536,4073,658,2055,30170
Indiana,Coatesville,609,151,261,49,15,26,502
Indiana,Jamestown,928,213,346,116,29,41,745
Indiana,Stilesville,261,47,134,37,5,18,241
Indiana,Mentone,1193,226,494,117,16,57,910
Indiana,Nappanee,6872,1179,2921,649,270,261,5280
Indiana,Middlebury,3572,468,1989,259,15,79,2810
Indiana,Sidney,72,16,20,9,3,10,58
Indiana,Bruceville,448,56,202,44,2,35,339
Indiana,Brazil,8288,1929,2894,933,145,513,6414
Indiana,Lizton,512,116,179,79,12,6,392
Indiana,Oolitic,1184,153,521,164,20,75,933
Indiana,Collegeville,562,535,19,0,0,8,562
Indiana,Camden,556,105,215,74,0,48,442
Indiana,Gosport,823,172,340,100,13,55,680
Indiana,Rosedale,751,162,292,106,7,28,595
Indiana,Lakes of the Four Seasons,7243,1412,3638,551,12,329,5942
Indiana,Ogden Dunes,1123,142,675,111,5,58,991
Indiana,Newtown,311,51,151,40,1,7,250
Indiana,Veedersburg,2059,466,757,321,23,102,1669
Indiana,Switz City,250,51,95,15,3,20,184
Indiana,Worthington,1178,194,459,191,19,114,977
Indiana,Fowlerton,310,37,139,40,3,20,239
Indiana,Shamrock Lakes,286,56,137,30,3,6,232
Indiana,Mount Auburn,106,16,37,22,0,12,87
Indiana,Fountain City,747,116,297,102,11,53,579
Indiana,East Germantown,339,61,160,35,12,29,297
Indiana,Elizabethtown,528,168,130,59,10,30,397
Indiana,Corunna,240,60,69,41,5,22,197
Indiana,Greenfield,21871,4644,8751,2353,238,1529,17515
Indiana,New Palestine,2235,412,1065,180,5,112,1774
Indiana,Jeffersonville,47175,11830,18195,5637,633,2087,38382
Indiana,New Washington,654,103,317,39,10,30,499
Indiana,Brooksburg,134,33,44,22,0,14,113
Indiana,Whiting,4845,1625,1386,394,154,294,3853
Indiana,Dune Acres,172,25,109,13,1,8,156
Indiana,Porter,4833,1285,2258,278,40,50,3911
Indiana,Vera Cruz,118,12,55,16,0,2,85
Indiana,Bloomfield,2126,510,695,450,15,192,1862
Indiana,Fairmount,2871,659,1058,346,49,131,2243
Indiana,Birdseye,521,81,250,43,4,30,408
Indiana,State Line City,195,26,99,29,0,9,163
Indiana,Boswell,775,198,281,80,3,36,598
Indiana,Grabill,1325,192,675,125,12,37,1041
Indiana,Lake Dalecarlia,1690,428,510,318,0,41,1297
Indiana,Dunreith,177,39,58,22,4,13,136
Indiana,Middletown,2554,612,895,346,6,129,1988
Indiana,Highland,22743,5563,9234,2533,162,1450,18942
Indiana,Lake Station,12059,3405,3693,1206,325,436,9065
Indiana,St. John,16839,3071,8719,890,30,604,13314
Indiana,Matthews,664,121,278,106,1,46,552
Indiana,Sweetser,1452,210,708,153,9,110,1190
Indiana,Laconia,83,6,54,18,0,2,80
Indiana,Mauckport,62,22,15,10,6,1,54
Indiana,Greenwood,56791,12986,22347,6072,419,2703,44527
Indiana,Tipton,5137,1134,2106,451,52,355,4098
Indiana,Pine Village,213,53,65,37,3,16,174
Indiana,Williamsport,1814,299,838,233,29,87,1486
Indiana,Whiteland,4394,1320,1826,470,13,140,3769
Indiana,Stinesville,223,59,54,41,4,22,180
Indiana,Alexandria,5025,1033,1988,496,57,380,3954
Indiana,East Chicago,28448,9610,7554,2431,487,1390,21472
Indiana,Winamac,2710,623,999,363,27,196,2208
Indiana,Lafayette,72444,22150,23601,8690,1164,3038,58643
Indiana,Hagerstown,1826,460,725,217,15,98,1515
Indiana,West Terre Haute,2216,597,670,341,38,146,1792
Indiana,Centerville,2562,473,883,450,55,160,2021
Indiana,Economy,133,35,63,15,0,7,120
Indiana,Bedford,13285,2517,5097,2222,93,1036,10965
Indiana,Lake Village,851,273,332,13,0,36,654
Indiana,Morocco,1067,211,411,105,11,101,839
Indiana,French Lick,1832,383,523,294,0,170,1370
Indiana,Greencastle,10461,3946,2941,1075,116,741,8819
Indiana,Russellville,356,93,132,40,10,20,295
Indiana,Patoka,1233,431,319,186,7,37,980
Indiana,Princeton,8627,2021,2995,1283,89,498,6886
Indiana,West Harrison,240,70,61,34,2,19,186
Indiana,Crows Nest,98,36,41,4,0,2,83
Indiana,Columbus,47227,10815,19005,4889,609,2355,37673
Indiana,Hymera,757,200,267,109,21,47,644
Indiana,Chesterton,13899,3054,5900,1292,148,838,11232
Indiana,Muncie,69164,28827,18420,7679,891,3552,59369
Indiana,Spencer,2272,495,767,401,49,129,1841
Indiana,Marshall,235,22,143,28,0,11,204
Indiana,Montezuma,990,163,431,121,0,40,755
Indiana,Bluffton,9855,2213,3963,944,104,653,7877
Indiana,Ossian,3361,576,1470,247,10,298,2601
Indiana,Uniondale,331,63,117,52,6,18,256
Indiana,Zanesville,611,87,325,70,0,19,501
Indiana,Elwood,8449,1767,3092,1294,158,569,6880
Indiana,Oxford,1165,303,495,121,3,48,970
Indiana,Chrisney,724,101,342,64,8,31,546
Indiana,Bryant,173,24,79,23,0,10,136
Indiana,Redkey,1561,398,565,169,16,113,1261
Indiana,Bargersville,6950,1129,3343,549,29,167,5217
Indiana,Galena,1566,274,693,122,8,120,1217
Indiana,Lanesville,675,177,268,79,7,31,562
Indiana,Darlington,822,186,322,123,8,47,686
Indiana,Trafalgar,1286,254,575,138,6,21,994
Indiana,Markleville,474,123,189,61,2,16,391
Indiana,Dayton,1569,265,741,192,6,41,1245
Indiana,West Lafayette,47224,31357,9411,1262,130,1202,43362
Indiana,Chandler,3424,868,1359,326,28,115,2696
Indiana,Burns Harbor,1605,427,546,205,14,36,1228
Indiana,Rensselaer,5757,1186,2201,737,31,402,4557
Indiana,Cannelburg,174,31,95,12,0,9,147
Indiana,Dugger,787,215,380,75,6,34,710
Indiana,Remington,1350,301,609,140,23,74,1147
Indiana,Albany,2005,403,838,231,67,161,1700
Indiana,Edwardsport,326,61,140,30,2,30,263
Indiana,Syracuse,2883,759,1039,412,9,144,2363
Indiana,Winona Lake,4921,1464,1914,409,109,213,4109
Indiana,Oaktown,674,119,270,75,4,59,527
Indiana,Wolcott,1095,232,473,127,4,57,893
Indiana,Highland,4846,811,2476,274,0,202,3763
Indiana,Buffalo,729,71,484,70,25,7,657
Indiana,Chalmers,499,73,175,81,3,27,359
Indiana,West College Corner,620,178,211,75,4,41,509
Indiana,McCordsville,6523,1179,3332,407,0,110,5028
Indiana,Lakeville,828,203,283,122,12,41,661
Indiana,Roseland,475,174,136,74,2,37,423
Indiana,South Haven,5159,1194,2066,560,73,224,4117
Indiana,Mooresville,9604,2087,3979,992,167,749,7974
Indiana,Churubusco,1800,387,736,150,20,111,1404
Indiana,Lagro,479,107,158,66,8,27,366
Indiana,Kouts,1972,392,861,207,4,135,1599
Indiana,Town of Pines,691,157,274,86,19,44,580
Indiana,Valparaiso,32916,10340,11714,3249,444,1709,27456
Indiana,Gas City,5844,1139,2183,908,40,327,4597
Indiana,Marion,28118,9239,8011,4004,355,1797,23406
Indiana,Bethany,60,20,28,5,0,1,54
Indiana,Connersville,13069,2641,4627,2248,177,988,10681
Indiana,Swayzee,896,102,456,80,14,65,717
Indiana,Hamlet,613,153,239,70,2,39,503
Indiana,Richmond,35653,9515,11392,5169,537,2496,29109
Indiana,Covington,2424,398,1108,326,24,173,2029
Indiana,Hillsboro,560,90,263,36,6,28,423
Indiana,Jasonville,1749,255,688,194,33,134,1304
Indiana,Carbon,470,119,157,45,13,25,359
Indiana,Oldenburg,542,158,219,41,9,49,476
Indiana,Burlington,510,100,223,78,2,32,435
Indiana,Grissom AFB,2452,781,625,351,79,88,1924
Indiana,Peru,11460,2677,3937,1606,197,636,9053
Indiana,New Chicago,1653,565,469,282,21,82,1419
Indiana,Gary,76677,28509,16706,9091,1384,5323,61013
Indiana,Hobart,28309,6561,11539,2820,367,1602,22889
Indiana,Munster,22840,5185,10440,1674,140,1564,19003
Indiana,Lawrence,48405,13924,16996,4058,535,1902,37415
Indiana,Spring Lake,250,46,140,23,4,18,231
Indiana,Marengo,690,104,255,129,5,54,547
Indiana,Taylorsville,934,229,363,93,0,16,701
Indiana,St. Joe,409,86,118,56,4,13,277
Indiana,Galveston,1163,178,499,171,18,67,933
Indiana,Borden,1171,237,404,93,19,73,826
Indiana,Utica,628,164,238,117,5,25,549
Indiana,Schererville,28698,7139,12611,2740,144,1611,24245
Indiana,Schneider,238,77,81,18,2,10,188
Indiana,Winfield,5543,925,2726,248,0,429,4328
Indiana,Goodland,1072,209,376,185,31,76,877
Indiana,Beverly Shores,563,96,350,58,2,42,548
Indiana,New Middletown,113,30,37,12,0,7,86
Indiana,Scottsburg,6696,1558,2462,849,141,381,5391
Indiana,Speedway,12188,3510,3863,1476,94,646,9589
Indiana,Bicknell,3003,584,1094,437,50,198,2363
Indiana,Monroe City,674,97,268,59,0,33,457
Indiana,Troy,393,91,192,59,2,19,363
Indiana,New Harmony,674,125,279,116,3,81,604
Indiana,Loogootee,2560,625,769,572,30,173,2169
Indiana,Crane,243,38,90,31,4,10,173
Indiana,Shoals,732,150,258,101,21,80,610
Indiana,La Crosse,601,116,225,102,17,9,469
Indiana,Michigan City,31251,10306,8625,4283,325,1655,25194
Indiana,La Paz,643,158,191,88,0,32,469
Indiana,Kendallville,9522,2123,3443,1462,117,689,7834
Indiana,Ligonier,4654,1066,1608,487,119,111,3391
Indiana,Brookston,1456,321,538,195,12,67,1133
Indiana,Glenwood,252,52,103,36,2,6,199
Indiana,Russiaville,1032,156,477,141,3,40,817
Indiana,Blountsville,96,12,43,17,2,5,79
Indiana,Knightstown,2270,675,730,230,27,144,1806
Indiana,Mooreland,291,67,110,29,5,21,232
Indiana,Carlisle,691,161,246,108,3,56,574
Indiana,Woodburn,1644,384,648,166,9,72,1279
Indiana,Parker City,1327,224,535,205,2,121,1087
Indiana,Saratoga,272,63,76,54,3,20,216
Indiana,Princes Lakes,1659,353,801,279,3,45,1481
Indiana,New Market,609,167,252,58,14,7,498
Indiana,Portland,5996,1597,1839,750,105,478,4769
Indiana,Sharpsville,868,163,359,118,15,38,693
Indiana,Angola,8645,2849,2457,1061,121,659,7147
Indiana,New Richmond,286,43,143,15,0,12,213
Indiana,Waynetown,1042,187,486,73,12,49,807
Indiana,Columbia City,9084,2267,3515,1129,83,521,7515
Indiana,La Fontaine,877,200,403,98,10,69,780
Indiana,Napoleon,186,40,58,27,10,19,154
Indiana,Upland,3537,1723,1066,127,8,186,3110
Indiana,Bass Lake,1430,165,639,118,14,50,986
Indiana,Union City,3396,830,876,536,38,305,2585
Indiana,Shelburn,1339,251,536,161,7,60,1015
Indiana,Alfordsville,61,7,39,8,0,2,56
Indiana,Odon,1526,252,585,190,38,171,1236
Indiana,Seymour,19357,3402,7325,2494,308,1357,14886
Indiana,Ferdinand,2000,476,931,110,14,203,1734
Indiana,Daleville,1636,350,689,220,17,81,1357
Indiana,Losantville,238,43,89,44,10,22,208
Indiana,Farmersburg,1284,194,552,170,4,56,976
Indiana,Elnora,581,133,257,68,0,48,506
Indiana,Plainville,393,33,216,65,0,22,336
Indiana,Huntington,17147,4606,6412,2032,151,936,14137
Indiana,Warren,1288,217,592,175,5,133,1122
Indiana,Shipshewana,918,154,420,69,9,32,684
Indiana,Warren Park,1622,429,445,233,25,276,1408
Indiana,Fowler,2282,573,753,348,51,172,1897
Indiana,Ridgeville,539,91,188,76,13,35,403
Indiana,Owensville,1356,311,539,156,17,122,1145
Indiana,Southport,1848,385,708,153,10,99,1355
Indiana,Yorktown,11178,1959,5237,1307,62,617,9182
Indiana,South Bend,102233,32799,29470,9375,2036,4822,78502
Indiana,New Carlisle,1911,439,767,147,38,78,1469
Indiana,Dupont,297,43,147,28,12,1,231
Indiana,Waterloo,2222,429,891,255,9,37,1621
Indiana,Garrett,6661,1553,2297,922,58,369,5199
Indiana,Altona,333,86,113,36,6,12,253
Indiana,Andrews,938,134,427,156,24,48,789
Indiana,Hartsville,411,103,148,59,3,19,332
Indiana,English,670,174,224,69,6,67,540
Indiana,Alton,34,11,14,6,0,3,34
Indiana,Spring Hill,75,9,40,19,0,7,75
Indiana,Indianapolis city (balance),857637,285760,256958,88338,12825,34649,678530
Indiana,Long Beach,1108,104,694,84,5,88,975
Indiana,La Porte,21874,5636,7024,3016,131,1291,17098
Indiana,Dunlap,6115,1334,2871,392,121,234,4952
Indiana,Clifford,247,81,66,57,14,14,232
Indiana,Hartford City,5929,1112,2481,565,175,347,4680
Indiana,Michigantown,521,96,182,56,14,37,385
Indiana,Patriot,446,80,153,50,11,4,298
Indiana,Wheatland,473,97,182,68,0,16,363
Indiana,Warsaw,15062,3611,5428,1909,101,661,11710
Indiana,Winslow,906,158,292,148,16,40,654
Indiana,Mexico,751,118,398,121,0,50,687
Indiana,Macy,249,61,89,12,4,6,172
Indiana,Culver,1211,206,553,167,12,110,1048
Indiana,Griffith,16377,4997,5778,1646,106,893,13420
Indiana,Bloomingdale,307,43,141,28,6,14,232
Indiana,Sandborn,398,54,205,52,2,27,340
Indiana,Hope,2441,484,956,306,24,103,1873
Indiana,Rossville,1700,288,659,168,28,148,1291
Indiana,Mulberry,1290,201,524,105,9,189,1028
Indiana,Bloomington,84058,47742,18960,6756,566,2472,76496
Indiana,Dale,1442,259,611,170,6,118,1164
Indiana,Dunkirk,2111,430,841,273,50,130,1724
Indiana,Kirklin,822,178,284,144,5,30,641
Indiana,Jonesville,236,56,90,30,0,16,192
Indiana,Tell City,7270,1231,2907,965,98,520,5721
Indiana,Cynthiana,627,134,270,70,6,28,508
Indiana,Claypool,520,128,203,55,16,16,418
Indiana,Sulphur Springs,287,74,119,33,0,22,248
Indiana,Lowell,9546,2242,3796,783,134,572,7527
Indiana,Butler,2729,665,867,441,28,138,2139
Indiana,Fortville,4460,747,1863,543,104,402,3659
Indiana,Milford,1444,291,585,184,27,68,1155
Indiana,New Point,354,89,129,35,3,21,277
Indiana,Hamilton,1466,315,710,148,16,81,1270
Indiana,Clarksville,21336,5138,7026,3017,625,1688,17494
Indiana,Fairland,684,166,273,67,1,65,572
Indiana,Aberdeen,1463,257,614,168,40,90,1169
Indiana,Americus,349,48,209,17,0,14,288
Indiana,Arlington,420,27,196,54,6,40,323
Indiana,Austin,3879,947,1666,379,41,196,3229
Indiana,Avoca,894,144,480,0,34,44,702
Indiana,Blanford,245,33,150,34,0,14,231
Indiana,Buck Creek,150,11,26,89,0,24,150
Indiana,Richland,440,70,216,37,3,17,343
Indiana,Cannelton,1541,379,501,251,24,55,1210
Indiana,Clinton,4743,1006,1576,903,19,389,3893
Indiana,Milan,1958,535,672,210,21,160,1598
Indiana,Clayton,998,165,478,67,0,41,751
Indiana,Laurel,548,134,165,73,15,46,433
Indiana,Staunton,435,82,229,41,4,12,368
Indiana,Roselawn,4599,721,2218,275,37,189,3440
Indiana,West Baden Springs,475,100,214,68,9,42,433
Indiana,Roachdale,905,207,344,116,16,39,722
Indiana,Bright,5649,1392,2597,273,12,456,4730
Indiana,Edinburgh,4671,1183,1782,614,35,249,3863
Indiana,Dillsboro,1551,362,513,145,29,156,1205
Indiana,Winchester,4924,1238,1860,566,58,407,4129
Indiana,Brownstown,2945,623,1028,503,13,193,2360
Indiana,Cromwell,452,79,173,55,3,17,327
Indiana,Burnettsville,418,88,193,30,2,22,335
Indiana,Cadiz,236,49,86,19,0,4,158
Indiana,New Castle,17402,4168,5833,2787,264,1179,14231
Indiana,Hudson,504,100,190,73,5,13,381
Indiana,Greendale,4165,1000,1706,501,56,299,3562
Indiana,Mount Vernon,6513,1514,2682,978,23,292,5489
Indiana,Vernon,388,54,152,63,6,41,316
Indiana,Markle,1399,307,561,164,7,105,1144
Indiana,Hanover,3504,1459,931,425,30,171,3016
Indiana,Indian Village,133,39,64,17,0,3,123
Indiana,North Liberty,1842,293,747,191,8,101,1340
Indiana,Noblesville,61558,13052,26438,5073,583,2030,47176
Indiana,Mellott,179,29,89,12,0,18,148
Indiana,Wallace,91,13,39,8,0,15,75
Indiana,Lyons,733,128,289,111,20,57,605
Indiana,Sellersburg,9013,1705,3614,790,277,505,6891
Indiana,Greensburg,11712,2544,4228,1652,162,785,9371
Indiana,Orestes,515,123,202,50,6,28,409
Indiana,Koontz Lake,1538,260,761,202,0,46,1269
Indiana,Pendleton,4213,724,2032,463,28,214,3461
Indiana,Gentryville,328,55,103,51,2,36,247
Indiana,Grandview,852,160,392,84,9,54,699
Indiana,Edgewood,2156,344,958,258,10,144,1714
Indiana,Mount Etna,112,17,67,12,1,2,99
Indiana,Anderson,54788,14689,17181,8548,1058,3238,44714
Indiana,Kennard,507,82,205,30,6,6,329
Indiana,Henryville,2106,453,718,349,71,108,1699
Indiana,Tri-Lakes,1643,197,909,106,0,65,1277
Indiana,Milltown,896,176,357,140,10,53,736
Indiana,Ladoga,1179,176,429,142,17,85,849
Indiana,Linden,711,80,334,85,6,49,554
Indiana,Paragon,653,146,272,58,7,28,511
Indiana,North Manchester,5917,1962,1898,515,152,488,5015
Indiana,Roann,412,87,159,51,8,28,333
Indiana,Fort Branch,2998,658,1243,299,47,146,2393
Indiana,Charlestown,8134,1766,2855,1116,148,555,6440
Indiana,Osgood,1886,513,610,253,16,113,1505
Indiana,Kewanna,535,124,172,145,16,32,489
Indiana,Rochester,6043,1227,2255,997,0,438,4917
Indiana,Mecca,368,46,159,27,7,16,255
Indiana,New Amsterdam,23,7,12,0,0,3,22
Indiana,Martinsville,11646,2552,3665,2111,234,743,9305
Indiana,Morgantown,1030,197,343,186,21,86,833
Indiana,South Whitley,1837,350,734,285,45,63,1477
Indiana,Eaton,1833,396,727,229,17,100,1469
Indiana,Springport,145,33,62,30,2,10,137
Indiana,Nashville,1349,254,543,213,24,149,1183
Indiana,Salamonia,224,63,48,24,0,9,144
Indiana,Kentland,1853,419,656,279,29,129,1512
Indiana,Flora,1968,340,822,283,6,127,1578
Indiana,North Vernon,6662,1555,2222,1081,101,517,5476
Indiana,Lebanon,15816,3609,5983,2319,107,1021,13039
Indiana,Thorntown,1429,333,547,173,17,92,1162
Indiana,Ulen,213,37,124,7,0,4,172
Indiana,Argos,1795,357,648,255,24,45,1329
Indiana,Brook,1065,252,383,134,32,57,858
Indiana,Plymouth,9996,2403,3638,1196,72,540,7849
Indiana,Versailles,2039,477,751,322,0,97,1647
Indiana,Wheatfield,952,203,334,126,0,47,710
Indiana,Washington,12069,2703,4298,1461,88,837,9387
Indiana,Huntingburg,6634,1181,2426,853,61,434,4955
Indiana,Gaston,837,178,292,129,8,45,652
Indiana,Selma,885,229,334,90,15,56,724
Indiana,Fulton,354,65,143,42,15,14,279
Indiana,Bunker Hill,494,80,206,89,7,24,406
Indiana,Whitewater,69,6,34,7,0,2,49
Indiana,Spring Grove,447,68,185,52,10,86,401
Indiana,Saltillo,80,10,35,15,0,12,72
Indiana,Frankton,1980,449,824,212,19,98,1602
Indiana,Rising Sun,2091,405,965,228,53,149,1800
Indiana,Monrovia,1500,356,662,116,6,13,1153
Indiana,Mishawaka,48926,14457,15573,6585,463,3024,40102
Indiana,Walkerton,2240,412,948,199,22,148,1729
Indiana,Liberty,1881,362,728,315,13,116,1534
Indiana,Haubstadt,1596,256,780,132,2,89,1259
Indiana,Hazleton,392,46,170,49,7,27,299
Indiana,Somerville,299,53,147,13,0,14,227
Indiana,Atlanta,890,164,369,104,10,37,684
Indiana,Carmel,90163,16689,45134,5661,364,2703,70551
Indiana,St. Leon,802,154,400,38,0,45,637
Indiana,Lawrenceburg,4979,1319,1313,857,59,491,4039
Indiana,Westport,1324,223,582,150,3,84,1042
Indiana,Hardinsburg,177,18,92,26,6,12,154
Indiana,New Pekin,1647,390,511,245,43,102,1291
Indiana,Salem,6181,1217,2138,1112,99,475,5041
Indiana,Burns City,143,20,115,8,0,0,143
Indiana,Butlerville,267,115,31,66,0,15,227
Indiana,Pottawattamie Park,256,42,142,30,1,15,230
Indiana,Clarksburg,75,1,24,47,0,0,72
Indiana,Sullivan,4109,761,1488,728,18,377,3372
Indiana,Crothersville,1755,289,706,228,20,75,1318
Indiana,Homecroft,662,188,299,47,15,17,566
Indiana,Millhousen,150,22,75,14,0,6,117
Indiana,Sheridan,2847,614,941,401,53,132,2141
Indiana,Cicero,4861,921,2487,534,102,131,4175
Indiana,Bainbridge,779,190,390,66,8,18,672
Indiana,Paoli,3697,799,1238,671,45,327,3080
Indiana,Mount Ayr,111,14,54,17,0,2,87
Indiana,Mitchell,4270,477,1684,694,122,397,3374
Indiana,Franklin,24813,5458,9847,2891,179,1670,20045
Indiana,New Whiteland,5955,1134,2177,862,92,265,4530
Indiana,Summitville,929,167,357,132,15,44,715
Indiana,Rockport,2419,477,841,335,23,192,1868
Indiana,Santa Claus,2601,440,1277,222,9,122,2070
Indiana,Farmland,1290,236,526,200,6,53,1021
Indiana,Battle Ground,1665,454,790,104,34,45,1427
Indiana,Fort Wayne,264052,72968,92583,26409,2731,12464,207155
Indiana,Rushville,6149,1291,2355,1021,124,405,5196
Indiana,Monroeville,1185,308,446,92,22,141,1009
Indiana,Berne,3962,656,1756,292,53,366,3123
Indiana,Carthage,894,127,327,160,7,42,663
Indiana,Cloverdale,1831,389,677,329,36,107,1538
Indiana,Milton,344,54,121,72,5,23,275
Indiana,Terre Haute,60691,21929,17496,7724,835,3021,51005
Indiana,Silver Lake,951,229,323,131,34,48,765
Indiana,Pittsboro,3298,452,1665,208,30,90,2445
Indiana,North Salem,508,108,271,44,0,33,456
Indiana,Mount Carmel,43,14,18,2,0,2,36
Indiana,Cedar Grove,152,45,66,16,0,6,133
Indiana,Brookville,2546,539,1060,347,7,179,2132
Indiana,Clay City,845,169,303,109,19,85,685
Indiana,Canaan,115,10,85,0,0,11,106
Indiana,Rome City,1197,240,531,181,35,70,1057
Indiana,Monroe,828,151,395,43,0,29,618
Indiana,Kokomo,57947,12613,21767,8077,954,3660,47071
Indiana,Otterbein,1036,215,406,144,0,47,812
Indiana,Linton,5262,971,1941,830,47,452,4241
Indiana,Trail Creek,2019,337,955,205,3,150,1650
Indiana,Corydon,3125,610,1025,543,114,276,2568
Indiana,Amboy,366,70,186,35,2,22,315
Indiana,Monticello,5282,1016,1723,623,68,690,4120
Indiana,Greenville,731,184,284,92,15,32,607
Indiana,Crawfordsville,16053,4092,5471,2359,352,903,13177
Indiana,Wolcottville,1021,198,358,175,20,16,767
Indiana,Melody Hill,3809,482,1975,297,30,133,2917
Indiana,Meridian Hills,1834,232,1015,68,7,65,1387
Indiana,Rocky Ripple,576,179,232,50,4,20,485
Indiana,Osceola,2558,481,1132,193,2,121,1929
Indiana,Logansport,18141,4558,6181,2225,270,1078,14312
Indiana,Onward,101,24,48,12,0,4,88
Indiana,Walton,1296,264,564,125,1,52,1006
Indiana,Cambridge City,1861,411,645,300,25,157,1538
Indiana,Wakarusa,1983,416,884,113,18,163,1594
Indiana,Elberfeld,730,182,335,45,9,24,595
Indiana,Goshen,33915,8745,12368,3116,469,1587,26285
Indiana,Greens Fork,456,83,183,56,12,33,367
Indiana,Newberry,190,23,103,28,1,7,162
Indiana,Medaryville,652,124,241,56,16,37,474
Indiana,Star City,226,31,107,40,0,20,198
Indiana,Palmyra,1350,189,451,247,18,118,1023
Indiana,Waveland,441,60,208,35,6,17,326
Indiana,Vevay,1493,337,484,288,15,153,1277
Indiana,Wabash,10184,2173,3889,1539,116,561,8278
Indiana,Francisco,579,130,229,84,6,29,478
Indiana,Sunman,1176,174,569,70,26,48,887
Indiana,Ashley,1061,258,341,146,39,42,826
Indiana,Clear Lake,394,30,258,38,2,44,372
Indiana,Boston,163,14,72,16,10,15,127
Indiana,Merrillville,35032,10444,11728,3408,596,2042,28218
Indiana,North Terre Haute,4498,1186,1461,623,10,250,3530
Indiana,Seelyville,819,149,312,139,22,25,647
Indiana,Zionsville,26209,4115,13778,1134,103,567,19697
Indiana,Spiceland,703,170,306,67,6,26,575
Indiana,Converse,1303,243,538,110,24,82,997
Indiana,Cumberland,5792,1969,1891,492,68,243,4663
Indiana,Griffin,139,29,58,11,0,12,110
Indiana,Beech Grove,14912,4263,4661,1881,176,952,11933
Indiana,Wanatah,1226,246,565,127,12,90,1040
Indiana,Bremen,4519,980,1759,418,34,249,3440
Indiana,Knightsville,710,111,241,155,2,107,616
Indiana,Topeka,1022,168,433,85,16,24,726
Indiana,Lagrange,2796,512,961,416,40,202,2131
Indiana,Roanoke,1842,404,829,173,2,67,1475
Indiana,Harmony,805,226,293,65,0,59,643
Indiana,Livonia,105,22,48,7,0,3,80
Indiana,Little York,231,45,138,16,0,6,205
Indiana,Campbellsburg,598,106,207,69,8,39,429
Indiana,Moores Hill,707,147,298,57,11,29,542
Indiana,North Judson,2057,477,756,192,47,112,1584
Indiana,Knox,3609,996,1002,731,36,245,3010
Indiana,Petersburg,2472,513,1024,297,22,191,2047
Indiana,Decker,281,69,108,34,0,9,220
Indiana,North Webster,1212,274,537,160,7,52,1030
Indiana,Plainfield,32045,7741,12185,3951,280,1680,25837
Indiana,Coalmont,232,33,91,88,0,0,212
Indiana,Colburn,330,147,29,103,0,0,279
Indiana,Cedar Lake,12242,3135,5041,1276,44,364,9860
Indiana,Dyer,16006,3338,7764,1232,90,973,13397
Indiana,Westville,6343,3091,1276,1345,135,130,5977
Indiana,Millersburg,746,192,314,54,6,23,589
Indiana,Simonton Lake,5121,889,2110,618,29,244,3890
Indiana,Poneto,181,40,95,15,2,6,158
Indiana,Kingsford Heights,1320,313,483,161,19,65,1041
Indiana,Reynolds,501,121,209,82,0,17,429
Indiana,Decatur,10331,2174,3563,1432,104,891,8164
Indiana,Geneva,1459,301,650,149,30,71,1201
Indiana,Huntertown,6787,1308,2738,860,26,142,5074
Indiana,Shirley,898,186,330,89,9,49,663
Indiana,Straughn,313,51,120,14,7,11,203
Indiana,Avon,17169,3092,7774,1689,116,660,13331
Indiana,Bourbon,1843,316,770,186,0,116,1388
Indiana,Kempton,359,65,165,50,4,24,308
Indiana,New Paris,1409,245,615,71,64,32,1027
Indiana,Van Buren,888,202,330,159,7,63,761
Indiana,Ambia,299,73,105,22,1,8,209
Indiana,Dana,543,93,257,51,2,32,435
Indiana,Morristown,1358,364,524,153,3,94,1138
Indiana,Williams Creek,398,53,254,13,0,3,323
Indiana,Rockville,2620,473,1112,317,21,191,2114
Indiana,Oakland City,2259,634,813,332,34,183,1996
Indiana,Mackey,116,47,37,21,0,0,105
Indiana,St. Paul,1166,307,413,109,2,51,882
Indiana,Batesville,6555,980,3045,586,128,528,5267
Indiana,Orland,410,120,159,57,0,17,353
Indiana,Fremont,2223,408,941,410,0,106,1865
Indiana,Monterey,298,86,135,34,1,7,263
Indiana,Colfax,722,178,292,75,10,23,578
Indiana,Leavenworth,324,50,70,77,8,52,257
Indiana,Wynnedale,184,44,94,22,0,10,170
Indiana,Frankfort,16186,3698,5467,1725,413,1017,12320
Indiana,Wilkinson,373,76,177,54,0,24,331
Indiana,Auburn,13162,3495,4552,1754,72,941,10814
Indiana,Perrysville,440,88,162,65,6,22,343
Indiana,Shelbyville,18898,4116,6878,2328,359,1373,15054
Indiana,Jonesboro,1311,233,565,195,26,89,1108
Indiana,Attica,3196,713,1300,364,77,214,2668
Indiana,Boonville,6337,1031,2441,808,143,447,4870
Indiana,Woodlawn Heights,77,3,50,2,0,3,58
Indiana,River Forest,18,4,13,0,0,1,18
Indiana,Lapel,2327,384,1066,243,48,157,1898
Indiana,Country Club Heights,89,6,60,6,0,11,83
Indiana,Lynnville,915,170,430,111,16,43,770
Indiana,Pennville,772,122,309,93,6,33,563
Indiana,Shadeland,1943,477,893,196,7,79,1652
Indiana,Earl Park,408,108,151,61,10,11,341
Indiana,Newport,393,61,173,78,14,8,334
Indiana,Cayuga,1202,235,540,110,26,65,976
Indiana,Ellettsville,6602,1245,2329,1123,136,299,5132
Iowa,Harcourt,304,53,128,34,5,13,233
Iowa,Montrose,829,192,311,83,3,75,664
Iowa,Little Sioux,148,32,61,19,0,9,121
Iowa,Dunlap,940,209,439,78,11,89,826
Iowa,Dike,1235,238,600,69,0,79,986
Iowa,West Burlington,2929,782,1060,350,89,169,2450
Iowa,Gruver,54,9,24,8,0,7,48
Iowa,Ladora,257,59,103,33,7,11,213
Iowa,Estherville,5859,1508,2435,519,112,273,4847
Iowa,Otho,460,94,201,74,1,41,411
Iowa,Farnhamville,401,101,156,32,1,34,324
Iowa,Callender,448,114,143,51,1,22,331
Iowa,Coburg,23,2,12,4,0,1,19
Iowa,Williamsburg,3150,683,1464,229,42,225,2643
Iowa,Creston,7832,1948,2735,1038,167,494,6382
Iowa,Pocahontas,1712,352,715,215,31,180,1493
Iowa,Gray,145,39,72,2,0,2,115
Iowa,Wyoming,423,97,164,80,2,28,371
Iowa,Alexander,147,41,52,9,1,5,108
Iowa,Coalville,594,150,163,69,16,62,460
Iowa,Alvord,265,35,148,12,0,11,206
Iowa,Little Rock,456,106,201,35,0,42,384
Iowa,Fonda,558,91,219,81,8,35,434
Iowa,Brayton,123,20,53,12,13,4,102
Iowa,Clarence,916,208,337,145,8,92,790
Iowa,Palmer,173,25,74,17,6,16,138
Iowa,Decatur City,210,29,101,20,0,13,163
Iowa,Weldon,172,19,99,30,9,2,159
Iowa,Manilla,819,141,365,85,12,65,668
Iowa,Denison,8358,2378,3222,387,84,339,6410
Iowa,Aspinwall,19,3,14,2,0,0,19
Iowa,Gilmore City,452,92,187,48,6,31,364
Iowa,Stratford,646,115,312,52,10,55,544
Iowa,Kingsley,1581,294,720,93,19,102,1228
Iowa,Dows,552,135,253,24,0,25,437
Iowa,Mount Sterling,37,0,37,0,0,0,37
Iowa,Mount Union,134,27,53,19,1,4,104
Iowa,DeWitt,5198,1014,1909,592,37,347,3899
Iowa,Center Junction,110,33,61,4,0,8,106
Iowa,Jacksonville,9,0,0,0,0,9,9
Iowa,Irvington,0,0,0,0,0,0,0
Iowa,Hutchins,20,20,0,0,0,0,20
Iowa,Hancock,195,32,94,25,0,20,171
Iowa,Kirkman,72,9,42,11,2,2,66
Iowa,Garnavillo,848,217,281,146,0,78,722
Iowa,Elkader,1381,284,572,164,13,118,1151
Iowa,Urbandale,42881,8048,20251,3143,358,1589,33389
Iowa,Saylorville,3492,550,1578,667,0,94,2889
Iowa,Runnells,515,121,215,45,4,3,388
Iowa,Pleasant Hill,9736,1796,4602,645,9,474,7526
Iowa,McClelland,191,55,96,0,1,7,159
Iowa,Keomah Village,78,13,44,6,0,12,75
Iowa,Marshalltown,27275,6216,10808,2490,305,1541,21360
Iowa,Bettendorf,35793,6636,16356,3157,203,1764,28116
Iowa,Story City,3395,673,1450,296,0,287,2706
Iowa,Slater,1556,255,721,112,14,40,1142
Iowa,McCallsburg,378,71,133,48,0,17,269
Iowa,Kelley,292,87,131,9,1,8,236
Iowa,Delphos,24,0,3,10,3,3,19
Iowa,Benton,41,4,24,0,0,13,41
Iowa,Cylinder,89,20,46,0,1,4,71
Iowa,Clive,17195,2665,8746,1100,62,624,13197
Iowa,Curlew,66,4,28,12,0,0,44
Iowa,Delaware,128,23,61,21,6,5,116
Iowa,Mapleton,1196,253,519,123,12,111,1018
Iowa,Riverdale,433,83,211,37,0,28,359
Iowa,Le Claire,3949,428,2094,216,23,157,2918
Iowa,Eldridge,6399,840,2803,663,65,163,4534
Iowa,Durant,1717,357,762,191,3,92,1405
Iowa,Blue Grass,1473,284,730,107,4,75,1200
Iowa,Parnell,218,33,118,39,1,6,197
Iowa,Ryan,388,78,201,24,1,24,328
Iowa,Dundee,259,65,105,9,4,10,193
Iowa,Rock Falls,151,26,84,11,0,5,126
Iowa,Sigourney,1922,336,886,180,0,184,1586
Iowa,Alden,850,188,364,87,12,47,698
Iowa,Colesburg,428,69,257,27,0,16,369
Iowa,Dana,42,10,17,4,5,1,37
Iowa,Plover,84,8,32,10,0,8,58
Iowa,Monroe,1743,308,764,183,14,87,1356
Iowa,Elgin,683,144,326,72,2,30,574
Iowa,Elberon,149,26,73,9,0,10,118
Iowa,Glenwood,5276,1438,1999,475,0,415,4327
Iowa,Shell Rock,1396,226,710,89,17,79,1121
Iowa,Aredale,49,3,25,10,0,7,45
Iowa,Anita,1127,220,534,91,5,74,924
Iowa,Riverside,998,208,454,69,3,88,822
Iowa,Kalona,2516,522,1011,216,4,201,1954
Iowa,Essex,874,167,412,85,20,43,727
Iowa,Coin,168,29,75,17,2,16,139
Iowa,Hardy,73,7,11,11,3,2,34
Iowa,Gilman,508,100,203,50,22,27,402
Iowa,Sidney,1081,209,420,141,8,96,874
Iowa,Orchard,53,8,18,14,3,5,48
Iowa,Dougherty,64,15,32,2,0,1,50
Iowa,Hartley,1698,295,690,132,32,192,1341
Iowa,Oakville,187,36,63,19,9,5,132
Iowa,Cotter,42,2,29,4,0,3,38
Iowa,Columbus Junction,2311,608,922,128,33,120,1811
Iowa,Ute,358,106,144,24,4,28,306
Iowa,Long Grove,1007,130,529,57,6,21,743
Iowa,Thurman,146,35,74,3,2,0,114
Iowa,Le Grand,933,214,379,86,15,60,754
Iowa,Mount Ayr,2066,342,928,188,18,198,1674
Iowa,Ruthven,743,137,240,100,0,108,585
Iowa,Rodman,31,6,11,6,0,6,29
Iowa,Tingley,142,15,74,17,2,12,120
Iowa,West Des Moines,64400,15217,28153,5710,580,2211,51871
Iowa,Mitchellville,2304,654,889,322,12,73,1950
Iowa,Alleman,383,77,229,21,2,13,342
Iowa,Haverhill,188,27,93,11,0,9,140
Iowa,Greenfield,1713,392,678,194,43,179,1486
Iowa,Donahue,411,74,207,19,0,17,317
Iowa,Martelle,236,58,118,20,0,10,206
Iowa,Rodney,46,16,16,6,0,6,44
Iowa,Douds,88,0,59,7,0,14,80
Iowa,Fruitland,1050,171,550,52,14,21,808
Iowa,Walker,825,165,434,30,0,31,660
Iowa,Oto,117,23,44,15,1,6,89
Iowa,Stockton,153,24,51,20,3,10,108
Iowa,Lawton,1001,201,488,39,7,46,781
Iowa,Sloan,1186,180,523,92,6,61,862
Iowa,Merrill,871,172,398,72,0,43,685
Iowa,Numa,83,23,31,12,0,7,73
Iowa,Milton,526,106,197,37,5,30,375
Iowa,Birmingham,615,148,245,46,9,32,480
Iowa,Prairieburg,193,73,68,19,0,10,170
Iowa,Central City,1334,347,497,137,11,50,1042
Iowa,Salem,524,104,223,44,6,29,406
Iowa,Rose Hill,145,37,58,18,5,13,131
Iowa,Bernard,146,46,72,2,4,0,124
Iowa,Centralia,123,33,59,10,1,7,110
Iowa,Rickardsville,171,26,103,9,0,2,140
Iowa,Baxter,1029,111,473,170,3,51,808
Iowa,West Union,2561,498,1143,283,26,172,2122
Iowa,St. Lucas,129,23,83,6,0,6,118
Iowa,Joice,209,43,85,23,1,9,161
Iowa,Monticello,3835,730,1580,356,0,424,3090
Iowa,Thor,203,53,97,11,0,1,162
Iowa,Rutland,131,25,49,24,0,19,117
Iowa,Hillsboro,189,25,70,10,4,21,130
Iowa,Renwick,286,55,141,28,0,11,235
Iowa,Fairfax,2596,311,1280,120,4,136,1851
Iowa,Beacon,580,97,247,76,11,42,473
Iowa,Underwood,931,140,431,53,24,20,668
Iowa,Dawson,159,44,56,14,1,0,115
Iowa,Adel,4316,581,1852,392,34,325,3184
Iowa,Denver,1676,265,871,80,14,111,1341
Iowa,Worthington,427,54,242,16,2,26,340
Iowa,Lisbon,2281,338,1135,164,12,72,1721
Iowa,Yale,255,29,114,32,0,32,207
Iowa,Stuart,1501,323,663,162,14,115,1277
Iowa,Hornick,230,36,103,20,6,9,174
Iowa,Avoca,1427,251,627,135,6,107,1126
Iowa,Harlan,4883,932,2122,529,47,425,4055
Iowa,Montour,297,65,130,44,7,14,260
Iowa,Chelsea,272,39,139,9,0,8,195
Iowa,Leighton,205,47,94,6,0,6,153
Iowa,Shelby,621,155,259,75,12,14,515
Iowa,Minden,602,83,326,27,2,19,457
Iowa,Crescent,574,68,312,34,7,31,452
Iowa,Oskaloosa,11505,2550,4149,1364,133,921,9117
Iowa,Oakland Acres,131,16,78,9,0,4,107
Iowa,Westgate,210,40,88,27,3,12,170
Iowa,Oelwein,6050,1430,2111,772,85,464,4862
Iowa,Hawkeye,460,99,224,27,0,16,366
Iowa,Grafton,218,49,105,20,5,11,190
Iowa,Livermore,341,63,155,36,3,14,271
Iowa,Onslow,200,49,72,26,1,17,165
Iowa,Prairie City,2204,320,981,213,4,103,1621
Iowa,Emerson,476,60,222,45,1,30,358
Iowa,Barnes City,233,54,94,33,3,8,192
Iowa,Farley,1742,465,803,102,0,28,1398
Iowa,Tama,2793,539,1010,316,43,158,2066
Iowa,Lone Rock,199,61,84,16,0,5,166
Iowa,Buckeye,98,10,52,3,0,10,75
Iowa,Scranton,554,116,233,77,3,44,473
Iowa,Ralston,71,11,27,10,2,6,56
Iowa,Swaledale,93,14,51,10,0,10,85
Iowa,Onawa,2830,713,1072,348,10,274,2417
Iowa,Durango,9,6,0,2,0,1,9
Iowa,Williamson,143,6,49,26,4,7,92
Iowa,Rockwell,946,156,398,113,2,76,745
Iowa,Balltown,61,4,39,1,0,3,47
Iowa,Jackson Junction,37,9,16,0,0,3,28
Iowa,Fort Atkinson,308,54,173,16,6,17,266
Iowa,Thompson,423,51,180,51,0,50,332
Iowa,Leland,259,69,115,14,0,11,209
Iowa,Peosta,1746,324,777,92,3,43,1239
Iowa,Edgewood,612,59,260,58,21,130,528
Iowa,Beaver,38,11,10,6,0,4,31
Iowa,Belmond,2574,383,1116,243,36,212,1990
Iowa,Paullina,1067,202,492,109,4,57,864
Iowa,Perry,7667,1910,2796,711,69,440,5926
Iowa,Clarksville,1448,280,666,105,3,81,1135
Iowa,Peterson,368,88,157,25,11,25,306
Iowa,Macksburg,107,14,35,14,0,22,85
Iowa,Hopkinton,603,108,276,43,3,31,461
Iowa,Walcott,1539,344,631,184,3,112,1274
Iowa,Lu Verne,298,81,108,23,2,21,235
Iowa,Pleasanton,32,2,22,0,0,2,26
Iowa,Bagley,348,78,157,35,1,22,293
Iowa,Fontanelle,610,131,204,78,13,69,495
Iowa,Stanwood,627,138,278,70,0,40,526
Iowa,Van Wert,161,15,87,30,1,7,140
Iowa,Waucoma,211,26,105,24,1,10,166
Iowa,Thornton,436,110,182,38,5,10,345
Iowa,Silver City,253,26,131,27,1,15,200
Iowa,Drakesville,200,17,102,27,5,17,168
Iowa,Rowan,155,42,57,26,0,10,135
Iowa,Calamus,441,108,171,32,1,28,340
Iowa,Houghton,151,17,91,6,0,5,119
Iowa,Minburn,400,61,191,31,0,17,300
Iowa,De Soto,980,198,426,97,0,33,754
Iowa,Massena,310,47,138,27,4,28,244
Iowa,Cumberland,192,29,87,18,2,20,156
Iowa,Atlantic,6709,1212,2803,831,112,634,5592
Iowa,Sherrill,247,46,150,10,0,7,213
Iowa,Epworth,1939,432,927,90,3,66,1518
Iowa,Ventura,814,128,422,56,0,37,643
Iowa,Asbury,5469,677,2886,249,13,133,3958
Iowa,Waterloo,68134,19266,24181,7082,816,3446,54791
Iowa,La Porte City,2598,504,1212,189,5,99,2009
Iowa,Hudson,2470,326,1316,154,33,81,1910
Iowa,Clare,178,28,77,26,0,9,140
Iowa,Harpers Ferry,257,37,168,16,0,22,243
Iowa,Solon,2581,500,1061,182,22,128,1893
Iowa,Red Oak,5434,1333,2058,520,59,399,4369
Iowa,Strawberry Point,1376,267,539,131,29,127,1093
Iowa,Dubuque,58340,17313,21932,5481,371,3076,48173
Iowa,Malcom,272,91,98,29,8,13,239
Iowa,Galt,29,0,15,0,0,2,17
Iowa,Hospers,718,122,374,34,11,38,579
Iowa,Orange City,6115,1691,2981,185,45,207,5109
Iowa,Rock Valley,3712,861,1568,123,27,271,2850
Iowa,Oakland,1533,362,615,140,25,88,1230
Iowa,Northboro,83,36,17,17,0,4,74
Iowa,Nichols,374,95,157,31,5,25,313
Iowa,Bertram,381,51,218,9,0,16,294
Iowa,Terril,372,79,153,46,3,11,292
Iowa,Boone,12529,2738,5211,1396,180,703,10228
Iowa,Webb,162,24,66,16,1,13,120
Iowa,Fremont,735,165,265,107,5,21,563
Iowa,Chillicothe,96,27,39,5,5,7,83
Iowa,Dallas Center,1733,324,777,112,0,103,1316
Iowa,Sioux City,82486,21828,29209,7536,1281,4190,64044
Iowa,Correctionville,786,136,318,85,21,90,650
Iowa,Carter Lake,3792,921,1152,378,68,245,2764
Iowa,Ayrshire,150,41,24,40,4,19,128
Iowa,Marengo,2620,555,1118,289,21,148,2131
Iowa,Vincent,149,29,68,21,15,1,134
Iowa,Rossie,39,8,20,0,1,5,34
Iowa,Somers,129,24,43,25,0,3,95
Iowa,Frederika,370,73,155,38,1,14,281
Iowa,University Park,485,137,139,48,7,18,349
Iowa,Halbur,289,80,119,12,0,4,215
Iowa,Sheldon,5132,1308,2383,223,35,245,4194
Iowa,Knierim,42,6,17,3,0,8,34
Iowa,Garwin,550,138,211,87,4,20,460
Iowa,Carlisle,4134,806,1547,381,14,241,2989
Iowa,La Motte,222,39,123,12,1,10,185
Iowa,Maquoketa,6026,1242,2001,862,116,519,4740
Iowa,Preston,975,202,503,70,9,30,814
Iowa,Sabula,422,90,180,36,0,48,354
Iowa,Zwingle,103,40,22,19,0,3,84
Iowa,New Market,405,65,202,58,2,25,352
Iowa,Moorland,207,40,89,23,1,17,170
Iowa,Grand Junction,879,205,312,107,10,56,690
Iowa,Cedar Falls,41202,16623,14261,2107,214,1551,34756
Iowa,Jesup,2894,621,1183,192,0,92,2088
Iowa,Spencer,11092,1990,4683,966,202,976,8817
Iowa,McIntire,79,27,35,5,1,9,77
Iowa,Bondurant,5826,726,2557,410,52,116,3861
Iowa,Armstrong,945,191,402,107,0,94,794
Iowa,Corwith,213,63,96,17,2,18,196
Iowa,Kanawha,826,176,362,43,8,61,650
Iowa,Klemme,616,126,262,54,6,19,467
Iowa,New Virginia,507,78,221,63,4,30,396
Iowa,Humeston,408,83,175,39,2,34,333
Iowa,Pioneer,4,2,2,0,0,0,4
Iowa,Westfield,142,44,33,21,2,14,114
Iowa,Danbury,334,69,149,31,2,31,282
Iowa,Bristow,141,18,48,20,11,10,107
Iowa,Cascade,2078,338,1032,84,19,205,1678
Iowa,Olin,841,197,351,76,3,38,665
Iowa,Tabor,1254,209,477,145,22,133,986
Iowa,Martinsburg,107,29,34,27,3,3,96
Iowa,Thayer,43,13,9,19,0,2,43
Iowa,West Point,998,194,459,114,2,84,853
Iowa,Corydon,1682,271,709,173,19,181,1353
Iowa,Dow City,506,87,186,66,3,34,376
Iowa,Buck Grove,42,16,10,14,0,2,42
Iowa,Exira,905,157,298,153,1,134,743
Iowa,Fort Madison,10614,2553,4082,1389,171,613,8808
Iowa,Logan,1592,275,661,175,14,69,1194
Iowa,Middletown,402,79,141,40,7,13,280
Iowa,Mitchell,134,8,62,24,0,9,103
Iowa,Aurelia,948,192,485,53,12,68,810
Iowa,Reinbeck,1492,254,742,123,20,152,1291
Iowa,Hayesville,34,3,15,9,0,7,34
Iowa,Thornburg,73,13,41,3,0,2,59
Iowa,Riverton,305,45,138,17,6,25,231
Iowa,Hamburg,1119,215,418,152,0,89,874
Iowa,Farragut,430,50,211,66,4,50,381
Iowa,Marysville,113,28,42,10,0,2,82
Iowa,Allerton,546,100,170,83,2,41,396
Iowa,North English,1106,232,325,110,10,97,774
Iowa,Fostoria,243,46,136,9,2,9,202
Iowa,Marcus,1234,232,586,77,26,116,1037
Iowa,Lakeside,717,154,367,29,11,35,596
Iowa,Huxley,3672,658,1723,188,0,130,2699
Iowa,Sheldahl,273,40,157,11,1,10,219
Iowa,Princeton,1114,286,471,141,16,36,950
Iowa,Gravity,135,26,65,18,0,7,116
Iowa,Swan,68,11,12,22,1,3,49
Iowa,Melcher-Dallas,1255,188,520,149,17,87,961
Iowa,Bussey,491,108,190,60,3,48,409
Iowa,Shueyville,641,80,357,28,6,12,483
Iowa,Oxford,882,159,447,71,5,40,722
Iowa,Woodburn,159,35,76,25,4,4,144
Iowa,Vinton,5124,1153,2242,321,42,458,4216
Iowa,Van Horne,868,179,339,85,14,27,644
Iowa,Urbana,1477,279,697,130,33,44,1183
Iowa,Janesville,956,111,489,55,2,71,728
Iowa,Moravia,675,144,260,88,8,58,558
Iowa,Redding,74,4,29,7,0,6,46
Iowa,Clearfield,386,91,141,41,8,25,306
Iowa,Roland,1233,162,602,88,2,32,886
Iowa,West Bend,714,73,371,54,11,109,618
Iowa,Newell,965,184,411,113,6,78,792
Iowa,Rembrandt,171,56,73,16,2,11,158
Iowa,Ricketts,112,22,54,4,0,4,84
Iowa,Carpenter,119,44,41,5,0,14,104
Iowa,Grimes,11930,1772,5271,1102,22,388,8555
Iowa,Brooklyn,1549,324,661,135,15,86,1221
Iowa,Beaconsfield,22,0,18,2,2,0,22
Iowa,Holstein,1354,269,598,170,0,127,1164
Iowa,Audubon,1989,363,930,191,10,230,1724
Iowa,Deloit,358,45,166,31,2,23,267
Iowa,Schleswig,909,208,371,101,29,46,755
Iowa,Lone Tree,1236,239,534,98,16,78,965
Iowa,Hamilton,86,23,10,18,2,5,58
Iowa,Clio,64,8,33,10,0,5,56
Iowa,Grinnell,9223,3470,2805,886,55,806,8022
Iowa,Graettinger,806,162,315,110,10,55,652
Iowa,Waukon,3716,804,1571,371,50,302,3098
Iowa,Fraser,146,21,87,9,0,7,124
Iowa,Nemaha,103,35,40,10,0,1,86
Iowa,Forest City,4089,1387,1401,274,65,250,3377
Iowa,Blockton,137,19,65,14,2,24,124
Iowa,Winterset,5203,744,2322,534,27,433,4060
Iowa,Bedford,1566,268,764,129,12,99,1272
Iowa,New Albin,562,153,189,58,3,40,443
Iowa,Arispe,120,7,56,12,0,13,88
Iowa,Stanton,581,61,326,57,0,49,493
Iowa,St. Paul,90,5,50,8,7,4,74
Iowa,Lansing,769,109,352,120,0,93,674
Iowa,Mondamin,338,76,174,29,0,19,298
Iowa,Stout,174,25,98,17,0,10,150
Iowa,Morrison,118,18,72,6,0,3,99
Iowa,Burlington,25127,6279,9059,3113,375,1442,20268
Iowa,Lenox,1557,258,630,164,48,115,1215
Iowa,Seymour,596,97,208,93,5,91,494
Iowa,Harvey,172,23,72,27,0,13,135
Iowa,Conway,23,10,7,4,1,1,23
Iowa,Kiron,249,49,119,15,1,22,206
Iowa,Westside,326,57,145,36,0,35,273
Iowa,Sheffield,1101,204,543,64,4,86,901
Iowa,Farmington,741,162,275,55,24,61,577
Iowa,Moville,1669,327,701,210,9,66,1313
Iowa,Plymouth,383,73,179,30,3,13,298
Iowa,Lovilia,684,112,301,68,5,35,521
Iowa,Moorhead,196,24,103,23,2,22,174
Iowa,Hartwick,108,10,65,2,0,3,80
Iowa,Park View,2755,601,1251,143,0,36,2031
Iowa,Swisher,917,114,521,68,0,21,724
Iowa,Woodbine,1585,311,696,110,8,142,1267
Iowa,Wellsburg,813,148,411,35,0,51,645
Iowa,Conrad,1053,178,535,61,4,131,909
Iowa,Pleasantville,1715,397,631,242,14,107,1391
Iowa,Knoxville,7200,1509,2749,955,25,571,5809
Iowa,University Heights,1206,433,496,49,4,29,1011
Iowa,Tiffin,3008,614,1299,278,50,73,2314
Iowa,Coralville,20645,6691,7996,1210,180,623,16700
Iowa,Missouri Valley,2646,660,810,371,32,279,2152
Iowa,Keosauqua,901,156,418,99,17,103,793
Iowa,Iowa City,74566,35379,21988,4534,488,1964,64353
Iowa,Coulter,195,38,94,15,5,2,154
Iowa,Aurora,208,42,94,18,0,8,162
Iowa,State Center,1595,271,696,140,0,79,1186
Iowa,Arthur,250,37,108,19,2,23,189
Iowa,Cherokee,4966,1169,1634,730,44,458,4035
Iowa,Rinard,44,7,19,1,0,10,37
Iowa,Lohrville,381,61,172,37,1,30,301
Iowa,Blairstown,699,87,305,62,35,30,519
Iowa,Belle Plaine,2427,454,971,273,52,180,1930
Iowa,Lake Mills,2082,427,869,194,12,222,1724
Iowa,Hartford,678,66,329,64,5,24,488
Iowa,Milo,804,131,405,63,10,15,624
Iowa,Newhall,993,168,474,86,3,93,824
Iowa,Baldwin,139,19,79,16,0,4,118
Iowa,Kirkville,197,31,116,7,6,2,162
Iowa,Sanborn,1452,241,660,77,4,173,1155
Iowa,Lamont,563,144,191,65,4,36,440
Iowa,Ackley,1785,324,824,115,27,164,1454
Iowa,Radcliffe,595,59,324,45,0,23,451
Iowa,Algona,5455,1017,2309,599,32,519,4476
Iowa,Council Bluffs,62478,16557,22369,7267,804,3316,50313
Iowa,Maurice,337,57,149,34,2,22,264
Iowa,Hull,2044,446,1005,78,14,103,1646
Iowa,Chatsworth,81,11,49,7,0,7,74
Iowa,Treynor,941,137,492,43,3,35,710
Iowa,Sutherland,639,142,224,98,6,59,529
Iowa,Calumet,159,20,53,23,0,11,107
Iowa,Popejoy,47,8,22,0,0,3,33
Iowa,Columbus City,438,98,181,44,2,33,358
Iowa,St. Olaf,144,26,53,16,0,3,98
Iowa,North Buena Vista,82,15,44,10,2,6,77
Iowa,Alta,2152,446,943,137,6,126,1658
Iowa,Albert City,625,155,234,43,4,69,505
Iowa,Toledo,2296,420,867,327,29,143,1786
Iowa,Clutier,231,67,81,27,9,16,200
Iowa,Whittemore,487,98,235,15,2,44,394
Iowa,Cresco,3780,740,1420,431,34,292,2917
Iowa,Ossian,873,152,414,72,13,100,751
Iowa,Oyens,99,13,52,3,0,4,72
Iowa,Hinton,831,176,408,63,0,27,674
Iowa,Lucas,199,40,107,13,3,13,176
Iowa,Boyden,891,176,389,36,0,29,630
Iowa,Spring Hill,71,27,25,5,0,1,58
Iowa,Norwalk,10568,1762,5049,979,48,399,8237
Iowa,Ackworth,219,47,68,6,0,4,125
Iowa,Russell,608,89,250,81,8,33,461
Iowa,Sandyville,63,7,21,15,2,0,45
Iowa,Springbrook,142,20,84,6,0,2,112
Iowa,Meriden,196,34,82,11,4,6,137
Iowa,Raymond,713,88,345,59,6,42,540
Iowa,Dunkerton,811,166,379,60,2,44,651
Iowa,Johnston,20767,3742,9994,1698,220,685,16339
Iowa,Altoona,17936,3793,7588,1564,68,606,13619
Iowa,Osage,3574,712,1444,431,26,374,2987
Iowa,Ottumwa,24676,6022,9315,2544,332,1489,19702
Iowa,Doon,687,134,333,33,11,31,542
Iowa,Miles,422,88,185,51,6,13,343
Iowa,Monmouth,171,41,74,19,0,9,143
Iowa,Ashton,482,89,191,57,2,29,368
Iowa,Harris,132,21,54,22,2,10,109
Iowa,Garrison,421,49,197,41,2,23,312
Iowa,Redfield,644,141,275,83,6,37,542
Iowa,Linden,165,21,93,22,2,6,144
Iowa,Readlyn,742,101,376,55,5,38,575
Iowa,Dumont,604,118,240,43,20,57,478
Iowa,Wiota,73,14,49,6,0,4,73
Iowa,Quasqueton,576,101,297,26,14,31,469
Iowa,Floris,185,18,67,21,2,15,123
Iowa,Volga,181,32,95,15,2,13,157
Iowa,Monona,1581,269,734,136,5,162,1306
Iowa,Truesdale,123,45,35,7,0,8,95
Iowa,Sageville,52,9,34,6,0,1,50
Iowa,Dyersville,4110,983,1779,320,18,355,3455
Iowa,Bankston,17,2,13,0,0,2,17
Iowa,Storm Lake,10672,2719,3895,743,174,545,8076
Iowa,Dedham,264,70,110,11,0,15,206
Iowa,Sergeant Bluff,4669,778,2143,312,85,190,3508
Iowa,Independence,6027,1305,2278,636,124,539,4882
Iowa,Washta,176,54,67,11,7,15,154
Iowa,Kensett,289,68,128,36,9,12,253
Iowa,Randalia,86,13,32,16,0,6,67
Iowa,Sumner,2124,364,977,177,20,188,1726
Iowa,Ellsworth,542,144,198,29,0,26,397
Iowa,Coggon,679,153,253,53,10,68,537
Iowa,Robins,3414,581,2109,85,14,31,2820
Iowa,Leon,2037,309,739,270,58,143,1519
Iowa,Webster City,7779,1542,3319,624,85,689,6259
Iowa,Rathbun,51,13,26,6,0,6,51
Iowa,Carbon,45,3,25,5,0,4,37
Iowa,Prescott,218,61,92,9,8,9,179
Iowa,Panama,199,35,94,13,0,7,149
Iowa,Granville,397,74,174,27,0,15,290
Iowa,Ireton,939,97,479,71,2,36,685
Iowa,Smithland,161,30,70,14,0,15,129
Iowa,Hanlontown,174,26,82,30,0,11,149
Iowa,Wahpeton,372,32,255,23,2,39,351
Iowa,Alburnett,641,139,277,49,8,20,493
Iowa,Bonaparte,459,121,136,30,7,23,317
Iowa,Larrabee,162,29,53,46,2,16,146
Iowa,Cleghorn,236,21,107,19,0,15,162
Iowa,Gilbertville,840,207,385,97,0,45,734
Iowa,Lytton,268,65,113,35,1,11,225
Iowa,Lake View,1062,143,559,114,0,107,923
Iowa,Bronson,257,44,123,25,0,4,196
Iowa,Anthon,632,101,267,60,4,82,514
Iowa,Hazleton,824,180,251,141,14,41,627
Iowa,Struble,112,33,45,11,1,0,90
Iowa,Akron,1542,278,627,185,7,99,1196
Iowa,Conesville,437,127,179,25,5,19,355
Iowa,New Sharon,1146,219,533,147,4,69,972
Iowa,Luxemburg,253,38,140,1,0,29,208
Iowa,Farmersburg,304,63,114,33,10,18,238
Iowa,Lowden,869,172,392,91,5,42,702
Iowa,Exline,168,22,73,22,1,18,136
Iowa,Craig,81,8,38,11,0,0,57
Iowa,Guthrie Center,1570,314,513,233,14,194,1268
Iowa,New Providence,258,51,119,24,0,7,201
Iowa,West Okoboji,308,32,195,24,0,40,291
Iowa,New Vienna,385,79,231,14,3,17,344
Iowa,Holy Cross,375,76,180,19,2,24,301
Iowa,Eddyville,1219,326,475,122,8,35,966
Iowa,Wall Lake,737,107,347,46,0,74,574
Iowa,Odebolt,1011,174,513,66,0,83,836
Iowa,Auburn,262,38,125,33,2,16,214
Iowa,Ridgeway,273,80,99,43,0,14,236
Iowa,Castalia,195,23,104,24,2,14,167
Iowa,Scarville,78,11,35,12,0,4,62
Iowa,Spillville,446,125,153,34,2,46,360
Iowa,Lacona,392,66,178,45,17,7,313
Iowa,Ida Grove,2137,412,940,189,13,202,1756
Iowa,Galva,447,36,212,42,9,21,320
Iowa,Quimby,397,99,191,19,7,21,337
Iowa,Andrew,446,92,183,24,1,19,319
Iowa,Battle Creek,737,124,320,70,7,56,577
Iowa,Winthrop,909,164,348,120,0,45,677
Iowa,Marathon,242,45,119,22,5,10,201
Iowa,Garber,121,46,47,9,0,3,105
Iowa,New London,1941,344,727,317,22,100,1510
Iowa,Palo,1182,232,425,150,16,37,860
Iowa,Mount Vernon,4454,1854,1366,223,15,111,3569
Iowa,Wayland,1061,218,439,103,11,74,845
Iowa,Menlo,414,80,158,45,10,21,314
Iowa,Lake Park,1201,253,563,90,20,74,1000
Iowa,Alta Vista,330,72,120,42,0,16,250
Iowa,Walnut,717,120,343,84,13,48,608
Iowa,Ionia,312,71,136,24,0,13,244
Iowa,Berkley,16,6,2,2,0,6,16
Iowa,Willey,126,17,63,5,0,5,90
Iowa,Breda,414,90,205,29,0,22,346
Iowa,Waukee,19344,3812,8753,1239,139,540,14483
Iowa,Granger,1819,316,791,154,14,70,1345
Iowa,Osterdock,85,30,35,11,0,3,79
Iowa,Marquette,405,107,153,60,4,34,358
Iowa,Luther,183,35,109,5,0,8,157
Iowa,Olds,210,45,87,12,1,12,157
Iowa,Spirit Lake,5021,908,2242,705,43,324,4222
Iowa,North Washington,152,50,70,5,1,2,128
Iowa,Holland,253,49,101,23,5,3,181
Iowa,Beaman,221,41,99,25,0,3,168
Iowa,Keswick,213,28,100,19,0,11,158
Iowa,Hedrick,579,115,249,54,11,49,478
Iowa,Randolph,194,27,92,9,0,13,141
Iowa,Dolliver,62,8,35,7,0,4,54
Iowa,Sharpsburg,116,16,40,18,3,5,82
Iowa,Millerton,109,43,30,2,0,3,78
Iowa,Latimer,518,142,188,26,2,40,398
Iowa,Charter Oak,644,159,249,58,12,23,501
Iowa,Arion,111,19,62,3,0,5,89
Iowa,Dayton,765,126,330,75,5,93,629
Iowa,Remsen,1748,330,746,124,16,126,1342
Iowa,Stockport,350,73,121,51,6,9,260
Iowa,Muscatine,23864,5554,8802,2635,385,1200,18576
Iowa,Pisgah,293,63,112,38,2,31,246
Iowa,Keokuk,10412,2406,4014,1068,126,557,8171
Iowa,Villisca,1340,236,579,136,30,87,1068
Iowa,Vail,501,113,196,58,0,33,400
Iowa,Nashua,1515,240,782,104,21,87,1234
Iowa,Lawler,369,56,171,37,2,30,296
Iowa,Fredericksburg,1136,233,434,89,7,108,871
Iowa,Orient,419,53,196,32,8,25,314
Iowa,Shellsburg,921,141,458,80,13,76,768
Iowa,Luzerne,134,4,73,15,0,2,94
Iowa,Keystone,578,66,294,33,5,63,461
Iowa,Arnolds Park,1173,334,565,106,2,83,1090
Iowa,Truro,537,125,200,33,6,23,387
Iowa,Promise City,81,16,23,25,0,4,68
Iowa,Pella,10273,2776,4814,499,30,483,8602
Iowa,Hansell,90,11,45,10,0,9,75
Iowa,Hampton,4280,909,1855,275,80,200,3319
Iowa,Kimballton,296,42,146,33,5,32,258
Iowa,Hills,827,195,336,53,0,92,676
Iowa,Geneva,125,21,69,13,0,3,106
Iowa,Manson,1838,260,880,106,7,171,1424
Iowa,Cantril,282,50,129,16,2,13,210
Iowa,Ely,2078,395,908,230,12,62,1607
Iowa,Marion,38699,7806,17223,3806,449,1782,31066
Iowa,Malvern,1005,209,409,118,0,100,836
Iowa,New Hartford,676,89,278,41,17,23,448
Iowa,Jamaica,277,73,96,46,4,16,235
Iowa,Fairfield,10216,3643,3113,1173,247,613,8789
Iowa,Rudd,451,97,179,64,12,22,374
Iowa,Charles City,7413,1729,2779,790,123,626,6047
Iowa,Welton,147,39,56,24,4,6,129
Iowa,Goose Lake,236,34,115,13,0,19,181
Iowa,Clinton,25637,6583,9563,2898,382,1778,21204
Iowa,Unionville,88,14,37,14,1,10,76
Iowa,Moulton,518,91,219,46,8,39,403
Iowa,Dickens,228,48,84,28,1,8,169
Iowa,Marne,124,22,60,14,0,3,99
Iowa,Lewis,482,70,256,40,8,19,393
Iowa,Bode,278,71,124,35,6,7,243
Iowa,Adair,787,161,346,74,5,57,643
Iowa,Bayard,391,91,165,60,2,13,331
Iowa,Steamboat Rock,311,65,136,35,0,24,260
Iowa,Union,422,69,201,44,6,27,347
Iowa,Kamrar,159,37,59,23,2,14,135
Iowa,Blairsburg,136,25,86,2,2,11,126
Iowa,Mingo,261,31,121,29,0,15,196
Iowa,Stanhope,392,85,153,64,8,15,325
Iowa,Jefferson,4160,897,1742,376,40,316,3371
Iowa,Masonville,113,24,35,17,2,3,81
Iowa,Churdan,474,115,172,48,3,41,379
Iowa,Washington,7345,1454,3057,805,135,561,6012
Iowa,Whiting,925,200,347,68,7,64,686
Iowa,Soldier,216,42,88,30,2,22,184
Iowa,Davenport,102318,30554,35595,10158,1219,5147,82673
Iowa,Rhodes,248,37,119,39,4,3,202
Iowa,Melbourne,895,212,324,123,4,25,688
Iowa,Swea City,570,126,181,84,15,24,430
Iowa,Ledyard,91,14,47,6,1,16,84
Iowa,Lakota,269,55,121,31,3,19,229
Iowa,Turin,119,17,28,17,6,7,75
Iowa,Packwood,351,68,137,15,11,27,258
Iowa,Aplington,996,229,450,89,5,74,847
Iowa,Ottosen,38,3,27,5,0,3,38
Iowa,Corning,1566,247,798,118,4,145,1312
Iowa,West Chester,104,9,41,25,7,10,92
Iowa,Shenandoah,4945,1033,2314,427,44,250,4068
Iowa,Patterson,187,30,89,20,7,7,153
Iowa,Batavia,605,123,170,94,13,42,442
Iowa,Marble Rock,286,63,121,25,8,47,264
Iowa,Wheatland,728,140,264,111,2,28,545
Iowa,Cincinnati,380,64,195,42,7,15,323
Iowa,Charlotte,325,78,111,31,2,25,247
Iowa,Elliott,512,79,245,41,2,12,379
Iowa,Fenton,290,55,131,32,5,13,236
Iowa,Le Mars,9894,2121,4255,783,29,689,7877
Iowa,Floyd,325,74,150,29,0,16,269
Iowa,Grand Mound,617,164,286,39,0,25,514
Iowa,Camanche,4342,797,1863,475,68,271,3474
Iowa,West Liberty,3749,1165,1435,291,87,140,3118
Iowa,Cromwell,97,15,52,13,0,6,86
Iowa,Ainsworth,522,122,207,52,8,15,404
Iowa,Plano,70,15,29,14,0,5,63
Iowa,Parkersburg,1913,313,904,117,0,183,1517
Iowa,Dakota City,798,147,356,80,3,37,623
Iowa,Wellman,1333,238,624,95,8,100,1065
Iowa,Coppock,31,2,8,7,0,5,22
Iowa,Yorktown,67,18,32,3,0,2,55
Iowa,Shambaugh,151,25,84,11,0,7,127
Iowa,Hepburn,17,2,11,0,0,0,13
Iowa,Blanchard,21,5,13,0,0,2,20
Iowa,Allison,1106,276,479,73,0,96,924
Iowa,St. Charles,724,136,383,41,0,40,600
Iowa,Pleasant Plain,75,6,43,1,0,11,61
Iowa,Colwell,69,14,28,21,0,0,63
Iowa,Toronto,94,9,50,4,1,11,75
Iowa,Andover,100,18,45,12,0,1,76
Iowa,Sully,865,145,454,36,9,38,682
Iowa,Kellogg,603,115,271,80,6,26,498
Iowa,Wadena,254,40,108,25,4,16,193
Iowa,Brighton,679,126,271,80,12,33,522
Iowa,East Peru,101,13,66,7,0,5,91
Iowa,Crawfordsville,317,52,145,34,5,7,243
Iowa,Nora Springs,1523,250,689,172,0,109,1220
Iowa,Griswold,1189,231,447,130,13,60,881
Iowa,Everly,597,134,260,59,11,24,488
Iowa,Royal,339,89,148,33,0,22,292
Iowa,Nodaway,97,7,41,11,0,11,70
Iowa,Guttenberg,1852,381,891,203,10,213,1698
Iowa,Pomeroy,603,83,322,44,6,56,511
Iowa,Rockwell City,2165,598,717,421,35,159,1930
Iowa,Sioux Rapids,791,179,313,75,3,48,618
Iowa,Bouton,135,21,64,21,1,3,110
Iowa,Greene,1006,198,466,72,9,133,878
Iowa,Plainfield,518,100,228,58,2,26,414
Iowa,Tripoli,1210,201,531,140,25,86,983
Iowa,Woodward,1543,683,530,45,12,45,1315
Iowa,Mystic,375,67,122,51,7,39,286
Iowa,Carroll,9899,1890,4122,1023,94,710,7839
Iowa,Bloomfield,2658,509,1086,319,16,177,2107
Iowa,Templeton,389,74,211,28,0,7,320
Iowa,Manning,1542,303,690,127,5,114,1239
Iowa,Glidden,1177,245,533,87,11,56,932
Iowa,Carson,729,135,326,68,7,47,583
Iowa,Sioux Center,7499,1914,3264,121,51,295,5645
Iowa,Portsmouth,134,35,50,16,0,15,116
Iowa,Elk Horn,501,64,237,57,11,57,426
Iowa,Earling,367,63,163,42,0,36,304
Iowa,Defiance,209,27,114,21,5,13,180
Iowa,Jolley,23,6,15,1,1,0,23
Iowa,Lidderdale,181,21,105,16,0,5,147
Iowa,Early,664,172,261,62,7,33,535
Iowa,Bevington,50,18,23,5,0,0,46
Iowa,Mount Auburn,112,12,53,20,0,4,89
Iowa,Derby,146,17,63,5,3,6,94
Iowa,Lockridge,311,62,122,58,1,25,268
Iowa,Rolfe,623,153,252,54,8,51,518
Iowa,Goldfield,555,129,275,41,2,33,480
Iowa,Arcadia,477,73,243,40,0,18,374
Iowa,Decorah,7765,3277,2692,443,36,532,6980
Iowa,Postville,2530,492,1016,73,16,125,1722
Iowa,Brandon,305,68,102,45,3,16,234
Iowa,Rowley,260,39,146,12,9,13,219
Iowa,Van Meter,1192,205,564,117,2,34,922
Iowa,Springville,1093,265,446,100,16,33,860
Iowa,Morley,80,27,14,14,6,9,70
Iowa,Lanesboro,129,43,76,6,1,1,127
Iowa,Pacific Junction,425,79,174,49,3,31,336
Iowa,Newton,15167,3099,5727,1735,309,1133,12003
Iowa,Gillett Grove,25,6,4,10,0,5,25
Iowa,Graf,60,8,33,6,0,1,48
Iowa,Greenville,64,15,39,1,1,3,59
Iowa,Lake City,1825,259,953,161,15,170,1558
Iowa,Lost Nation,493,112,162,68,23,37,402
Iowa,Earlham,1489,266,698,124,11,45,1144
Iowa,Pulaski,321,33,158,26,6,16,239
Iowa,Dexter,619,150,235,59,2,37,483
Iowa,Waverly,10075,3114,3997,551,127,595,8384
Iowa,Woolstock,171,46,67,27,2,18,160
Iowa,Atkins,1861,281,1014,107,1,52,1455
Iowa,Gladbrook,981,162,408,119,10,106,805
Iowa,Westphalia,126,17,43,24,0,8,92
Iowa,Stacyville,552,104,240,60,6,58,468
Iowa,Norway,551,155,188,71,0,36,450
Iowa,Clarion,2772,598,1099,242,44,271,2254
Iowa,Orleans,420,38,308,29,0,26,401
Iowa,Hawarden,2706,370,1207,169,12,240,1998
Iowa,Wilton,2833,632,1357,212,15,90,2306
Iowa,Leando,42,0,0,0,34,8,42
Iowa,Rock Rapids,2556,307,1286,83,38,201,1915
Iowa,Ringsted,480,113,155,57,16,39,380
Iowa,Low Moor,276,63,112,37,5,2,219
Iowa,Lorimor,369,76,157,49,7,9,298
Iowa,Afton,900,186,468,82,7,43,786
Iowa,Windsor Heights,4990,898,2228,466,19,358,3969
Iowa,Maloy,17,0,9,4,0,0,13
Iowa,Lineville,195,33,91,22,3,11,160
Iowa,Crystal Lake,246,67,96,29,0,16,208
Iowa,Deep River,239,36,113,34,1,14,198
Iowa,Harper,85,18,34,6,0,3,61
Iowa,Bridgewater,141,22,77,8,0,9,116
Iowa,Neola,933,163,374,99,6,67,709
Iowa,Burt,547,111,225,44,2,31,413
Iowa,Spragueville,129,20,31,13,0,13,77
Iowa,Wesley,389,122,141,30,2,28,323
Iowa,Titonka,535,95,212,47,3,61,418
Iowa,Whitten,170,21,92,9,4,1,127
Iowa,Iowa Falls,5124,1320,2080,494,8,464,4366
Iowa,Evansdale,4786,1287,1773,534,32,214,3840
Iowa,Elk Run Heights,970,198,533,107,0,41,879
Iowa,Schaller,798,139,340,60,28,37,604
Iowa,Sac City,2137,485,871,249,16,165,1786
Iowa,Calmar,1017,265,451,37,9,25,787
Iowa,Yetter,30,8,11,5,0,0,24
Iowa,Rake,164,30,60,23,0,27,140
Iowa,St. Marys,184,24,116,6,0,7,153
Iowa,Martensdale,498,92,156,73,20,17,358
Iowa,Cumming,384,53,222,19,0,6,300
Iowa,Clarinda,5398,1733,1938,494,30,394,4589
Iowa,Donnellson,939,229,319,106,7,74,735
Iowa,Delmar,512,113,212,62,8,27,422
Iowa,Rockford,785,168,363,77,12,33,653
Iowa,Udell,45,5,22,4,0,6,37
Iowa,Centerville,5487,1071,2110,768,26,477,4452
Iowa,Williams,392,81,175,35,8,18,317
Iowa,Tipton,3196,603,1453,267,38,200,2561
Iowa,Lester,269,22,147,10,0,22,201
Iowa,Inwood,938,99,448,61,2,91,701
Iowa,Reasnor,138,28,55,15,0,6,104
Iowa,Ocheyedan,512,29,263,64,0,37,393
Iowa,Hiawatha,7281,1959,2684,708,25,374,5750
Iowa,Cedar Rapids,131360,36427,49136,13022,1216,6392,106193
Iowa,Westwood,94,10,67,3,0,6,86
Iowa,Rome,89,10,44,6,2,4,66
Iowa,Mount Pleasant,8528,2658,3232,803,136,415,7244
Iowa,College Springs,226,34,86,29,7,17,173
Iowa,Braddyville,131,22,70,9,0,8,109
Iowa,Libertyville,378,73,169,33,5,24,304
Iowa,Center Point,2534,480,1175,144,4,76,1879
Iowa,Elkhart,813,157,292,124,17,31,621
Iowa,Des Moines,215932,65922,69304,23845,3295,9146,171512
Iowa,St. Ansgar,1237,160,611,65,8,75,919
Iowa,Cushing,208,34,110,15,0,16,175
Iowa,Brunsville,134,30,66,7,0,12,115
Iowa,Atalissa,350,78,169,23,5,18,293
Iowa,Pierson,378,57,171,29,3,23,283
Iowa,Walford,1471,176,831,79,7,27,1120
Iowa,Coon Rapids,1283,201,575,105,14,112,1007
Iowa,Randall,170,23,78,16,2,6,125
Iowa,Salix,367,83,141,50,1,14,289
Iowa,Le Roy,6,0,6,0,0,0,6
Iowa,Varina,48,15,12,11,1,3,42
Iowa,Larchwood,927,141,483,65,3,49,741
Iowa,Fayette,1146,652,256,84,3,71,1066
Iowa,Fairbank,1154,251,555,83,22,34,945
Iowa,Fertile,307,66,158,25,2,20,271
Iowa,Stanley,131,29,45,10,0,11,95
Iowa,Traer,1603,322,716,121,4,178,1341
Iowa,Mechanicsville,986,211,350,134,3,113,811
Iowa,Delhi,491,121,218,51,10,23,423
Iowa,Oxford Junction,415,106,181,34,0,24,345
Iowa,Paton,195,52,85,21,2,12,172
Iowa,Riceville,827,183,338,71,10,82,684
Iowa,What Cheer,773,139,314,102,6,43,604
Iowa,Webster,141,43,61,6,0,9,119
Iowa,South English,278,62,128,12,9,5,216
Iowa,Ollie,202,33,102,19,0,17,171
Iowa,Keota,1027,213,388,103,13,93,810
Iowa,Delta,338,81,67,27,12,62,249
Iowa,Hubbard,739,123,382,36,5,91,637
Iowa,Garner,3059,497,1580,189,0,209,2475
Iowa,Wapello,2055,505,848,168,7,148,1676
Iowa,Grandview,503,80,242,47,2,26,397
Iowa,Lincoln,121,32,40,15,1,13,101
Iowa,Dysart,1437,248,751,92,0,83,1174
Iowa,Bancroft,688,118,305,50,2,67,542
Iowa,Eldora,2664,682,1039,293,28,239,2281
Iowa,Rippey,224,39,87,26,7,18,177
Iowa,Primghar,917,196,365,97,4,81,743
Iowa,Boxholm,162,13,86,38,0,11,148
Iowa,Barnum,273,61,101,12,1,9,184
Iowa,Ogden,1997,430,871,203,24,152,1680
Iowa,Washburn,656,152,283,167,0,44,646
Iowa,Twin Lakes,189,24,142,16,7,0,189
Iowa,Toeterville,38,5,17,8,0,8,38
Iowa,Sun Valley Lake,249,10,199,20,6,14,249
Iowa,Stone City,241,73,121,14,0,10,218
Iowa,Sexton,0,0,0,0,0,0,0
Iowa,Watkins,116,0,75,15,0,8,98
Iowa,St. Joseph,123,6,50,0,0,0,56
Iowa,South Amana,121,11,93,17,0,0,121
Iowa,Roseville,0,0,0,0,0,0,0
Iowa,Rochester,90,36,0,38,0,16,90
Iowa,River Sioux,97,12,55,3,0,6,76
Iowa,Portland,55,0,37,18,0,0,55
Iowa,Percival,90,6,66,0,0,5,77
Iowa,St. Benedict,26,7,4,15,0,0,26
Iowa,Otranto,0,0,0,0,0,0,0
Iowa,West Amana,220,129,31,20,0,18,198
Iowa,Amana,324,47,190,16,13,27,293
Iowa,Corley,23,0,23,0,0,0,23
Iowa,Conroy,255,80,101,36,0,19,236
Iowa,Climbing Hill,124,29,21,38,0,0,88
Iowa,Chapin,110,45,62,0,0,0,107
Iowa,California Junction,76,8,53,0,0,0,61
Iowa,Burr Oak,175,60,62,20,0,15,157
Iowa,Weston,84,0,78,0,0,6,84
Iowa,Burchinal,13,0,13,0,0,0,13
Iowa,Bolan,8,0,0,8,0,0,8
Iowa,Bentley,105,5,74,0,0,6,85
Iowa,Beaverdale,1032,242,429,106,25,16,818
Iowa,Bartlett,10,0,10,0,0,0,10
Iowa,Athelstan,16,16,0,0,0,0,16
Iowa,Anderson,44,13,22,0,0,0,35
Iowa,Bradford,89,0,70,0,0,0,70
Iowa,Denmark,376,67,136,63,0,44,310
Iowa,New Haven,80,6,36,6,0,0,48
Iowa,Mineola,154,42,40,23,0,37,142
Iowa,Franklin,141,10,95,7,2,9,123
Iowa,Persia,301,52,141,14,7,9,223
Iowa,Collins,436,71,154,56,2,13,296
Iowa,Kellerton,294,34,96,61,0,22,213
Iowa,Diagonal,387,74,147,18,6,69,314
Iowa,Grant,126,23,43,24,0,11,101
Iowa,Badger,509,101,245,37,0,44,427
Iowa,Emmetsburg,3771,845,1765,187,15,322,3134
Iowa,Richland,617,107,328,38,12,35,520
Iowa,Kinross,51,7,22,9,0,7,45
Iowa,Gibson,43,4,17,9,0,7,37
Iowa,Woden,233,60,78,29,1,10,178
Iowa,Imogene,31,3,17,1,0,1,22
Iowa,Wallingford,198,31,96,23,1,11,162
Iowa,Searsboro,184,48,49,28,4,14,143
Iowa,Mona,96,35,52,9,0,0,96
Iowa,Colo,916,192,392,87,2,40,713
Iowa,Ferguson,171,31,53,39,2,27,152
Iowa,Miller,22,0,22,0,0,0,22
Iowa,Middle Amana,752,143,394,6,0,64,607
Iowa,Meyer,12,0,12,0,0,0,12
Iowa,Loveland,0,0,0,0,0,0,0
Iowa,Madrid,2584,412,1091,344,20,207,2074
Iowa,Arlington,471,106,227,41,3,19,396
Iowa,Gilbert,955,159,502,57,2,10,730
Iowa,Northwood,2205,535,909,189,5,142,1780
Iowa,Henderson,172,18,79,12,0,11,120
Iowa,Little Cedar,41,0,33,0,0,8,41
Iowa,Lake Panorama,864,71,598,77,15,39,800
Iowa,Kent,26,7,13,0,0,0,20
Iowa,Maharishi Vedic City,593,277,196,83,3,11,570
Iowa,Liscomb,278,68,132,18,1,13,232
Iowa,Manly,1471,352,557,178,18,101,1206
Iowa,Lehigh,405,94,182,46,0,39,361
Iowa,Diamondhead Lake,347,57,192,0,23,33,305
Iowa,East Amana,43,22,14,0,0,7,43
Iowa,Irwin,341,45,189,35,8,21,298
Iowa,Casey,385,103,125,56,1,35,320
Iowa,Okoboji,881,181,498,80,5,48,812
Iowa,Milford,2989,423,1293,312,63,156,2247
Iowa,New Hampton,3445,713,1500,296,0,276,2785
Iowa,Eagle Grove,3437,948,1406,166,44,199,2763
Iowa,Tennant,72,13,34,3,0,7,57
Iowa,Murray,717,106,308,69,10,62,555
Iowa,Garden Grove,208,24,89,7,7,12,139
Iowa,Osceola,5021,832,2155,516,86,274,3863
Iowa,Modale,286,59,140,26,6,10,241
Iowa,Magnolia,149,39,73,15,1,12,140
Iowa,Grundy Center,2700,458,1261,280,7,149,2155
Iowa,Mediapolis,1713,287,704,178,8,153,1330
Iowa,Lamoni,2498,1149,728,210,29,82,2198
Iowa,Danville,1042,159,444,95,11,76,785
Iowa,Alton,1299,190,723,37,4,42,996
Iowa,Macedonia,241,43,102,37,0,11,193
Iowa,Superior,226,45,83,10,5,16,159
Iowa,Pilot Mound,189,31,80,34,8,24,177
Iowa,Jewell Junction,1265,263,545,119,25,46,998
Iowa,Grand River,202,27,92,29,4,7,159
Iowa,Davis City,239,16,86,50,16,12,180
Iowa,Havelock,132,21,54,20,2,5,102
Iowa,Matlock,82,15,54,3,0,5,77
Iowa,George,1150,116,671,48,0,90,925
Iowa,North Liberty,18357,5054,6742,1425,227,423,13871
Iowa,Laurel,256,63,106,28,0,15,212
Iowa,Clemons,156,33,80,16,0,2,131
Iowa,Zearing,540,130,259,31,5,32,457
Iowa,Cambridge,804,106,350,70,8,23,557
Iowa,Millersburg,133,27,62,29,2,4,124
Iowa,Owasa,46,11,28,4,0,3,46
Iowa,Duncan,103,43,20,28,0,0,91
Iowa,Waterville,116,20,63,8,1,8,100
Iowa,Maxwell,832,164,425,53,3,24,669
Iowa,Guernsey,47,11,21,2,1,6,41
Iowa,Albia,3761,646,1557,278,44,421,2946
Iowa,Blencoe,248,44,122,24,0,5,195
Iowa,Panorama Park,90,9,39,18,0,12,78
Iowa,Maysville,179,30,83,22,0,13,148
Iowa,McCausland,309,47,165,14,8,10,244
Iowa,Montezuma,1388,192,616,137,19,78,1042
Iowa,Buffalo,1184,299,516,128,7,73,1023
Iowa,Holiday Lake,399,75,239,58,7,8,387
Iowa,High Amana,77,6,38,5,0,8,57
Iowa,Hayfield,82,21,48,4,0,9,82
Iowa,Green Mountain,165,23,38,20,0,29,110
Iowa,Garden City,146,21,75,10,0,0,106
Iowa,Frytown,35,0,35,0,0,0,35
Iowa,Homestead,250,0,113,0,0,16,129
Iowa,Albion,615,143,293,67,4,16,523
Iowa,Victor,843,109,437,61,1,64,672
Iowa,Morning Sun,857,182,396,64,18,47,707
Iowa,Ellston,32,4,17,6,0,3,30
Iowa,Nevada,6798,1203,2950,654,97,396,5300
Iowa,Gowrie,940,180,411,66,14,105,776
Iowa,Shannon City,81,15,41,5,1,3,65
Iowa,Fort Dodge,24417,7395,7860,3123,392,1354,20124
Iowa,Bennett,357,82,188,28,0,13,311
Iowa,Lime Springs,538,83,226,66,0,56,431
Iowa,Laurens,1224,226,522,137,41,102,1028
Iowa,Lynnville,446,92,214,23,5,33,367
Iowa,Lambs Grove,250,16,130,23,0,12,181
Iowa,Colfax,1915,520,800,207,32,85,1644
Iowa,Maynard,542,118,198,50,3,42,411
Iowa,Mason City,27309,7314,10381,2833,367,1798,22693
Iowa,Agency,603,111,287,68,13,54,533
Iowa,Valeria,41,12,15,4,0,2,33
Iowa,Duncombe,287,76,115,45,1,20,257
Iowa,Clermont,581,74,292,83,8,40,497
Iowa,West Branch,2061,447,964,231,26,138,1806
Iowa,Bellevue,2267,451,998,145,23,186,1803
Iowa,Meservey,197,26,114,19,2,13,174
Iowa,Clear Lake,7644,1315,3737,721,90,588,6451
Iowa,Castana,145,16,54,19,0,6,95
Iowa,Britt,1915,353,844,130,5,234,1566
Iowa,New Liberty,173,31,73,7,1,16,128
Iowa,Dixon,185,46,76,23,5,16,166
Iowa,St. Anthony,50,8,16,14,1,1,40
Iowa,Mallard,215,34,121,11,10,12,188
Iowa,St. Donatus,107,13,68,8,2,5,96
Iowa,Hastings,188,50,59,13,0,13,135
Iowa,Ames,65937,36031,18819,2509,398,1327,59084
Iowa,Humboldt,4583,757,2096,419,77,385,3734
Iowa,Bradgate,63,9,38,4,0,2,53
Iowa,Manchester,5037,800,2326,373,0,517,4016
Iowa,Greeley,260,50,140,15,0,13,218
Iowa,Earlville,841,177,389,55,0,67,688
Iowa,Polk City,4481,559,1998,409,55,124,3145
Iowa,Ankeny,59152,13642,24749,5343,395,1549,45678
Iowa,Goodell,89,12,35,23,2,9,81
Iowa,Anamosa,5461,1526,1931,782,47,440,4726
Iowa,Chariton,4151,947,1563,516,36,373,3435
Iowa,Melrose,155,15,91,17,0,2,125
Iowa,Sibley,2639,547,1096,198,39,256,2136
Iowa,Bassett,49,11,30,6,1,1,49
Iowa,Panora,1162,234,496,99,5,95,929
Iowa,Winfield,1042,200,428,132,4,70,834
Iowa,Archer,144,16,80,14,1,7,118
Iowa,Vining,70,16,28,4,0,11,59
Iowa,Melvin,248,36,106,31,0,12,185
Iowa,Fredonia,292,74,115,13,4,8,214
Iowa,Eldon,1071,217,414,135,35,81,882
Iowa,Linn Grove,190,22,97,22,0,20,161
Iowa,Clayton,53,6,39,6,0,2,53
Iowa,Elma,612,95,254,64,0,62,475
Iowa,Luana,268,65,93,24,3,21,206
Iowa,McGregor,821,184,314,154,3,66,721
Iowa,Buffalo Center,989,176,460,42,0,71,749
Iowa,Chester,193,43,77,12,0,6,138
Iowa,Protivin,327,31,181,22,3,28,265
Iowa,Letts,451,88,184,44,10,20,346
Iowa,Blakesburg,297,39,115,53,4,47,258
Iowa,Indianola,15653,4201,6107,1441,70,781,12600
Iowa,Elkport,6,1,3,1,0,1,6
Kansas,Paradise,28,6,18,1,0,3,28
Kansas,Cedar Vale,519,156,155,35,9,28,383
Kansas,Fall River,137,21,58,32,1,10,122
Kansas,Beloit,3995,936,1445,537,0,288,3206
Kansas,Olsburg,217,27,112,30,0,4,173
Kansas,Harper,1287,233,572,126,19,106,1056
Kansas,Cawker City,591,116,251,73,6,49,495
Kansas,Hunter,63,4,36,10,0,7,57
Kansas,Scottsville,26,0,12,12,0,0,24
Kansas,Peru,169,31,79,31,0,4,145
Kansas,Perry,894,124,372,137,4,51,688
Kansas,Woodbine,211,37,122,14,0,0,173
Kansas,Plainville,2025,399,883,97,29,167,1575
Kansas,Morrill,234,36,108,27,10,3,184
Kansas,Americus,723,101,366,76,6,47,596
Kansas,Willis,24,0,16,6,0,1,23
Kansas,Selden,337,82,154,23,1,17,277
Kansas,Deerfield,710,142,306,39,0,20,507
Kansas,Lake Quivira,982,151,576,37,16,23,803
Kansas,Council Grove,2282,493,903,212,5,208,1821
Kansas,Gridley,314,52,130,40,3,24,249
Kansas,Douglass,1881,369,748,135,33,121,1406
Kansas,Lucas,387,97,176,32,6,27,338
Kansas,El Dorado,12988,3121,4931,1513,81,935,10581
Kansas,Garfield,197,28,81,20,0,34,163
Kansas,Garden City,26806,6917,9386,1931,438,1362,20034
Kansas,Almena,398,80,163,40,19,26,328
Kansas,Oxford,1065,122,467,121,18,108,836
Kansas,Wellington,7834,1694,2730,1017,116,671,6228
Kansas,Olpe,575,81,280,45,2,48,456
Kansas,Palco,163,49,39,25,6,11,130
Kansas,Bucklin,828,74,362,89,24,64,613
Kansas,Elwood,850,148,370,153,7,67,745
Kansas,Effingham,534,61,223,71,0,56,411
Kansas,Nortonville,619,129,268,46,0,43,486
Kansas,Admire,79,7,37,10,0,17,71
Kansas,Great Bend,15544,3461,6084,1617,149,846,12157
Kansas,Natoma,302,34,159,36,1,22,252
Kansas,Lewis,399,64,224,24,11,13,336
Kansas,Strong City,454,92,188,40,15,44,379
Kansas,Leona,32,7,12,2,1,1,23
Kansas,Fowler,495,114,150,61,2,46,373
Kansas,Horton,1758,296,740,214,29,113,1392
Kansas,Conway Springs,1475,326,539,107,22,106,1100
Kansas,Agra,222,32,117,38,2,16,205
Kansas,Kensington,464,58,245,31,0,61,395
Kansas,Basehor,5669,958,2456,600,20,254,4288
Kansas,Walton,305,63,147,35,0,13,258
Kansas,Cedar,19,0,11,2,0,2,15
Kansas,Frankfort,698,90,353,40,2,96,581
Kansas,Colby,5505,1536,2407,336,18,226,4523
Kansas,Luray,165,26,84,17,0,10,137
Kansas,Emporia,24649,8287,8509,2035,293,848,19972
Kansas,Dodge City,27808,6325,10412,2055,530,1000,20322
Kansas,Utica,127,24,62,24,0,9,119
Kansas,Collyer,69,7,43,6,1,3,60
Kansas,Powhattan,93,23,25,13,4,4,69
Kansas,Caldwell,996,205,407,108,18,107,845
Kansas,Argonia,535,108,186,57,0,41,392
Kansas,Chautauqua,42,0,20,10,0,4,34
Kansas,Anthony,2169,406,961,166,24,186,1743
Kansas,Wheaton,66,9,40,5,0,0,54
Kansas,Westmoreland,665,180,282,69,0,34,565
Kansas,Bassett,17,1,11,0,0,4,16
Kansas,Mulberry,451,65,197,70,34,18,384
Kansas,Cedar Point,21,0,4,0,1,1,6
Kansas,Wamego,4811,1122,1948,388,70,279,3807
Kansas,Lancaster,225,28,106,27,0,24,185
Kansas,Arcadia,425,98,136,58,0,26,318
Kansas,Huron,89,23,28,19,0,3,73
Kansas,Galatia,29,1,19,2,0,5,27
Kansas,Downs,806,149,379,111,7,58,704
Kansas,Milan,60,7,29,8,0,6,50
Kansas,Moran,408,76,135,78,0,49,338
Kansas,Copeland,323,71,162,17,0,27,277
Kansas,Winchester,628,151,188,170,2,36,547
Kansas,Yoder,192,21,143,28,0,0,192
Kansas,Wright,109,4,44,25,0,0,73
Kansas,Wilroads Gardens,432,83,191,80,0,33,387
Kansas,Weskan,140,20,60,10,0,0,90
Kansas,Welda,63,18,12,18,0,15,63
Kansas,Wakarusa,257,46,125,17,0,12,200
Kansas,Vassar,822,132,455,98,0,35,720
Kansas,Ensign,221,54,72,53,0,10,189
Kansas,Talmage,117,0,63,12,21,0,96
Kansas,Rosalia,100,18,46,7,13,8,92
Kansas,Riverton,881,57,431,121,0,53,662
Kansas,Piqua,93,26,36,5,0,12,79
Kansas,Odin,125,6,66,21,0,0,93
Kansas,Munjor,217,7,76,54,0,33,170
Kansas,Menlo,52,2,25,3,0,0,30
Kansas,Gem,125,58,45,5,0,2,110
Kansas,Roxbury,40,8,32,0,0,0,40
Kansas,Elsmore,81,21,20,7,4,7,59
Kansas,De Soto,6138,825,2732,662,162,214,4595
Kansas,Kansas City,152069,44085,48548,13726,3052,6512,115923
Kansas,Sedan,951,184,303,157,8,145,797
Kansas,Williamsburg,385,60,177,42,3,18,300
Kansas,Geuda Springs,157,27,74,12,3,22,138
Kansas,Logan,594,113,273,64,0,44,494
Kansas,Paxico,262,42,117,19,13,3,194
Kansas,Burdett,433,102,167,29,18,45,361
Kansas,Scott City,3954,718,1814,322,0,177,3031
Kansas,Lane,225,57,90,44,0,16,207
Kansas,Latham,169,27,58,27,0,14,126
Kansas,Dresden,96,14,51,2,0,4,71
Kansas,Thayer,609,100,266,64,10,32,472
Kansas,Hardtner,182,30,83,29,0,7,149
Kansas,Radium,22,0,11,5,0,3,19
Kansas,Seward,38,9,13,7,0,4,33
Kansas,Sylvan Grove,290,59,117,48,3,16,243
Kansas,Holcomb,2204,435,1022,118,16,38,1629
Kansas,Ingalls,222,42,98,17,0,15,172
Kansas,Rantoul,199,44,50,40,7,7,148
Kansas,Jennings,146,44,42,26,9,9,130
Kansas,Bushton,285,53,133,14,0,14,214
Kansas,Overbrook,938,194,427,76,6,88,791
Kansas,Melvern,455,112,155,72,5,9,353
Kansas,Arlington,545,138,205,85,1,33,462
Kansas,Holton,3257,782,1042,522,22,231,2599
Kansas,Junction City,23703,4201,10688,1885,374,791,17939
Kansas,Longton,376,92,120,47,8,24,291
Kansas,Partridge,217,51,96,18,4,12,181
Kansas,Pretty Prairie,536,86,255,38,0,38,417
Kansas,Wathena,1437,299,547,161,13,133,1153
Kansas,Brownell,55,12,17,6,3,4,42
Kansas,Mayfield,95,17,52,6,0,1,76
Kansas,Mulvane,5719,832,2686,791,21,331,4661
Kansas,Hamlin,71,17,22,0,6,2,47
Kansas,Severance,122,16,49,13,6,6,90
Kansas,Coolidge,187,25,56,16,4,24,125
Kansas,St. Paul,614,80,268,49,14,42,453
Kansas,Stark,73,12,31,2,4,13,62
Kansas,Spearville,1015,128,550,35,13,40,766
Kansas,Raymond,70,14,33,5,0,18,70
Kansas,Haddam,113,18,41,13,0,12,84
Kansas,Earlton,102,2,45,1,1,6,55
Kansas,Atchison,10675,3523,3360,1051,74,568,8576
Kansas,Blue Rapids,1081,246,484,64,16,78,888
Kansas,Danville,46,3,30,4,0,0,37
Kansas,Miltonvale,586,87,260,91,2,30,470
Kansas,Jamestown,341,92,147,38,0,16,293
Kansas,Aurora,75,15,23,16,0,2,56
Kansas,Redfield,113,19,58,12,1,0,90
Kansas,Zurich,99,15,43,16,0,8,82
Kansas,Woodston,100,36,32,15,0,4,87
Kansas,Stockton,1543,267,648,170,28,114,1227
Kansas,Ashland,633,81,323,78,3,67,552
Kansas,Greeley,271,46,93,28,5,19,191
Kansas,Marquette,704,142,272,126,3,47,590
Kansas,Bendena,113,31,54,0,0,28,113
Kansas,Bucyrus,412,97,217,19,0,11,344
Kansas,Wallace,73,17,38,9,0,6,70
Kansas,Glen Elder,427,76,205,36,0,35,352
Kansas,Simpson,54,10,24,9,3,2,48
Kansas,Emmett,122,20,62,9,0,0,91
Kansas,Burden,715,122,259,105,8,31,525
Kansas,Hesston,3777,966,1802,95,0,267,3130
Kansas,Winfield,12138,3015,4452,1499,213,723,9902
Kansas,Ottawa,12275,2941,4904,1410,69,540,9864
Kansas,Halstead,2158,460,887,134,3,128,1612
Kansas,Tonganoxie,5073,1183,1864,539,46,352,3984
Kansas,Gaylord,165,24,79,7,1,17,128
Kansas,Catharine,32,0,24,0,0,8,32
Kansas,Toronto,239,31,98,51,6,16,202
Kansas,McLouth,1184,266,452,145,22,45,930
Kansas,Park,142,11,71,17,2,14,115
Kansas,Gove City,89,24,34,7,0,5,70
Kansas,Scranton,645,151,242,88,19,31,531
Kansas,Timken,68,22,19,0,4,12,57
Kansas,Soldier,90,19,31,15,0,3,68
Kansas,Pawnee Rock,266,77,78,39,0,28,222
Kansas,Wetmore,354,98,137,19,4,26,284
Kansas,Lost Springs,108,18,42,12,0,18,90
Kansas,Chicopee,673,124,328,48,0,10,510
Kansas,Falun,60,25,28,0,0,7,60
Kansas,Benedict,94,24,42,2,7,8,83
Kansas,Coyville,50,14,13,9,0,0,36
Kansas,McCune,396,64,165,52,8,9,298
Kansas,New Albany,165,12,24,54,0,3,93
Kansas,Brewster,327,25,202,18,0,12,257
Kansas,Montezuma,892,172,411,63,3,115,764
Kansas,Bunker Hill,179,17,79,18,0,6,120
Kansas,Dorrance,223,36,113,21,0,4,174
Kansas,Summerfield,124,9,64,23,0,11,107
Kansas,Denton,160,27,78,18,0,10,133
Kansas,White Cloud,109,25,36,18,1,9,89
Kansas,Elmdale,67,24,28,6,0,1,59
Kansas,Long Island,153,29,78,6,5,6,124
Kansas,Prairie View,116,22,65,8,2,2,99
Kansas,Coats,142,31,54,16,4,9,114
Kansas,Milton,169,15,125,0,0,0,140
Kansas,Marienthal,53,27,25,1,0,0,53
Kansas,McConnell AFB,1488,427,631,36,5,0,1099
Kansas,Lowell,368,12,123,0,0,109,244
Kansas,Fort Dodge,172,13,24,51,0,84,172
Kansas,Fort Riley,7116,3427,2134,117,0,0,5678
Kansas,Franklin,499,179,184,33,0,0,396
Kansas,Grantville,186,80,73,15,0,0,168
Kansas,Harris,0,0,0,0,0,0,0
Kansas,Healy,203,44,92,10,8,22,176
Kansas,Hillsdale,305,58,212,24,0,0,294
Kansas,Detroit,135,13,54,9,0,0,76
Kansas,Home,143,7,104,0,0,18,129
Kansas,Kickapoo Site 1,59,17,22,5,0,0,44
Kansas,Kickapoo Site 2,61,20,8,8,0,0,36
Kansas,Kickapoo Site 5,32,13,14,3,0,2,32
Kansas,Kickapoo Site 7,34,13,6,9,2,2,32
Kansas,Kickapoo Tribal Center,144,45,45,22,0,10,122
Kansas,Kipp,112,22,0,25,0,0,47
Kansas,Levant,30,0,30,0,0,0,30
Kansas,Kickapoo Site 6,36,2,10,3,0,0,15
Kansas,Sublette,1556,249,712,138,3,114,1216
Kansas,Lawrence,95294,41489,29640,6943,294,3042,81408
Kansas,Walnut,186,29,68,26,7,6,136
Kansas,Peabody,1171,227,442,116,26,155,966
Kansas,Dexter,327,29,164,28,7,26,254
Kansas,Wellsville,1987,375,851,176,11,94,1507
Kansas,Newton,18923,4100,7854,1847,112,982,14895
Kansas,Athol,37,4,21,7,0,2,34
Kansas,Neosho Falls,143,26,42,35,7,9,119
Kansas,Formoso,92,19,50,6,1,5,81
Kansas,Clifton,425,70,220,35,3,54,382
Kansas,Palmer,168,10,110,0,2,7,129
Kansas,Havana,97,17,30,15,3,8,73
Kansas,Salina,47230,11033,18368,5381,598,2652,38032
Kansas,Canton,754,126,375,80,6,28,615
Kansas,Altoona,282,42,128,16,8,36,230
Kansas,Benton,971,221,382,143,21,43,810
Kansas,Sun City,36,1,24,1,0,1,27
Kansas,Ulysses,5639,1044,2372,387,77,252,4132
Kansas,Tribune,765,123,353,23,9,86,594
Kansas,Longford,130,35,41,19,0,5,100
Kansas,Lakin,1974,406,861,50,30,158,1505
Kansas,Little River,497,102,201,38,7,54,402
Kansas,Medicine Lodge,2027,426,754,251,69,164,1664
Kansas,Lebo,753,117,360,113,11,23,624
Kansas,Waverly,677,88,314,54,14,72,542
Kansas,Blue Mound,332,64,158,39,4,23,288
Kansas,Havensville,138,36,67,12,4,4,123
Kansas,Louisville,214,60,95,19,0,17,191
Kansas,Belle Plaine,1585,266,792,148,17,95,1318
Kansas,Arma,1313,192,518,235,11,144,1100
Kansas,Merriam,11243,3586,4018,1489,127,504,9724
Kansas,Greenleaf,438,73,141,53,4,23,294
Kansas,Dunlap,30,0,21,3,2,4,30
Kansas,Hoxie,1145,149,570,129,20,113,981
Kansas,Bentley,558,92,258,50,0,33,433
Kansas,Olathe,135986,28284,60003,10323,1045,3654,103309
Kansas,Prairie Village,22048,4711,10208,1841,127,927,17814
Kansas,Fairway,3947,667,1942,273,15,168,3065
Kansas,Bel Aire,7671,1130,3804,467,39,350,5790
Kansas,La Harpe,579,125,248,69,2,58,502
Kansas,Gas,488,71,267,38,3,32,411
Kansas,Barnes,165,38,75,5,4,11,133
Kansas,Latimer,23,6,9,1,0,0,16
Kansas,Edgerton,1665,346,650,171,7,32,1206
Kansas,Gardner,21351,3734,8763,1942,193,638,15270
Kansas,Herndon,134,28,66,15,3,8,120
Kansas,Dighton,1031,198,436,52,0,117,803
Kansas,Horace,109,14,51,4,1,1,71
Kansas,Goessel,582,106,253,50,3,69,481
Kansas,Ramona,107,11,40,23,3,10,87
Kansas,Udall,660,78,300,86,14,46,524
Kansas,Gypsum,441,65,198,50,3,18,334
Kansas,New Cambria,67,13,22,21,1,6,63
Kansas,Abilene,6422,1116,2810,779,10,458,5173
Kansas,Carlton,12,2,9,0,0,0,11
Kansas,Hepler,139,35,49,4,0,20,108
Kansas,Tampa,124,24,63,8,0,7,102
Kansas,Bronson,281,33,113,37,0,11,194
Kansas,Moundridge,2186,285,1009,190,0,264,1748
Kansas,Lehigh,220,39,99,17,4,6,165
Kansas,Claflin,491,94,207,68,2,44,415
Kansas,Alton,119,35,42,12,1,14,104
Kansas,Schoenchen,161,43,83,18,2,4,150
Kansas,Ellis,2158,274,907,230,11,126,1548
Kansas,Oketo,82,10,55,1,0,4,70
Kansas,Axtell,384,72,169,34,3,28,306
Kansas,Valley Falls,1017,261,435,91,8,106,901
Kansas,Iola,5400,1362,1770,710,141,336,4319
Kansas,Meriden,731,105,301,88,14,39,547
Kansas,Prescott,255,38,82,43,10,53,226
Kansas,Pleasanton,1454,196,564,159,54,117,1090
Kansas,Norcatur,316,40,134,48,0,29,251
Kansas,Greeley County unified government (balance),326,48,178,22,5,18,271
Kansas,Chase,514,68,188,80,4,25,365
Kansas,Frederick,6,0,6,0,0,0,6
Kansas,Niotaze,91,16,57,4,3,1,81
Kansas,Lincoln Center,1323,313,515,160,5,115,1108
Kansas,Mission,9437,3055,3602,1049,40,429,8175
Kansas,Larned,3865,984,1437,636,0,239,3296
Kansas,Minneola,928,146,324,135,22,62,689
Kansas,Baileyville,269,94,114,0,0,9,217
Kansas,Parkerville,70,22,14,8,0,3,47
Kansas,Chetopa,1329,267,490,158,24,101,1040
Kansas,Oswego,1839,397,739,205,14,152,1507
Kansas,Shawnee,65239,14285,29444,5468,559,2108,51864
Kansas,Westwood,1624,410,684,166,11,44,1315
Kansas,Westwood Hills,378,57,199,41,0,8,305
Kansas,Cheney,2028,252,949,159,18,110,1488
Kansas,Linn,444,101,175,44,1,36,357
Kansas,Cherryvale,2194,392,769,275,81,140,1657
Kansas,Elk City,299,43,137,25,0,15,220
Kansas,Cullison,48,13,25,4,0,3,45
Kansas,Pratt,6774,1432,2655,679,102,487,5355
Kansas,Richfield,37,8,23,1,0,0,32
Kansas,Rolla,589,130,233,44,0,26,433
Kansas,Jewell,506,98,208,47,15,36,404
Kansas,Inman,1309,251,628,81,4,138,1102
Kansas,Clearwater,2608,352,1184,242,12,153,1943
Kansas,Leavenworth,36008,8023,13672,4269,684,1446,28094
Kansas,Asherville,0,0,0,0,0,0,0
Kansas,Ada,139,139,0,0,0,0,139
Kansas,LeRoy,657,129,301,51,2,53,536
Kansas,Parkerfield,376,66,233,10,1,12,322
Kansas,Ransom,345,22,184,35,2,30,273
Kansas,Manhattan,55489,27359,16108,3739,316,1320,48842
Kansas,Riley,1434,156,635,189,11,83,1074
Kansas,Portis,100,13,51,7,0,3,74
Kansas,Reserve,54,9,32,8,2,3,54
Kansas,Hiawatha,3158,488,1294,409,33,207,2431
Kansas,Nickerson,1038,186,461,116,19,40,822
Kansas,Chapman,1241,253,516,141,11,85,1006
Kansas,Labette,55,3,43,0,0,2,48
Kansas,Linwood,508,120,151,108,0,30,409
Kansas,Bird City,530,64,248,54,13,36,415
Kansas,Elbing,336,54,180,6,0,10,250
Kansas,Barnard,39,2,21,5,0,11,39
Kansas,Harveyville,265,72,124,19,0,22,237
Kansas,Oberlin,1640,244,646,237,13,205,1345
Kansas,Plains,1121,209,471,59,39,35,813
Kansas,Galesburg,166,32,65,10,0,4,111
Kansas,Ford,226,48,94,42,0,13,197
Kansas,Louisburg,4386,805,1810,522,19,196,3352
Kansas,Willard,95,20,20,17,0,7,64
Kansas,Andover,12862,2357,5653,1026,24,541,9601
Kansas,Bern,168,19,87,17,0,4,127
Kansas,Corning,235,58,74,14,0,4,150
Kansas,Goff,167,46,38,24,10,4,122
Kansas,Roseland,99,38,40,12,0,1,91
Kansas,Enterprise,1069,266,383,97,20,78,844
Kansas,Delphos,406,82,157,75,0,20,334
Kansas,Concordia,5138,1164,1951,520,12,433,4080
Kansas,Madison,854,137,428,88,20,19,692
Kansas,Sharon Springs,858,140,372,63,22,75,672
Kansas,Atlanta,172,28,97,21,0,16,162
Kansas,Freeport,0,0,0,0,0,0,0
Kansas,Waldron,19,8,11,0,0,0,19
Kansas,Minneapolis,1736,259,783,174,14,156,1386
Kansas,Hillsboro,2851,895,1184,186,21,218,2504
Kansas,Otis,274,58,108,33,0,32,231
Kansas,Olivet,44,3,25,12,0,1,41
Kansas,Quenemo,370,78,141,48,19,16,302
Kansas,Lenexa,53051,11584,24620,4193,445,1998,42840
Kansas,Leoti,1549,257,781,72,28,75,1213
Kansas,McDonald,184,31,96,10,1,15,153
Kansas,Richmond,657,111,239,90,9,49,498
Kansas,Lansing,11835,3590,4723,1365,175,314,10167
Kansas,Derby,23768,4408,10903,1656,287,1157,18411
Kansas,La Crosse,1170,205,459,172,8,132,976
Kansas,Offerle,228,41,120,6,2,9,178
Kansas,Cambridge,161,36,63,6,0,17,122
Kansas,Arkansas City,11986,2581,4166,1513,216,775,9251
Kansas,Oneida,86,61,12,6,0,5,84
Kansas,Munden,105,16,59,13,0,8,96
Kansas,Vining,73,22,9,6,6,7,50
Kansas,Washington,1088,166,460,117,3,99,845
Kansas,Coffeyville,9578,2378,3063,1140,323,834,7738
Kansas,Sawyer,140,44,48,7,9,4,112
Kansas,Oak Hill,58,29,9,13,0,1,52
Kansas,Randall,65,8,23,14,0,6,51
Kansas,Florence,460,62,183,79,12,33,369
Kansas,Rossville,1263,296,512,104,12,74,998
Kansas,Marion,1832,243,840,140,7,209,1439
Kansas,Assaria,466,96,212,47,0,23,378
Kansas,Brookville,296,67,122,36,0,14,239
Kansas,White City,635,163,256,67,8,54,548
Kansas,Wilsey,144,37,64,25,0,4,130
Kansas,Kinsley,1569,279,652,183,25,129,1268
Kansas,Morganville,192,19,98,24,8,4,153
Kansas,Wakefield,1048,208,465,116,17,56,862
Kansas,Durham,100,8,65,10,0,6,89
Kansas,Lincolnville,167,20,87,37,0,7,151
Kansas,Burr Oak,199,42,102,22,0,23,189
Kansas,Maize,4696,1214,1466,430,67,112,3289
Kansas,Belpre,125,24,30,9,11,6,80
Kansas,Allen,166,35,62,24,3,12,136
Kansas,Robinson,204,21,82,27,5,15,150
Kansas,Ozawkie,647,84,351,44,2,31,512
Kansas,Bennington,749,128,318,67,0,48,561
Kansas,Cuba,283,19,130,54,0,12,215
Kansas,Cottonwood Falls,770,177,290,76,16,104,663
Kansas,South Haven,342,76,138,30,1,27,272
Kansas,Grainfield,289,36,157,13,8,27,241
Kansas,Hunnewell,108,15,63,2,0,5,85
Kansas,Matfield Green,22,0,8,10,0,4,22
Kansas,Parsons,9876,2395,3553,1043,85,724,7800
Kansas,Hanover,627,116,318,46,0,39,519
Kansas,Iuka,162,15,82,12,0,9,118
Kansas,Webber,26,1,21,4,0,0,26
Kansas,Centralia,558,78,275,44,1,42,440
Kansas,Scandia,507,75,219,68,4,27,393
Kansas,Clay Center,4079,459,1813,523,40,285,3120
Kansas,Sterling,2515,914,850,206,24,164,2158
Kansas,Mildred,12,2,4,3,0,0,9
Kansas,La Cygne,1134,270,425,87,33,73,888
Kansas,Quinter,889,122,431,53,14,79,699
Kansas,Norton,2792,455,1163,276,23,280,2197
Kansas,Leon,675,125,317,64,5,30,541
Kansas,Liberal,20251,5185,6626,1684,148,984,14627
Kansas,Hoyt,601,167,241,73,5,20,506
Kansas,Elgin,85,20,40,9,0,8,77
Kansas,Susank,24,3,17,3,0,0,23
Kansas,Mission Woods,177,22,107,15,4,6,154
Kansas,Albert,159,23,85,10,0,12,130
Kansas,Ellinwood,2375,451,1105,204,79,72,1911
Kansas,St. George,951,131,345,100,20,25,621
Kansas,Bison,164,27,92,14,6,8,147
Kansas,Eudora,6745,1291,2840,503,111,156,4901
Kansas,Macksville,545,64,271,22,8,12,377
Kansas,Bonner Springs,7796,1586,3136,848,33,384,5987
Kansas,Hope,380,31,181,40,15,35,302
Kansas,Bluff City,146,39,33,3,7,21,103
Kansas,Onaga,808,131,304,118,2,93,648
Kansas,Overland Park,188687,44476,83820,15552,1588,7703,153139
Kansas,Lebanon,283,44,122,30,5,25,226
Kansas,Sabetha,2555,425,1162,188,49,225,2049
Kansas,Baxter Springs,4004,795,1666,468,28,218,3175
Kansas,Tipton,218,31,102,18,1,21,173
Kansas,North Newton,1879,623,844,74,0,126,1667
Kansas,Edwardsville,4462,852,1683,430,55,206,3226
Kansas,Linn Valley,745,84,402,86,10,35,617
Kansas,Cunningham,403,47,184,46,2,32,311
Kansas,Stafford,1122,160,423,144,30,128,885
Kansas,Hays,20956,7557,7123,1613,160,1020,17473
Kansas,Fort Scott,7800,1907,2837,697,96,675,6212
Kansas,Fulton,116,11,55,9,0,7,82
Kansas,Cimarron,2312,308,1109,94,35,87,1633
Kansas,Oskaloosa,1438,333,563,138,14,103,1151
Kansas,Elk Falls,94,9,42,16,0,6,73
Kansas,Vermillion,86,14,32,8,4,6,64
Kansas,Clyde,861,145,356,74,16,81,672
Kansas,Eureka,2308,358,833,413,42,172,1818
Kansas,Lenora,326,24,179,20,2,35,260
Kansas,Hamilton,271,70,96,41,7,12,226
Kansas,Russell,4460,708,2350,380,40,284,3762
Kansas,Tescott,289,76,105,25,4,31,241
Kansas,Severy,207,28,98,39,1,19,185
Kansas,Liebenthal,163,51,47,21,0,14,133
Kansas,Hugoton,4067,835,1643,227,113,188,3006
Kansas,Baldwin City,4658,1586,1495,469,13,291,3854
Kansas,Lecompton,701,153,252,82,2,30,519
Kansas,Green,171,21,92,14,3,2,132
Kansas,Burns,288,46,124,19,6,18,213
Kansas,Burlingame,968,202,355,133,15,43,748
Kansas,Savonburg,57,7,14,16,0,6,43
Kansas,Neosho Rapids,212,30,102,15,6,32,185
Kansas,Rose Hill,4024,747,2052,219,32,168,3218
Kansas,Winona,270,68,109,21,1,8,207
Kansas,Circleville,193,27,93,14,1,8,143
Kansas,Rexford,232,22,93,7,1,14,137
Kansas,Gorham,408,77,148,24,8,16,273
Kansas,Osborne,1507,306,627,115,14,152,1214
Kansas,Milford,321,32,145,37,4,5,223
Kansas,Denison,127,15,60,15,0,8,98
Kansas,Zenda,79,17,34,5,1,13,70
Kansas,Meade,1592,358,647,186,40,103,1334
Kansas,Ellsworth,3030,878,1152,326,111,183,2650
Kansas,Alta Vista,504,79,233,65,17,20,414
Kansas,Penalosa,2,0,2,0,0,0,2
Kansas,Kismet,424,51,252,28,9,19,359
Kansas,Norwich,487,99,207,30,3,26,365
Kansas,Russell Springs,25,1,5,6,2,5,19
Kansas,Nashville,27,3,15,4,0,4,26
Kansas,Fontana,263,52,122,7,2,10,193
Kansas,Osawatomie,4315,1032,1080,828,29,240,3209
Kansas,Spring Hill,6315,942,2747,562,71,228,4550
Kansas,Speed,33,3,17,6,0,2,28
Kansas,Kingman,2977,485,1278,310,19,401,2493
Kansas,Burrton,876,113,374,97,14,49,647
Kansas,Beattie,215,58,101,11,0,17,187
Kansas,Agenda,44,2,20,6,0,7,35
Kansas,Rush Center,221,47,89,11,0,40,187
Kansas,Mount Hope,784,127,332,84,4,83,630
Kansas,Eastborough,762,144,413,42,0,27,626
Kansas,Garden Plain,779,133,366,42,0,58,599
Kansas,Goodland,4515,921,1819,444,13,383,3580
Kansas,Bartlett,60,19,23,3,0,2,47
Kansas,Girard,2721,804,904,265,34,169,2176
Kansas,Neodesha,2074,401,779,298,40,176,1694
Kansas,Buffalo,298,50,94,41,1,33,219
Kansas,Fredonia,2314,401,876,304,88,160,1829
Kansas,Sylvia,246,26,92,20,0,11,149
Kansas,Kirwin,155,8,90,15,4,7,124
Kansas,South Hutchinson,2494,392,1037,378,53,293,2153
Kansas,Abbyville,80,16,47,3,0,5,71
Kansas,Auburn,1181,133,537,143,8,61,882
Kansas,McCracken,202,24,108,6,0,25,163
Kansas,Netawaka,174,43,81,19,1,2,146
Kansas,Carbondale,1371,311,516,173,3,57,1060
Kansas,Moscow,225,47,110,9,0,8,174
Kansas,Osage City,2821,312,1305,292,61,281,2251
Kansas,Mission Hills,3580,561,2110,82,11,81,2845
Kansas,Galena,2924,606,1057,440,117,185,2405
Kansas,Haviland,727,216,277,37,4,67,601
Kansas,WaKeeney,1988,389,915,193,10,203,1710
Kansas,Eskridge,555,98,217,85,6,75,481
Kansas,McFarland,358,84,164,18,1,27,294
Kansas,Bogue,344,29,98,43,10,12,192
Kansas,Hudson,98,25,44,9,0,15,93
Kansas,Chanute,9119,1785,3270,1325,149,634,7163
Kansas,Lyons,3608,435,1800,248,17,326,2826
Kansas,Hazelton,150,33,45,7,6,21,112
Kansas,Highland,1069,700,192,37,4,45,978
Kansas,Alexander,82,11,15,17,0,23,66
Kansas,Spivey,39,10,15,8,0,6,39
Kansas,Ogden,1745,411,577,228,61,46,1323
Kansas,Randolph,160,33,75,15,0,4,127
Kansas,Maple Hill,648,119,291,62,4,23,499
Kansas,Glade,15,1,10,2,0,2,15
Kansas,Yates Center,1309,233,490,182,17,141,1063
Kansas,Grenola,184,8,107,18,0,8,141
Kansas,Plevna,76,16,39,6,5,1,67
Kansas,Topeka,126877,33052,45234,14945,1317,7287,101835
Kansas,Mullinville,226,45,99,17,1,9,171
Kansas,Ness City,1512,180,786,61,6,137,1170
Kansas,Mayetta,301,49,126,44,1,22,242
Kansas,Delia,168,12,100,8,0,4,124
Kansas,Culver,112,16,44,5,9,16,90
Kansas,Mahaska,66,16,38,4,0,0,58
Kansas,Whiting,193,32,87,18,0,8,145
Kansas,Lyndon,1043,254,412,115,5,37,823
Kansas,Altamont,1047,173,463,76,20,55,787
Kansas,Morrowville,148,35,70,6,0,9,120
Kansas,Caney,1838,405,758,228,34,96,1521
Kansas,Liberty,91,39,20,13,0,6,78
Kansas,Wilmore,34,3,27,3,0,1,34
Kansas,Preston,167,31,54,35,3,12,135
Kansas,Republic,110,13,59,12,4,12,100
Kansas,Windom,110,6,50,11,0,1,68
Kansas,Howard,684,94,314,64,6,85,563
Kansas,Silver Lake,1514,222,665,128,0,70,1085
Kansas,Uniontown,311,51,84,35,5,39,214
Kansas,Bushong,10,1,6,0,0,3,10
Kansas,Hartford,377,108,149,26,0,29,312
Kansas,Reading,201,27,90,22,5,6,150
Kansas,Clayton,63,11,28,4,0,8,51
Kansas,Everest,283,49,134,17,0,45,245
Kansas,Fairview,359,57,170,43,2,20,292
Kansas,St. Francis,1428,211,627,168,4,168,1178
Kansas,Kanopolis,491,56,243,53,4,41,397
Kansas,Seneca,1990,327,926,165,4,244,1666
Kansas,Goddard,4319,789,1681,463,21,134,3088
Kansas,Waterville,743,100,362,43,9,44,558
Kansas,Marysville,3289,616,1263,376,39,324,2618
Kansas,Waldo,62,18,24,0,6,3,51
Kansas,Grinnell,283,48,127,35,0,31,241
Kansas,Syracuse,1808,478,673,101,59,55,1366
Kansas,Olmitz,110,24,44,16,0,10,94
Kansas,Hoisington,2589,616,969,225,43,99,1952
Kansas,Victoria,975,239,457,48,18,56,818
Kansas,Augusta,9358,1610,3780,835,127,719,7071
Kansas,Park City,7885,1350,3402,769,109,176,5806
Kansas,Cassoday,136,10,70,21,0,8,109
Kansas,Lorraine,182,38,75,13,0,8,134
Kansas,Rozel,119,17,58,15,4,6,100
Kansas,Satanta,1083,173,457,46,31,58,765
Kansas,Edna,367,37,177,54,3,15,286
Kansas,Manchester,140,41,38,11,11,16,117
Kansas,Cherokee,873,154,349,69,5,58,635
Kansas,Pittsburg,20280,7770,5710,1995,292,801,16568
Kansas,Mound Valley,351,74,135,56,8,20,293
Kansas,Kanorado,220,23,132,4,2,18,179
Kansas,Potwin,553,133,205,36,4,17,395
Kansas,Holyrood,500,81,225,64,9,42,421
Kansas,Isabel,104,5,62,9,0,7,83
Kansas,Johnson City,1229,192,645,54,17,59,967
Kansas,Belvue,384,111,90,16,3,24,244
Kansas,St. Marys,2653,571,1127,80,17,87,1882
Kansas,Easton,288,59,106,46,9,31,251
Kansas,Smith Center,1527,232,741,159,4,133,1269
Kansas,Belleville,1852,279,816,169,25,249,1538
Kansas,Courtland,315,52,149,28,0,29,258
Kansas,Narka,124,40,30,11,13,8,102
Kansas,Grandview Plaza,1438,243,724,162,20,32,1181
Kansas,Turon,365,63,155,36,6,17,277
Kansas,Lindsborg,3309,902,1164,356,19,281,2722
Kansas,Colony,511,139,144,66,5,35,389
Kansas,Virgil,37,0,20,5,0,12,37
Kansas,Lone Elm,14,4,8,0,0,2,14
Kansas,Englewood,77,15,28,7,0,0,50
Kansas,West Mineral,126,18,51,14,2,5,90
Kansas,Haven,1195,160,547,105,4,66,882
Kansas,Willowbrook,88,8,64,0,1,3,76
Kansas,Smolan,178,45,84,26,3,6,164
Kansas,Solomon,1171,218,459,112,2,65,856
Kansas,Galva,1066,148,550,87,7,59,851
Kansas,McPherson,13041,2860,5891,810,215,696,10472
Kansas,Frontenac,3424,622,1498,459,0,210,2789
Kansas,Colwich,1159,168,533,92,5,45,843
Kansas,Kechi,2643,625,1404,166,4,46,2245
Kansas,Protection,379,81,150,49,2,29,311
Kansas,Attica,749,103,305,48,11,44,511
Kansas,Climax,40,3,22,0,0,5,30
Kansas,Glasco,514,106,180,82,0,56,424
Kansas,Hollenberg,22,1,10,6,0,5,22
Kansas,Dearing,603,134,284,27,16,32,493
Kansas,Tyro,195,32,90,16,0,14,152
Kansas,Byers,30,0,17,6,0,0,23
Kansas,Columbus,3113,647,1235,402,22,182,2488
Kansas,Scammon,591,127,234,64,5,25,455
Kansas,Mapleton,90,16,47,7,0,6,76
Kansas,Humboldt,1793,396,719,198,6,157,1476
Kansas,Edmond,121,76,31,1,0,1,109
Kansas,Damar,161,34,78,7,1,14,134
Kansas,Jetmore,857,141,411,69,12,78,711
Kansas,Mound City,1019,250,416,99,13,61,839
Kansas,Manter,308,97,102,21,5,25,250
Kansas,Oakley,1965,348,933,130,3,158,1572
Kansas,Hill City,1559,278,721,157,16,137,1309
Kansas,Morland,131,11,64,27,0,13,115
Kansas,Erie,1210,156,487,139,11,101,894
Kansas,Alden,114,6,51,19,0,3,79
Kansas,Herington,2163,304,1005,270,23,132,1734
Kansas,Leawood,34570,4882,19078,1846,122,1335,27263
Kansas,Roeland Park,6796,2153,2703,534,36,386,5812
Kansas,Dwight,197,44,93,10,0,28,175
Kansas,Atwood,1104,208,467,94,21,109,899
Kansas,Andale,901,124,401,40,0,28,593
Kansas,Muscotah,176,36,61,20,0,16,133
Kansas,Oaklawn-Sunview,3144,766,861,471,129,109,2336
Kansas,Garnett,3251,344,1416,422,14,336,2532
Kansas,Kincaid,111,13,42,13,2,2,72
Kansas,Westphalia,161,26,75,17,0,10,128
Kansas,St. John,1269,187,684,104,13,82,1070
Kansas,Geneseo,234,56,103,14,4,19,196
Kansas,Parker,484,144,179,29,0,10,362
Kansas,Bazine,339,44,202,15,8,11,280
Kansas,Wilson,730,112,326,76,6,63,583
Kansas,New Strawn,437,63,263,21,1,5,353
Kansas,Towanda,1292,163,570,89,9,75,906
Kansas,Whitewater,789,137,358,69,7,39,610
Kansas,Phillipsburg,2655,525,1108,280,20,196,2129
Kansas,Alma,953,160,450,82,15,80,787
Kansas,Paola,5585,1031,2346,532,0,446,4355
Kansas,Kiowa,937,137,411,112,15,54,729
Kansas,Sharon,166,26,83,25,0,13,147
Kansas,Burlington,2587,581,983,289,70,166,2089
Kansas,Hanston,304,40,157,13,9,10,229
Kansas,Beverly,133,32,42,23,0,3,100
Kansas,Leonardville,486,86,258,34,0,33,411
Kansas,Troy,937,225,403,115,0,48,791
Kansas,Viola,92,12,41,14,2,7,76
Kansas,Langdon,36,25,6,5,0,0,36
Kansas,Mankato,870,138,350,113,4,87,692
Kansas,Esbon,126,7,69,22,0,12,110
Kansas,Valley Center,6747,1123,3201,524,0,361,5209
Kansas,Elkhart,1689,287,732,119,4,200,1342
Kansas,Independence,8847,2030,3204,1068,58,645,7005
Kansas,Wichita,389563,100804,142230,40910,5737,16727,306408
Kansas,Princeton,242,60,91,22,2,21,196
Kansas,Pomona,1158,276,444,151,14,51,936
Kansas,Hutchinson,41146,9838,15718,5111,456,2511,33634
Kansas,Buhler,1188,166,594,116,21,76,973
Kansas,Greensburg,910,198,376,82,9,78,743
Kansas,Weir,624,106,268,83,9,47,513
Kansas,Moline,381,57,165,38,2,31,293
Kansas,Coldwater,892,159,343,104,0,78,684
Kansas,Haysville,11298,2011,4342,1156,107,739,8355
Kansas,Sedgwick,1432,357,637,85,14,87,1180
Kentucky,Bremen,226,16,124,24,0,9,173
Kentucky,St. Regis Park,1336,268,645,120,11,80,1124
Kentucky,Pioneer Village,2872,456,1492,293,59,190,2490
Kentucky,Augusta,1119,221,482,121,25,78,927
Kentucky,Falmouth,2915,689,937,325,54,249,2254
Kentucky,Fort Knox,8965,1872,4082,481,72,54,6561
Kentucky,Gamaliel,303,46,149,17,13,25,250
Kentucky,Goshen,960,181,446,80,6,26,739
Kentucky,Buckhorn,115,45,28,17,0,4,94
Kentucky,Pikeville,6967,2074,2329,734,174,525,5836
Kentucky,Newport,15152,5022,4323,2024,389,904,12662
Kentucky,Worthington Hills,1494,416,523,195,14,45,1193
Kentucky,Woodland Hills,723,141,319,67,7,43,577
Kentucky,Phelps,750,51,389,141,14,16,611
Kentucky,Kuttawa,678,67,273,110,9,72,531
Kentucky,Brandenburg,2850,825,948,375,45,215,2408
Kentucky,Clay,1030,162,380,174,17,113,846
Kentucky,Wheatcroft,130,23,70,10,14,5,122
Kentucky,Hyden,443,99,165,53,19,72,408
Kentucky,Windy Hills,2297,296,1204,272,40,167,1979
Kentucky,Calvert City,2509,381,1121,223,34,215,1974
Kentucky,Tompkinsville,2731,530,1111,301,38,278,2258
Kentucky,Lebanon,5621,1335,1487,1271,62,439,4594
Kentucky,Raywick,139,38,39,25,15,12,129
Kentucky,Coal Run Village,1534,380,571,203,30,143,1327
Kentucky,La Grange,8735,2060,3086,963,117,576,6802
Kentucky,River Bluff,471,87,239,27,4,23,380
Kentucky,Lakeview Heights,304,40,164,31,0,14,249
Kentucky,Ravenna,673,106,249,87,19,57,518
Kentucky,Crestview Hills,3281,975,1391,339,22,235,2962
Kentucky,Erlanger,18776,4918,7155,1779,368,1112,15332
Kentucky,Ekron,333,98,82,36,9,28,253
Kentucky,Princeton,6157,1151,2314,894,46,426,4831
Kentucky,Claryville,2581,495,1200,200,9,129,2033
Kentucky,Mentor,312,77,134,22,1,17,251
Kentucky,Clinton,1368,388,294,190,77,180,1129
Kentucky,Edgewood,8723,1358,4601,547,25,379,6910
Kentucky,Fort Mitchell,8237,2241,3089,703,0,282,6315
Kentucky,Irvington,1268,230,472,155,31,149,1037
Kentucky,Perryville,1009,314,380,129,31,50,904
Kentucky,Clay City,1059,198,233,260,58,65,814
Kentucky,Brodhead,1527,325,544,151,70,120,1210
Kentucky,Alexandria,9211,2090,4148,833,18,390,7479
Kentucky,Jeffersonville,1912,289,831,209,83,70,1482
Kentucky,Owenton,1616,299,532,232,36,198,1297
Kentucky,Beattyville,1375,351,322,224,98,156,1151
Kentucky,Warfield,350,36,140,34,4,19,233
Kentucky,Berea,15188,4441,5181,1598,198,662,12080
Kentucky,Eddyville,2565,849,753,532,57,112,2303
Kentucky,Science Hill,553,111,232,73,15,40,471
Kentucky,Gratz,90,13,42,0,6,3,64
Kentucky,McRoberts,893,257,391,36,0,93,777
Kentucky,Woodlawn Park,864,244,407,60,8,28,747
Kentucky,Westwood,670,87,333,44,0,28,492
Kentucky,Seneca Gardens,662,82,390,46,2,28,548
Kentucky,Fleming-Neon,599,147,233,87,8,59,534
Kentucky,Rolling Hills,909,235,364,108,3,24,734
Kentucky,Bellevue,5828,1590,2104,823,89,235,4841
Kentucky,Hunters Hollow,269,62,130,33,8,3,236
Kentucky,Hillview,8987,2251,3500,1077,102,440,7370
Kentucky,Salyersville,1772,325,618,251,63,181,1438
Kentucky,Fredonia,628,118,294,25,7,25,469
Kentucky,Sardis,93,35,26,19,0,3,83
Kentucky,Indian Hills,2965,418,1773,84,11,94,2380
Kentucky,Mockingbird Valley,155,14,89,4,2,16,125
Kentucky,Old Brownsboro Place,394,63,227,20,4,19,333
Kentucky,Highland Heights,7136,3666,1765,626,35,425,6517
Kentucky,Annville,1110,171,447,155,65,94,932
Kentucky,Manor Creek,322,21,160,23,3,9,216
Kentucky,Lexington-Fayette urban,318734,101736,112055,31679,4655,12026,262151
Kentucky,Bancroft,469,80,268,25,0,21,394
Kentucky,South Wallins,583,62,260,18,27,79,446
Kentucky,Hodgenville,3213,687,1062,324,48,337,2458
Kentucky,Upton,699,97,320,65,24,38,544
Kentucky,Bellemeade,814,128,417,85,5,93,728
Kentucky,Bellewood,302,35,156,26,0,17,234
Kentucky,Crossgate,241,30,134,13,2,15,194
Kentucky,Audubon Park,1352,299,726,80,7,84,1196
Kentucky,Goose Creek,267,48,151,28,0,17,244
Kentucky,Fincastle,868,191,397,96,5,19,708
Kentucky,Hurstbourne Acres,1891,661,694,206,21,63,1645
Kentucky,Parkway Village,644,165,218,119,10,28,540
Kentucky,St. Matthews,18147,5036,6612,2480,315,1111,15554
Kentucky,Strathmoor Manor,367,50,210,18,2,10,290
Kentucky,Watterson Park,1082,347,282,166,32,37,864
Kentucky,Wellington,438,112,196,48,2,31,389
Kentucky,Norbourne Estates,430,81,224,36,1,21,363
Kentucky,Benham,527,70,300,28,10,29,437
Kentucky,Wingo,728,209,210,101,38,40,598
Kentucky,Wheelwright,645,147,206,109,51,64,577
Kentucky,Booneville,143,17,80,3,0,3,103
Kentucky,Pewee Valley,1568,338,783,85,7,113,1326
Kentucky,Greenville,4323,886,1505,671,177,360,3599
Kentucky,Central City,5822,1446,2233,553,117,401,4750
Kentucky,West Liberty,3369,1222,906,622,111,192,3053
Kentucky,Benton,4460,634,2047,365,92,477,3615
Kentucky,Vanceburg,1400,311,382,271,45,159,1168
Kentucky,St. Charles,334,40,151,10,8,20,229
Kentucky,Nebo,184,15,106,5,6,7,139
Kentucky,Madisonville,19138,4089,6977,2541,435,966,15008
Kentucky,Nicholasville,29977,6587,11372,3689,440,1432,23520
Kentucky,Sonora,709,143,290,52,9,13,507
Kentucky,Westwood,4509,744,1958,811,58,240,3811
Kentucky,Jeffersontown,28178,6812,11630,2698,310,1542,22992
Kentucky,Milton,693,96,295,113,7,39,550
Kentucky,Greensburg,2214,417,745,342,85,255,1844
Kentucky,Plum Springs,464,92,180,62,6,16,356
Kentucky,East Bernstadt,876,215,378,70,57,21,741
Kentucky,Blackey,150,24,72,11,4,20,131
Kentucky,Oakland,240,32,123,38,2,16,211
Kentucky,Sanders,233,75,51,40,18,25,209
Kentucky,North Middletown,747,175,268,91,12,32,578
Kentucky,Ashland,20822,4526,7703,2772,365,1417,16783
Kentucky,Owensboro,59188,14216,19896,8135,1123,3538,46908
Kentucky,Warsaw,1861,592,558,296,34,130,1610
Kentucky,South Shore,982,229,292,121,45,136,823
Kentucky,Anchorage,2281,299,1217,88,0,41,1645
Kentucky,Vine Grove,5969,1300,2562,645,55,258,4820
Kentucky,Harlan,1452,309,519,222,45,129,1224
Kentucky,Forest Hills,437,87,220,41,0,14,362
Kentucky,Belleview,308,25,170,7,0,8,210
Kentucky,Hickory Hill,117,16,76,4,0,4,100
Kentucky,Beechmont,755,121,330,97,29,18,595
Kentucky,Beech Grove,415,94,198,64,17,16,389
Kentucky,Bandana,355,59,227,0,0,0,286
Kentucky,Auxier,892,261,481,36,14,0,792
Kentucky,Artemus,531,112,188,39,25,19,383
Kentucky,Louisville/Jefferson County metro government (balance),617032,180857,209568,68289,10496,30383,499593
Kentucky,Middlesborough,9583,1851,3180,1421,274,890,7616
Kentucky,Heritage Creek,1069,221,512,105,15,96,949
Kentucky,Woodburn,365,69,180,44,3,33,329
Kentucky,Meadow Vale,733,122,408,44,2,39,615
Kentucky,Worthville,178,39,59,24,4,11,137
Kentucky,Liberty,1970,351,620,340,59,282,1652
Kentucky,Dry Ridge,2465,540,771,317,44,73,1745
Kentucky,Wurtland,1385,222,570,185,17,197,1191
Kentucky,Horse Cave,2376,541,718,377,64,221,1921
Kentucky,Eminence,2546,650,803,341,58,159,2011
Kentucky,Briarwood,514,126,174,89,2,27,418
Kentucky,Douglass Hills,5702,1233,2410,549,19,306,4517
Kentucky,Druid Hills,399,28,178,62,0,12,280
Kentucky,Glenview,455,43,297,26,3,19,388
Kentucky,Glenview Manor,266,48,114,25,1,15,203
Kentucky,Hills and Dales,182,27,115,6,0,6,154
Kentucky,Hollow Creek,765,133,445,41,0,52,671
Kentucky,Hollyvilla,477,96,184,56,4,37,377
Kentucky,Meadowview Estates,425,160,93,93,16,27,389
Kentucky,Kingsley,406,94,195,38,0,17,344
Kentucky,Trenton,445,88,228,38,4,23,381
Kentucky,Richlawn,387,80,190,45,2,17,334
Kentucky,Drakesboro,474,129,187,45,7,30,398
Kentucky,Greenup,1268,363,473,153,40,86,1115
Kentucky,Guthrie,1340,313,367,247,8,84,1019
Kentucky,Raceland,2661,478,1147,418,50,139,2232
Kentucky,West Point,907,253,240,139,17,64,713
Kentucky,Munfordville,1688,391,530,265,55,181,1422
Kentucky,Lincolnshire,170,22,88,14,2,8,134
Kentucky,Providence,3050,691,1093,410,37,253,2484
Kentucky,Crestwood,4914,945,2212,307,23,88,3575
Kentucky,Wayland,313,45,119,47,6,32,249
Kentucky,Allen,191,52,75,21,2,8,158
Kentucky,Marion,2935,730,857,525,41,370,2523
Kentucky,Dycusburg,78,10,25,43,0,0,78
Kentucky,Ghent,362,48,157,43,14,18,280
Kentucky,Catlettsburg,1931,489,618,339,109,117,1672
Kentucky,Dixon,1069,272,400,114,59,34,879
Kentucky,Mount Olivet,499,155,137,42,10,28,372
Kentucky,Hazard,5170,1300,1853,1021,49,259,4482
Kentucky,Prestonsburg,3645,1027,1110,533,175,204,3049
Kentucky,Buckner,5465,1741,1708,792,150,139,4530
Kentucky,Flemingsburg,2837,470,1100,430,47,211,2258
Kentucky,Burkesville,1733,580,363,222,26,257,1448
Kentucky,Elizabethtown,29474,6973,10406,3730,651,1676,23436
Kentucky,Bellefonte,856,101,542,33,3,52,731
Kentucky,Worthington,1579,361,715,157,44,134,1411
Kentucky,Radcliff,22693,5378,7892,2705,591,1100,17666
Kentucky,Cumberland,2039,449,549,278,61,250,1587
Kentucky,Campbellsburg,961,211,381,116,16,56,780
Kentucky,Creekside,295,71,135,16,0,29,251
Kentucky,New Castle,1094,207,447,105,26,106,891
Kentucky,Barbourmeade,1416,174,746,105,31,32,1088
Kentucky,Brownsboro Farm,664,90,368,41,6,21,526
Kentucky,Sparta,332,43,145,37,0,10,235
Kentucky,Eubank,397,106,68,61,25,17,277
Kentucky,Millersburg,718,162,304,93,23,64,646
Kentucky,Paris,9874,2579,3110,1265,199,675,7828
Kentucky,Hazel,391,64,142,59,9,35,309
Kentucky,Whitesville,499,80,199,39,9,52,379
Kentucky,Camargo,1399,267,484,156,33,128,1068
Kentucky,Fountain Run,193,34,74,17,5,34,164
Kentucky,Williamstown,3924,730,1268,571,131,206,2906
Kentucky,Poplar Hills,415,186,48,55,14,5,308
Kentucky,Norwood,450,64,217,50,2,16,349
Kentucky,Northfield,1142,223,479,76,15,116,909
Kentucky,Murray Hill,596,92,291,28,2,121,534
Kentucky,Meadowbrook Farm,140,23,60,12,1,5,101
Kentucky,Maryhill Estates,212,28,99,13,0,5,145
Kentucky,Hurstbourne,4383,412,2643,289,0,201,3545
Kentucky,Graymoor-Devondale,2959,493,1291,255,52,302,2393
Kentucky,Moorland,460,135,160,100,12,9,416
Kentucky,Middletown,7865,1525,3594,977,96,414,6606
Kentucky,Houston Acres,469,107,197,58,2,35,399
Kentucky,Coldstream,1394,342,485,172,5,34,1038
Kentucky,Brownsboro Village,359,92,158,46,2,22,320
Kentucky,Broeck Pointe,326,35,186,15,0,8,244
Kentucky,Beechwood Village,1338,315,570,115,11,63,1074
Kentucky,Riverwood,483,56,288,17,0,19,380
Kentucky,London,8020,1510,3137,1315,222,600,6784
Kentucky,Rolling Fields,714,84,389,26,2,35,536
Kentucky,Ten Broeck,129,21,82,11,0,4,118
Kentucky,Inez,870,218,297,113,23,100,751
Kentucky,Bradfordsville,248,45,86,48,4,16,199
Kentucky,North Corbin,2211,287,856,305,124,88,1660
Kentucky,West Buechel,1501,514,469,145,18,76,1222
Kentucky,Spring Valley,778,116,429,17,6,21,589
Kentucky,Plantation,896,206,295,119,4,22,646
Kentucky,Lyndon,11427,3826,3919,1170,157,695,9767
Kentucky,Blaine,55,13,30,2,0,10,55
Kentucky,Mount Sterling,7180,1412,2473,980,229,529,5623
Kentucky,Germantown,72,21,39,6,0,2,68
Kentucky,Dover,283,45,127,49,0,15,236
Kentucky,Loretto,670,159,223,72,16,45,515
Kentucky,Concord,9,0,2,3,1,3,9
Kentucky,Whitesburg,2335,326,949,308,29,270,1882
Kentucky,Jenkins,2358,628,817,249,34,141,1869
Kentucky,Thornhill,273,52,133,9,0,6,200
Kentucky,Muldraugh,1066,288,351,145,44,48,876
Kentucky,Mount Vernon,2702,558,769,468,134,197,2126
Kentucky,Fairview,144,33,71,8,4,11,127
Kentucky,Hardinsburg,2357,488,944,283,41,230,1986
Kentucky,Beaver Dam,3560,693,1547,321,56,208,2825
Kentucky,Hartford,2722,602,1020,342,31,264,2259
Kentucky,Russell Springs,2550,609,706,427,87,212,2041
Kentucky,Waverly,375,62,158,56,6,18,300
Kentucky,Barlow,571,127,184,83,27,49,470
Kentucky,La Center,894,174,381,101,18,111,785
Kentucky,Harrodsburg,8403,1815,3062,911,278,659,6725
Kentucky,Bloomfield,860,172,445,61,3,53,734
Kentucky,Glasgow,14370,3391,4602,2253,395,1276,11917
Kentucky,Ledbetter,1770,253,742,212,52,113,1372
Kentucky,Hustonville,530,58,222,40,1,59,380
Kentucky,Maysville,8797,2139,3192,1013,190,668,7202
Kentucky,Richmond,34566,15226,8208,3896,751,1701,29782
Kentucky,Ferguson,936,140,427,98,17,87,769
Kentucky,Orchard Grass Hills,1862,307,834,98,14,57,1310
Kentucky,Louisa,2947,535,1128,303,101,257,2324
Kentucky,Carlisle,2323,531,693,373,64,172,1833
Kentucky,Sturgis,1771,253,759,180,45,153,1390
Kentucky,Leitchfield,6784,990,2259,1224,243,519,5235
Kentucky,Hindman,568,112,252,29,25,52,470
Kentucky,Brooksville,666,156,202,66,22,67,513
Kentucky,Lebanon Junction,2046,482,894,203,57,126,1762
Kentucky,Cold Spring,6319,1207,3234,527,27,351,5346
Kentucky,Hickman,2318,740,681,212,101,186,1920
Kentucky,Earlington,1458,351,446,235,59,106,1197
Kentucky,Whitley City,1694,469,504,209,86,152,1420
Kentucky,Manchester,1440,363,607,158,41,119,1288
Kentucky,Irvine,2230,398,829,396,3,183,1809
Kentucky,Crofton,508,47,217,69,11,68,412
Kentucky,Winchester,18413,4603,6038,2611,540,1113,14905
Kentucky,Lancaster,3832,1004,1038,412,236,329,3019
Kentucky,Cynthiana,6348,1590,2079,948,195,578,5390
Kentucky,Robards,514,86,257,43,14,18,418
Kentucky,Rockport,225,44,98,27,9,12,190
Kentucky,Columbia,4722,1838,1392,470,52,411,4163
Kentucky,South Carrollton,217,25,78,48,3,14,168
Kentucky,Powderly,917,192,426,107,10,86,821
Kentucky,Mayfield,9940,2361,3231,1110,257,770,7729
Kentucky,Carrollton,3849,772,1400,478,32,203,2885
Kentucky,Prestonville,99,26,23,17,10,4,80
Kentucky,Martin,517,166,158,95,0,56,475
Kentucky,Fort Campbell North,13882,4716,5030,262,40,8,10056
Kentucky,LaFayette,180,49,55,17,0,25,146
Kentucky,Scottsville,4412,919,1619,916,10,255,3719
Kentucky,Kevil,624,114,254,71,2,76,517
Kentucky,Burgin,1087,247,383,157,0,107,894
Kentucky,Bardstown,13042,3272,4229,1761,162,627,10051
Kentucky,Burlington,17069,3734,7436,1272,266,556,13264
Kentucky,Florence,31940,7889,12103,3929,422,1669,26012
Kentucky,Sadieville,357,45,171,30,5,11,262
Kentucky,Shelbyville,15660,3629,5574,1853,490,684,12230
Kentucky,Caneyville,647,173,243,64,14,33,527
Kentucky,Clarkson,995,189,351,139,34,79,792
Kentucky,Pineville,1808,371,579,274,107,217,1548
Kentucky,Ewing,252,59,89,15,16,21,200
Kentucky,Woodlawn,205,70,82,16,3,4,175
Kentucky,Wilder,3083,894,1309,362,80,175,2820
Kentucky,Pine Knot,1350,437,561,165,39,68,1270
Kentucky,Lawrenceburg,11272,2094,4124,1708,267,523,8716
Kentucky,Stanford,3673,697,1473,462,106,369,3107
Kentucky,Slaughters,261,57,99,43,4,15,218
Kentucky,Butler,706,80,251,83,22,114,550
Kentucky,Elkton,2291,544,820,348,30,103,1845
Kentucky,Sebree,1362,267,426,143,39,114,989
Kentucky,Hopkinsville,31483,7819,9859,3945,768,2101,24492
Kentucky,Owingsville,2052,471,564,289,104,161,1589
Kentucky,Pippa Passes,631,556,62,4,2,4,628
Kentucky,Brooks,2575,598,1042,482,10,67,2199
Kentucky,Fox Chase,528,77,317,44,2,25,465
Kentucky,Hebron Estates,1080,228,618,80,4,89,1019
Kentucky,California,133,17,56,16,4,2,95
Kentucky,Southgate,3859,1213,1120,585,0,104,3022
Kentucky,Bardwell,743,101,314,83,12,54,564
Kentucky,Wilmore,6299,2351,2008,468,49,237,5113
Kentucky,Vicco,319,34,132,45,13,16,240
Kentucky,Oneida,339,93,141,10,12,22,278
Kentucky,Garrison,550,6,223,89,33,75,426
Kentucky,Corydon,838,141,340,62,5,51,599
Kentucky,Adairville,947,179,388,61,3,77,708
Kentucky,Morehead,7674,4374,1620,635,44,266,6939
Kentucky,Auburn,1293,277,441,184,7,154,1063
Kentucky,Lewisburg,783,104,313,87,15,75,594
Kentucky,Russellville,7008,1651,2324,959,224,554,5712
Kentucky,Park City,635,126,269,63,18,22,498
Kentucky,Junction City,2080,333,930,264,22,132,1681
Kentucky,Hendron,4821,741,2167,546,111,336,3901
Kentucky,Reidland,4467,687,2176,325,259,171,3618
Kentucky,Oakbrook,9301,2304,4442,737,62,374,7919
Kentucky,Salem,674,81,305,72,15,93,566
Kentucky,Livermore,1304,208,534,134,68,89,1033
Kentucky,Covington,40552,13128,10978,5631,840,2164,32741
Kentucky,Crescent Springs,4035,632,1730,339,31,96,2828
Kentucky,Villa Hills,7410,1787,3767,461,24,407,6446
Kentucky,Nortonville,879,175,389,81,20,88,753
Kentucky,Stearns,1052,152,616,20,0,31,819
Kentucky,Stamping Ground,847,175,271,119,13,49,627
Kentucky,Franklin,8762,2193,3032,1100,164,418,6907
Kentucky,Corinth,233,68,86,29,5,21,209
Kentucky,Campbellsville,11413,2970,3581,1527,270,739,9087
Kentucky,Island,515,76,250,45,10,18,399
Kentucky,Paducah,24879,6786,7930,3430,559,2003,20708
Kentucky,Pleasureville,1016,321,325,126,22,51,845
Kentucky,Albany,2293,542,654,393,36,355,1980
Kentucky,Rochester,287,49,109,24,0,18,200
Kentucky,Blandville,103,10,50,25,0,10,95
Kentucky,Independence,27183,5416,11920,1886,505,761,20488
Kentucky,Kenton Vale,123,36,58,9,2,5,110
Kentucky,McHenry,417,70,128,49,14,23,284
Kentucky,Morganfield,3463,882,1252,413,131,252,2930
Kentucky,Corbin,7194,1268,2468,951,311,597,5595
Kentucky,Lakeside Park,2749,688,1225,326,0,78,2317
Kentucky,Ludlow,4515,1419,1407,476,147,227,3676
Kentucky,Ryland Heights,1106,279,383,115,27,72,876
Kentucky,Hanson,733,144,261,113,7,72,597
Kentucky,Cloverport,908,201,336,150,20,91,798
Kentucky,Woodbury,42,6,27,2,0,1,36
Kentucky,Sandy Hook,714,112,209,132,27,107,587
Kentucky,Henderson,28800,6947,9750,4304,711,1876,23588
Kentucky,Simpsonville,2786,494,1181,280,25,87,2067
Kentucky,Campton,544,110,148,97,27,55,437
Kentucky,Shepherdsville,12117,3337,4436,1151,189,585,9698
Kentucky,Fort Thomas,16313,3358,7320,1563,135,735,13111
Kentucky,Brownsville,832,154,319,141,19,109,742
Kentucky,Fulton,2522,647,680,257,111,195,1890
Kentucky,Dawson Springs,2690,610,929,296,156,232,2223
Kentucky,Arlington,376,109,87,72,9,64,341
Kentucky,Mackville,252,35,115,5,0,11,166
Kentucky,Springfield,2982,974,801,360,46,199,2380
Kentucky,Willisburg,380,115,107,64,15,15,316
Kentucky,Williamsburg,5269,2278,1211,465,8,328,4290
Kentucky,Morgantown,2627,507,820,339,109,274,2049
Kentucky,Bromley,944,233,245,160,13,31,682
Kentucky,Frenchburg,776,209,284,70,28,39,630
Kentucky,Carrsville,36,0,29,2,0,2,33
Kentucky,Massac,4888,802,2067,503,89,274,3735
Kentucky,Georgetown,32902,7255,13170,3436,454,1219,25534
Kentucky,Fancy Farm,601,55,193,39,17,94,398
Kentucky,Fairview,294,29,108,0,0,0,137
Kentucky,Ezel,153,8,75,35,0,5,123
Kentucky,Emlyn,448,0,310,25,0,21,356
Kentucky,Elizaville,151,37,63,0,0,43,143
Kentucky,Dwale,142,36,21,40,0,37,134
Kentucky,Doe Valley,1877,243,1179,73,0,82,1577
Kentucky,Dexter,319,25,183,22,0,19,249
Kentucky,Crayne,174,19,77,20,0,25,141
Kentucky,Coldiron,202,62,56,8,0,4,130
Kentucky,Diablock,318,43,78,27,78,67,293
Kentucky,Chaplin,314,34,177,8,14,24,257
Kentucky,Farley,4398,879,1505,800,22,317,3523
Kentucky,Cerulean,283,95,161,27,0,0,283
Kentucky,Cayce,69,12,31,10,0,0,53
Kentucky,Cawood,497,125,224,24,0,0,373
Kentucky,Cannonsburg,719,277,114,93,15,48,547
Kentucky,Burna,229,85,93,6,0,7,191
Kentucky,Buffalo,379,78,165,53,10,0,306
Kentucky,Boston,113,13,74,18,0,8,113
Kentucky,Smithland,270,24,150,36,4,17,231
Kentucky,Crab Orchard,960,232,365,107,16,78,798
Kentucky,Calhoun,883,142,339,126,5,75,687
Kentucky,Sacramento,476,108,156,66,25,50,405
Kentucky,Smiths Grove,764,151,342,66,6,63,628
Kentucky,Betsy Layne,727,137,285,97,0,12,531
Kentucky,Cecilia,667,71,363,17,0,17,468
Kentucky,Fort Wright,5724,1620,2388,613,119,151,4891
Kentucky,Farmers,38,23,0,15,0,0,38
Kentucky,Flat Lick,1316,144,619,110,22,61,956
Kentucky,Midway,1749,623,651,141,34,77,1526
Kentucky,Onton,39,0,31,0,0,8,39
Kentucky,Edmonton,1676,350,563,339,62,156,1470
Kentucky,New Hope,144,59,23,17,0,23,122
Kentucky,Millstone,49,0,0,18,0,31,49
Kentucky,Mays Lick,291,63,169,0,0,30,262
Kentucky,Mayking,365,36,132,59,17,39,283
Kentucky,Marrowbone,126,0,79,15,0,0,94
Kentucky,Manitou,341,64,123,30,0,0,217
Kentucky,Magnolia,590,114,279,36,11,44,484
Kentucky,Maceo,330,94,167,16,0,9,286
Kentucky,McCarr,93,4,58,0,6,15,83
Kentucky,Farmington,161,53,59,16,0,6,134
Kentucky,Lowes,26,0,0,12,0,14,26
Kentucky,Kenvir,375,73,114,55,11,25,278
Kentucky,Jeff,193,21,110,23,4,0,158
Kentucky,Hiseville,195,33,113,15,0,0,161
Kentucky,High Bridge,306,32,239,16,0,19,306
Kentucky,Hebron,6160,904,2597,660,52,65,4278
Kentucky,Hazel Green,84,0,47,13,0,24,84
Kentucky,Hardyville,407,128,153,0,0,16,297
Kentucky,Gracey,76,33,26,17,0,0,76
Kentucky,Gilbertsville,539,74,179,122,0,71,446
Kentucky,Union,5815,952,3221,158,30,94,4455
Kentucky,Freeburn,281,0,149,35,0,27,211
Kentucky,Francisville,9401,1437,5115,268,29,135,6984
Kentucky,Lovelaceville,17,17,0,0,0,0,17
Kentucky,Elsmere,8570,2416,2397,1160,126,379,6478
Kentucky,White Plains,812,119,370,101,16,69,675
Kentucky,Taylor Mill,6746,1681,2484,894,93,267,5419
Kentucky,Silver Grove,1450,417,436,146,17,67,1083
Kentucky,Green Spring,738,96,402,47,11,31,587
Kentucky,Grayson,4015,1389,1039,353,108,474,3363
Kentucky,Olive Hill,1715,353,554,254,29,149,1339
Kentucky,Glenview Hills,367,49,195,8,0,26,278
Kentucky,Langdon Place,901,207,443,68,5,39,762
Kentucky,Somerset,11376,2726,3521,1567,258,1081,9153
Kentucky,Lynnview,1043,201,418,131,13,72,835
Kentucky,Shively,15741,4851,4125,2349,422,1190,12937
Kentucky,Wildwood,264,40,133,30,4,11,218
Kentucky,Monterey,133,18,68,26,0,13,125
Kentucky,Burnside,1087,159,400,165,3,89,816
Kentucky,Jamestown,2052,490,664,274,27,244,1699
Kentucky,Wickliffe,813,117,390,63,4,67,641
Kentucky,Hawesville,990,206,408,95,23,52,784
Kentucky,Fordsville,617,115,177,129,7,64,492
Kentucky,Masonville,1231,231,628,69,0,30,958
Kentucky,Jackson,2022,421,803,327,46,142,1739
Kentucky,Versailles,9192,2083,3434,1156,186,375,7234
Kentucky,Monticello,6088,1464,1890,666,228,661,4909
Kentucky,Glencoe,347,74,101,30,14,17,236
Kentucky,Bowling Green,65731,25563,18197,6409,1025,2746,53940
Kentucky,Cambridge,165,37,53,28,4,5,127
Kentucky,Blue Ridge Manor,827,284,279,124,6,66,759
Kentucky,McKee,1060,143,338,130,49,120,780
Kentucky,Melbourne,441,157,153,30,3,23,366
Kentucky,Lynch,613,88,326,52,8,57,531
Kentucky,Dayton,5422,1497,1984,612,69,283,4445
Kentucky,Barbourville,3119,936,928,442,166,234,2706
Kentucky,Elkhorn City,1064,145,412,163,9,147,876
Kentucky,Stanton,2646,575,1008,319,98,132,2132
Kentucky,Livingston,126,35,32,20,8,13,108
Kentucky,Oak Grove,7411,1757,2504,854,287,91,5493
Kentucky,Paintsville,4134,844,1387,747,109,347,3434
Kentucky,Cadiz,2608,610,781,420,70,233,2114
Kentucky,Crestview,461,106,189,29,3,18,345
Kentucky,Park Hills,2983,973,1064,216,81,86,2420
Kentucky,Berry,352,99,139,38,3,22,301
Kentucky,Breckinridge Center,2363,1563,264,91,47,7,1972
Kentucky,Hardin,544,116,153,79,15,22,385
Kentucky,Murray,19037,8324,5478,1563,350,914,16629
Kentucky,Mortons Gap,1241,206,525,201,12,78,1022
Kentucky,Prospect,4876,623,2986,319,22,198,4148
Kentucky,Taylorsville,1547,559,410,192,29,149,1339
Kentucky,Columbus,256,88,60,37,9,10,204
Kentucky,Uniontown,754,145,307,138,8,37,635
Kentucky,Walton,4281,717,1739,509,6,123,3094
Kentucky,Frankfort,27582,8151,8693,3935,695,1557,23031
Kentucky,Lewisport,1877,482,689,191,41,77,1480
Kentucky,Smithfield,132,28,45,28,1,3,105
Kentucky,Bedford,698,179,193,86,35,36,529
Kentucky,Bonnieville,236,63,48,34,0,36,181
Kentucky,Mount Washington,14433,2892,6110,1249,129,829,11209
Kentucky,Salt Lick,411,69,201,39,13,7,329
Kentucky,Danville,16685,5114,5520,2006,396,959,13995
Kentucky,Loyall,657,130,252,70,10,61,523
Kentucky,Crittenden,3861,764,1489,426,109,115,2903
Kentucky,Russell,3311,553,1612,310,28,209,2712
Kentucky,Tolu,60,22,6,19,0,5,52
Kentucky,Symsonia,549,85,246,44,0,36,411
Kentucky,Summersville,583,46,261,16,0,50,373
Kentucky,Verona,1502,275,689,147,0,120,1231
Kentucky,Summer Shade,207,7,104,25,0,39,175
Kentucky,Spottsville,406,51,301,17,0,0,369
Kentucky,South Williamson,533,54,350,19,34,25,482
Kentucky,Sedalia,444,172,198,32,0,7,409
Kentucky,Salvisa,286,85,107,16,0,18,226
Kentucky,Rosine,136,0,89,17,0,9,115
Kentucky,Evarts,691,207,268,65,34,36,610
Kentucky,Rabbit Hash,426,102,134,60,0,0,296
Kentucky,Pryorsburg,308,81,71,8,47,10,217
Kentucky,Pleasant View,527,164,234,70,0,24,492
Kentucky,Plano,1015,211,547,108,0,13,879
Kentucky,Petersburg,551,155,200,124,0,18,497
Kentucky,Payne Gap,340,85,160,23,0,44,312
Kentucky,Pathfork,432,63,221,37,0,33,354
Kentucky,Pembroke,852,156,370,68,2,55,651
Kentucky,Fairfield,86,14,51,4,0,14,83
Kentucky,New Haven,609,126,189,101,16,56,488
Kentucky,Cave City,2772,860,816,261,78,172,2187
Kentucky,Grand Rivers,336,44,220,35,7,22,328
Kentucky,Sharpsburg,466,88,210,40,13,27,378
Kentucky,Centertown,471,87,231,35,10,11,374
Kentucky,Virgie,129,0,93,0,12,10,115
Kentucky,Westport,271,74,132,5,22,20,253
Kentucky,Rockholds,289,85,102,60,0,14,261
Kentucky,Water Valley,217,15,125,22,15,16,193
Kentucky,Flatwoods,7186,1218,3073,911,144,686,6032
Kentucky,Wallins Creek,411,32,255,54,6,12,359
Kentucky,Strathmoor Village,679,154,297,59,9,21,540
Kentucky,Spring Mill,269,55,144,18,0,11,228
Kentucky,South Park View,2,0,2,0,0,0,2
Kentucky,Utica,487,70,204,19,0,0,293
Kentucky,Rineyville,2793,662,1092,243,71,94,2162
Kentucky,Poole,186,14,85,0,9,20,128
Kentucky,McKinney,135,0,103,17,0,0,120
Kentucky,McDowell,635,115,199,40,25,137,516
Kentucky,Ironville,918,243,351,49,32,64,739
Kentucky,Hickory,272,102,70,79,4,0,255
Kentucky,Sycamore,150,30,48,47,3,7,135
Kentucky,Coxton,154,28,87,0,21,9,145
Kentucky,Cunningham,292,37,122,7,0,72,238
Kentucky,Allensville,207,15,99,13,0,19,146
Kentucky,Elk Creek,1600,232,924,60,0,79,1295
Kentucky,Maytown,294,49,161,0,0,0,210
Kentucky,Ages,457,77,165,40,0,43,325
Kentucky,Anthoston,273,84,61,36,0,11,192
Kentucky,Dunmor,278,45,154,19,8,0,226
Kentucky,Belfry,313,41,146,15,10,55,267
Kentucky,Big Clifty,337,56,193,8,0,0,257
Kentucky,Cleaton,159,49,64,27,0,19,159
Kentucky,Combs,299,25,129,46,0,48,248
Kentucky,Arjay,502,152,132,65,12,27,388
Louisiana,Jordan Hill,87,0,50,0,0,0,50
Louisiana,Fifth Ward,738,129,287,78,0,67,561
Louisiana,Hester,361,23,179,22,10,12,246
Louisiana,Hayes,1106,343,327,44,40,70,824
Louisiana,Grand Point,2996,631,1385,167,24,105,2312
Louisiana,Gloster,161,0,110,0,0,0,110
Louisiana,Glencoe,230,144,20,45,0,21,230
Louisiana,Gillis,403,19,137,86,0,42,284
Louisiana,Frierson,225,23,57,0,15,13,108
Louisiana,Fort Jesup,278,34,163,0,0,43,240
Louisiana,Jeanerette,5410,1808,1575,240,234,370,4227
Louisiana,Dubach,1083,296,374,120,29,80,899
Louisiana,Varnado village,460,72,162,51,3,48,336
Louisiana,New Iberia,29992,8733,9199,3021,517,1768,23238
Louisiana,Arnaudville,1330,340,367,134,37,93,971
Louisiana,Port Sulphur,2175,792,554,84,67,92,1589
Louisiana,Belle Chasse,13490,2425,6192,996,223,355,10191
Louisiana,Heflin village,224,52,101,21,0,9,183
Louisiana,Chalmette,23602,7131,6185,2717,616,1121,17770
Louisiana,Eunice,10407,2830,2828,1116,430,605,7809
Louisiana,Morse village,938,223,353,86,14,27,703
Louisiana,Pioneer village,202,37,87,36,5,16,181
Louisiana,Joyce,148,37,81,25,0,5,148
Louisiana,Dulac,1504,332,653,101,82,131,1299
Louisiana,Kraemer,826,124,443,127,6,21,721
Louisiana,Carencro,8775,2928,2499,809,111,447,6794
Louisiana,Lafourche Crossing,2270,536,1042,104,62,82,1826
Louisiana,Cotton Valley,1039,335,290,37,30,36,728
Louisiana,Lillie village,218,41,73,30,0,48,192
Louisiana,Arabi,4501,1311,1481,499,78,213,3582
Louisiana,Leesville,6055,1753,1764,704,208,381,4810
Louisiana,Hornbeck,561,120,225,89,2,18,454
Louisiana,Fort Polk North,2425,186,1554,52,0,0,1792
Louisiana,Sibley,1333,206,580,161,12,95,1054
Louisiana,East Hodge village,266,100,36,32,6,39,213
Louisiana,Downsville village,92,17,46,9,4,8,84
Louisiana,Violet,5424,1665,1644,485,159,263,4216
Louisiana,Rosepine,1971,353,747,306,81,117,1604
Louisiana,Doyline village,777,181,251,100,11,64,607
Louisiana,Fort Polk South,9233,2350,3783,206,164,6,6509
Louisiana,Abbeville,12286,3416,3442,1411,306,991,9566
Louisiana,Farmerville,3815,1541,691,328,49,259,2868
Louisiana,Labadieville,2092,616,920,143,45,61,1785
Louisiana,Bossier City,67935,18508,24887,5928,1034,3335,53692
Louisiana,Haughton,3390,534,1378,389,50,120,2471
Louisiana,Palmetto village,133,39,17,13,4,19,92
Louisiana,Springhill,4980,1267,1691,531,104,444,4037
Louisiana,Quitman village,273,57,104,11,3,25,200
Louisiana,Reeves village,244,44,114,13,7,9,187
Louisiana,Simpson village,591,133,290,16,0,41,480
Louisiana,New Llano,2528,678,814,289,59,143,1983
Louisiana,Clayton,569,217,78,63,33,40,431
Louisiana,Norco,2917,615,1235,391,29,88,2358
Louisiana,Albany village,1194,231,482,173,6,41,933
Louisiana,Vinton,3343,862,916,497,220,186,2681
Louisiana,Sulphur,20241,4076,7877,2087,440,1120,15600
Louisiana,Hahnville,3430,1113,1302,290,72,135,2912
Louisiana,Tallulah,6929,2479,1567,553,245,501,5345
Louisiana,Richmond village,568,143,214,41,8,67,473
Louisiana,Dry Prong village,502,113,186,22,24,29,374
Louisiana,Port Vincent village,612,89,330,91,17,24,551
Louisiana,French Settlement village,1133,186,398,142,19,81,826
Louisiana,Delcambre,2267,567,699,228,50,157,1701
Louisiana,Oil City,1113,318,290,148,51,107,914
Louisiana,Lafayette,126515,44601,40237,11684,1978,5927,104427
Louisiana,Rodessa village,214,67,69,18,12,5,171
Louisiana,Welsh,3234,831,905,363,63,315,2477
Louisiana,Barataria,979,257,396,85,7,102,847
Louisiana,Wilson village,501,123,168,52,18,23,384
Louisiana,Estherwood village,895,220,289,57,19,39,624
Louisiana,Kinder,2909,596,922,238,96,134,1986
Louisiana,Oberlin,1660,484,372,234,32,102,1224
Louisiana,Converse village,389,69,189,19,3,31,311
Louisiana,Noble village,258,67,110,25,8,15,225
Louisiana,Zwolle,1960,584,463,131,72,205,1455
Louisiana,Hodge village,404,91,140,57,3,68,359
Louisiana,North Hodge village,467,77,149,42,12,27,307
Louisiana,New Orleans,389648,158888,94538,40375,9458,19792,323051
Louisiana,Marion,999,395,281,91,26,77,870
Louisiana,Estelle,17099,3922,7123,1508,208,822,13583
Louisiana,Bernice,1616,535,463,76,28,143,1245
Louisiana,Elton,1370,337,343,119,51,201,1051
Louisiana,Shongaloo village,142,2,85,10,0,2,99
Louisiana,Ruston,22055,12030,4656,969,311,813,18779
Louisiana,Houma,33520,9125,11434,3630,456,1756,26401
Louisiana,Cameron,209,27,82,24,5,41,179
Louisiana,Maringouin,932,395,307,78,12,62,854
Louisiana,Choudrant village,1252,114,604,81,10,58,867
Louisiana,Vienna,503,79,268,26,4,29,406
Louisiana,Melville,1172,466,209,127,47,69,918
Louisiana,Opelousas,16399,5802,3618,1556,416,1187,12579
Louisiana,Bayou Cane,20829,5247,7467,2033,464,1419,16630
Louisiana,Schriever,6407,2113,2255,540,182,202,5292
Louisiana,Eros,192,57,81,12,4,7,161
Louisiana,Jonesboro,4560,1813,707,513,191,321,3545
Louisiana,Poydras,2668,468,1076,251,62,183,2040
Louisiana,Dubberly village,239,55,128,20,2,20,225
Louisiana,Minden,12442,3842,3958,1153,131,954,10038
Louisiana,Bonita village,241,140,65,9,5,7,226
Louisiana,Lacassine,366,151,55,75,12,10,303
Louisiana,Dixie Inn village,257,80,77,45,3,12,217
Louisiana,Ringgold,1601,508,363,133,28,125,1157
Louisiana,Prospect,445,65,169,109,0,62,405
Louisiana,Reddell,1041,258,400,31,34,80,803
Louisiana,Roanoke,349,0,251,48,0,16,315
Louisiana,Rock Hill,135,21,100,0,0,0,121
Louisiana,Romeville,195,95,26,26,0,0,147
Louisiana,St. James,788,310,284,54,7,37,692
Louisiana,Presquille,1595,132,888,111,11,82,1224
Louisiana,St. Maurice,392,96,140,11,10,38,295
Louisiana,Belcher village,306,74,119,16,4,26,239
Louisiana,Duson,1780,383,584,200,19,100,1286
Louisiana,Bayou Corne,18,0,18,0,0,0,18
Louisiana,Welcome,932,385,176,48,38,35,682
Louisiana,Watson,1193,47,724,72,0,114,957
Louisiana,Wallace Ridge,867,121,496,53,0,30,700
Louisiana,Singer,363,55,167,14,21,0,257
Louisiana,Prairieville,31721,6344,14229,2315,428,1143,24459
Louisiana,Point Place,498,157,163,22,22,24,388
Louisiana,Pointe a la Hache,217,149,19,49,0,0,217
Louisiana,Lakeshore,1918,513,671,207,81,141,1613
Louisiana,Lakeview,1467,282,554,145,6,71,1058
Louisiana,Lawtell,1441,221,679,87,0,71,1058
Louisiana,Lemannville,1078,653,102,91,107,16,969
Louisiana,Lockport Heights,1683,316,724,122,10,42,1214
Louisiana,Longville,639,247,44,49,0,24,364
Louisiana,Milton,2330,570,1072,290,23,65,2020
Louisiana,Oretta,352,18,226,25,41,24,334
Louisiana,Minorca,1703,558,730,169,11,75,1543
Louisiana,Monterey,462,60,237,74,0,19,390
Louisiana,Moonshine,224,74,56,7,0,41,178
Louisiana,Ossun,1870,461,699,172,0,56,1388
Louisiana,Paulina,1085,182,495,69,8,66,820
Louisiana,Pitkin,803,175,304,97,9,50,635
Louisiana,Pleasure Bend,234,21,107,13,30,9,180
Louisiana,Vienna Bend,1228,378,394,41,28,30,871
Louisiana,Ventress,784,191,335,114,0,110,750
Louisiana,Union,611,193,206,57,0,60,516
Louisiana,Triumph,493,61,141,90,0,0,292
Louisiana,Jena,3390,819,1342,218,90,361,2830
Louisiana,Roseland,1072,329,190,172,31,111,833
Louisiana,Elizabeth,489,113,172,65,3,26,379
Louisiana,Many,2757,1028,675,252,29,235,2219
Louisiana,Fisher village,292,57,135,30,0,6,228
Louisiana,Rayne,8075,2264,2773,749,141,429,6356
Louisiana,Moss Bluff,12034,2516,5463,1130,185,479,9773
Louisiana,Haynesville,2599,991,701,139,84,205,2120
Louisiana,Ferriday,3326,1300,881,225,100,112,2618
Louisiana,Westlake,4661,1117,1806,521,112,128,3684
Louisiana,Norwood village,276,48,117,37,4,24,230
Louisiana,Jackson,4952,2538,1084,660,42,184,4508
Louisiana,Marksville,5476,1674,1748,484,47,428,4381
Louisiana,Chataignier village,247,89,55,24,12,17,197
Louisiana,Saline village,620,136,242,44,4,17,443
Louisiana,Thibodaux,14515,5311,4298,1245,242,983,12079
Louisiana,Gonzales,10677,2729,3772,1437,149,578,8665
Louisiana,Montz,2219,544,876,167,18,46,1651
Louisiana,Atlanta village,139,36,49,19,7,7,118
Louisiana,Sicily Island village,452,150,104,39,32,36,361
Louisiana,Venice,245,75,96,22,0,0,193
Louisiana,Jonesville,1889,630,445,156,57,171,1459
Louisiana,Siracusaville,597,118,117,89,10,39,373
Louisiana,Sorrel,559,87,359,30,8,34,518
Louisiana,Spokane,266,38,168,26,0,27,259
Louisiana,Starks,364,71,79,90,44,28,312
Louisiana,Start,1035,181,433,51,23,60,748
Louisiana,Sugartown,69,0,27,0,0,0,27
Louisiana,Luling,13614,3035,5804,913,110,521,10383
Louisiana,Basile,1713,490,365,210,82,107,1254
Louisiana,Church Point,4511,1103,1246,715,181,400,3645
Louisiana,Pleasant Hill village,562,192,144,81,16,28,461
Louisiana,Bogalusa,11793,3083,2699,1481,469,953,8685
Louisiana,Grayson village,531,120,155,79,16,26,396
Louisiana,Tangipahoa village,651,314,85,62,29,19,509
Louisiana,Boutte,2952,975,793,388,66,0,2222
Louisiana,Franklinton,3774,1164,1194,412,136,527,3433
Louisiana,Denham Springs,9991,2759,2976,1445,171,704,8055
Louisiana,Cut Off,5897,1194,2778,345,151,339,4807
Louisiana,Grand Cane village,286,89,141,21,6,19,276
Louisiana,Westminster,2819,595,1401,206,35,157,2394
Louisiana,Lydia,544,117,168,194,0,0,479
Louisiana,Montegut,2084,491,746,134,0,124,1495
Louisiana,Leonville,990,245,382,74,19,61,781
Louisiana,Raceland,10686,2770,3990,919,275,696,8650
Louisiana,Grand Coteau,808,296,194,53,4,83,630
Louisiana,Port Barre,1774,335,533,86,64,138,1156
Louisiana,Baskin village,252,61,84,22,17,17,201
Louisiana,Red Chute,6468,1480,2884,648,121,191,5324
Louisiana,Plain Dealing,926,214,364,117,19,121,835
Louisiana,Livingston,2095,471,874,193,2,116,1656
Louisiana,Hosston village,269,38,131,18,0,20,207
Louisiana,Grosse Tete village,818,114,362,58,13,35,582
Louisiana,Waterproof,701,293,101,78,55,57,584
Louisiana,Paradis,1759,421,712,147,0,127,1407
Louisiana,St. Rose,7665,2197,2332,864,315,275,5983
Louisiana,Jefferson,10341,3309,2856,1682,272,893,9012
Louisiana,Jean Lafitte,1971,408,825,183,54,83,1553
Louisiana,Bridge City,6894,2304,1884,695,151,270,5304
Louisiana,Avondale,4989,1317,1632,406,116,335,3806
Louisiana,Mooringsport,569,106,233,68,19,39,465
Louisiana,Newellton,1386,571,235,46,18,93,963
Louisiana,Scott,8761,1950,3422,1060,202,394,7028
Louisiana,Golden Meadow,2023,498,783,239,20,102,1642
Louisiana,Chackbay,5573,1065,2414,487,52,169,4187
Louisiana,Mansfield,4820,2013,926,527,75,241,3782
Louisiana,Midway,1245,342,410,129,29,12,922
Louisiana,Lisbon village,132,30,60,12,3,11,116
Louisiana,Dodson village,398,110,110,37,12,17,286
Louisiana,Keachi,275,46,152,17,7,9,231
Louisiana,Ponchatoula,7131,1955,2205,724,120,303,5307
Louisiana,Bastrop,10521,4315,1871,766,269,650,7871
Louisiana,Shreveport,193785,64712,53817,19059,4894,11596,154078
Louisiana,Vivian,3599,1363,795,326,85,250,2819
Louisiana,Jennings,10047,2725,2685,1289,248,864,7811
Louisiana,Mound village,3,0,2,1,0,0,3
Louisiana,Bienville village,206,29,97,14,12,20,172
Louisiana,Ville Platte,7196,2255,1589,706,573,538,5661
Louisiana,Gibsland,626,178,269,58,0,48,553
Louisiana,Mount Lebanon,27,3,13,10,0,1,27
Louisiana,Turkey Creek village,461,122,172,57,3,31,385
Louisiana,Cottonport,1704,526,531,105,5,83,1250
Louisiana,Morganza village,826,250,303,63,13,55,684
Louisiana,Arcadia,2804,1202,544,358,73,165,2342
Louisiana,Castor village,332,16,125,35,10,21,207
Louisiana,Richwood,5013,3306,568,525,96,143,4638
Louisiana,Parks village,799,193,334,48,8,26,609
Louisiana,South Vacherie,3565,902,1419,360,46,189,2916
Louisiana,Sorrento,1809,490,716,182,17,68,1473
Louisiana,Merryville,1342,398,382,152,31,124,1087
Louisiana,Gilbert village,428,110,169,67,17,30,393
Louisiana,Lafitte,990,221,414,117,6,73,831
Louisiana,Benton,2402,738,602,252,68,124,1784
Louisiana,Tullos,437,81,162,40,4,19,306
Louisiana,Grand Isle,757,114,323,116,23,52,628
Louisiana,Gretna,17797,5714,5670,2107,476,1087,15054
Louisiana,Harahan,9309,2409,3724,846,75,794,7848
Louisiana,Harvey,20712,6163,7107,2137,465,901,16773
Louisiana,Lecompte,926,260,356,111,24,45,796
Louisiana,Pineville,14313,4508,4044,1502,273,925,11252
Louisiana,Charenton,1688,532,645,181,8,91,1457
Louisiana,Covington,10133,3013,3388,1347,255,429,8432
Louisiana,Lake Charles,76267,23678,21704,8185,2346,5250,61163
Louisiana,Laplace,29147,7625,11406,2310,580,1342,23263
Louisiana,Carlyss,4953,871,1881,511,119,242,3624
Louisiana,Walker,6250,1203,2346,658,190,389,4786
Louisiana,Ama,1366,409,407,147,70,85,1118
Louisiana,Taft,63,0,63,0,0,0,63
Louisiana,Kentwood,2288,621,399,268,125,237,1650
Louisiana,Napoleonville village,662,231,137,62,28,37,495
Louisiana,Plaquemine,6726,1658,1781,733,143,541,4856
Louisiana,Ashland village,237,48,124,6,2,12,192
Louisiana,Claiborne,11435,2455,4502,1139,137,861,9094
Louisiana,Washington,904,335,189,87,38,85,734
Louisiana,Empire,1060,258,397,87,41,59,842
Louisiana,Ridgecrest,929,178,328,65,26,46,643
Louisiana,Shenandoah,20192,4528,9231,1676,249,817,16501
Louisiana,Inniswold,6777,1572,2877,501,55,178,5183
Louisiana,Baker,13557,4483,3480,1689,391,729,10772
Louisiana,Angie village,300,58,129,21,15,19,242
Louisiana,Woodworth,1281,172,646,150,0,47,1015
Louisiana,Provencal village,544,217,178,27,5,28,455
Louisiana,Goldonna village,368,94,129,38,8,34,303
Louisiana,River Ridge,13241,3043,5919,1259,109,797,11127
Louisiana,Stanley village,154,52,31,31,0,16,130
Louisiana,Monticello,4479,1561,1447,478,35,189,3710
Louisiana,Baton Rouge,225362,89648,56711,20927,4361,11931,183578
Louisiana,Forest Hill village,685,146,290,40,0,26,502
Louisiana,Gardere,10841,4285,2502,1319,154,163,8423
Louisiana,Oak Hills Place,9015,2119,4438,551,101,456,7665
Louisiana,Old Jefferson,8065,1989,3304,799,10,187,6289
Louisiana,Collinston village,293,133,71,11,7,21,243
Louisiana,Springfield,479,160,150,58,0,39,407
Louisiana,Destrehan,10933,2231,5757,634,126,384,9132
Louisiana,Timberlane,10192,2143,3783,1032,98,573,7629
Louisiana,Westwego,8499,2690,2226,1149,162,586,6813
Louisiana,Abita Springs,2511,514,992,352,25,127,2010
Louisiana,Slidell,27769,6739,9358,3566,264,1702,21629
Louisiana,Hall Summit village,342,76,172,46,10,13,317
Louisiana,Rayville,3612,1431,514,297,178,364,2784
Louisiana,Montpelier village,343,79,112,44,9,26,270
Louisiana,Greenwood,3199,872,1616,283,58,87,2916
Louisiana,Oak Ridge village,94,13,46,6,0,13,78
Louisiana,Stonewall,2544,428,1212,185,53,144,2022
Louisiana,South Mansfield village,351,165,84,20,8,30,307
Louisiana,Zachary,17056,4216,6576,1069,182,727,12770
Louisiana,Loreauville village,856,304,217,56,40,55,672
Louisiana,Donaldsonville,8090,3078,2120,520,119,651,6488
Louisiana,Calvin village,215,38,72,20,10,9,149
Louisiana,Gray,5893,1586,1704,649,60,254,4253
Louisiana,Pearl River,2556,568,880,388,16,119,1971
Louisiana,Franklin,7097,2450,1733,614,236,461,5494
Louisiana,Berwick,4660,1535,1404,411,118,211,3679
Louisiana,Ball,3994,1107,1346,464,136,195,3248
Louisiana,Robeline village,106,43,33,6,3,8,93
Louisiana,Clarence village,269,112,46,16,17,27,218
Louisiana,Woodmere,10458,3412,3195,974,248,415,8244
Louisiana,Terrytown,24244,6783,7982,2030,633,866,18294
Louisiana,Metairie,143481,39705,55533,14359,1949,8273,119819
Louisiana,Longstreet village,109,22,56,4,4,18,104
Louisiana,Gueydan,1266,279,444,157,29,152,1061
Louisiana,St. Martinville,6014,2294,1453,644,162,355,4908
Louisiana,Kaplan,4549,956,1645,675,55,309,3640
Louisiana,North Vacherie,2071,642,553,285,50,158,1688
Louisiana,West Monroe,12756,3792,3972,1432,133,1065,10394
Louisiana,New Roads,4616,1466,1216,461,168,417,3728
Louisiana,Boyce,1319,497,304,97,49,70,1017
Louisiana,Mansura,1759,545,372,156,66,258,1397
Louisiana,Clinton,1815,542,519,220,11,100,1392
Louisiana,Natalbany,2388,1037,541,161,103,152,1994
Louisiana,Hammond,20444,8956,5064,1398,529,1083,17030
Louisiana,Bayou Gauche,2031,385,1098,49,38,30,1600
Louisiana,DeQuincy,3125,633,1193,359,183,193,2561
Louisiana,Homer,2942,965,907,247,42,135,2296
Louisiana,Wallace,707,227,230,29,0,19,505
Louisiana,Reserve,9280,3185,2716,815,129,514,7359
Louisiana,Garyville,1997,479,665,114,32,149,1439
Louisiana,Natchitoches,18080,9166,3320,884,314,938,14622
Louisiana,Waggaman,9866,3330,3329,993,122,428,8202
Louisiana,Gilliam village,115,29,58,4,3,12,106
Louisiana,Blanchard,3042,457,1580,220,77,91,2425
Louisiana,Lockport,2489,598,833,343,55,207,2036
Louisiana,Olla,1701,292,670,125,72,94,1253
Louisiana,Gramercy,3396,813,1495,240,46,110,2704
Louisiana,Plaucheville village,244,53,103,25,2,9,192
Louisiana,White Castle,1970,703,340,311,30,183,1567
Louisiana,Iowa,3229,716,1002,301,78,246,2343
Louisiana,Cankton village,741,143,239,90,2,15,489
Louisiana,Patterson,6012,2062,1918,479,125,278,4862
Louisiana,Glenmora,1300,464,371,59,39,52,985
Louisiana,Winnsboro,4690,1268,999,484,114,297,3162
Louisiana,Eastwood,4910,901,2042,292,64,300,3599
Louisiana,Supreme,984,350,154,113,8,19,644
Louisiana,Columbia,406,130,164,34,0,44,372
Louisiana,Lacombe,8503,2279,3525,635,108,681,7228
Louisiana,Maurice village,1424,198,552,235,17,122,1124
Louisiana,Swartz,4661,1073,1858,453,96,243,3723
Louisiana,Clarks village,912,379,249,150,24,53,855
Louisiana,Moreauville village,981,291,307,131,15,105,849
Louisiana,Bunkie,4001,1353,1137,222,69,366,3147
Louisiana,Lucky village,238,116,47,13,8,19,203
Louisiana,Mandeville,12252,2750,5137,1301,177,664,10029
Louisiana,Cecilia,1987,457,717,194,0,106,1474
Louisiana,Port Allen,5051,1642,1591,621,50,303,4207
Louisiana,Edgefield village,300,95,88,34,3,10,230
Louisiana,Folsom village,847,227,241,99,11,46,624
Louisiana,Logansport,1878,544,471,212,111,88,1426
Louisiana,St. Francisville,1829,404,608,271,58,81,1422
Louisiana,Martin village,560,109,269,36,5,53,472
Louisiana,Colfax,2456,836,447,224,66,150,1723
Louisiana,Wisner,722,189,175,57,17,174,612
Louisiana,Village St. George,6900,1839,2855,617,57,397,5765
Louisiana,Pollock,469,119,111,46,14,28,318
Louisiana,Merrydale,8808,2900,2428,1071,191,391,6981
Louisiana,Lutcher,3302,948,1222,364,31,301,2866
Louisiana,Bryceland village,65,11,34,8,0,6,59
Louisiana,Oak Grove,1740,497,604,156,21,193,1471
Louisiana,Sarepta,825,160,403,70,18,30,681
Louisiana,Cullen,1049,377,324,26,11,108,846
Louisiana,Meraux,7296,1904,2894,645,64,222,5729
Louisiana,Sun village,335,66,149,26,16,19,276
Louisiana,Baldwin,2522,1104,519,167,135,219,2144
Louisiana,Amelia,1647,433,684,117,12,18,1264
Louisiana,McNary village,178,53,76,23,5,7,164
Louisiana,Cheneyville,623,201,144,90,0,70,505
Louisiana,Bordelonville,640,67,199,38,77,45,426
Louisiana,Boothville,626,116,305,19,5,96,541
Louisiana,Belmont,325,15,95,68,9,43,230
Louisiana,Bayou L'Ourse,1564,275,648,107,0,95,1125
Louisiana,Bayou Goula,442,245,70,86,0,22,423
Louisiana,Bayou Country Club,1298,247,723,111,0,112,1193
Louisiana,Bayou Blue,11682,2421,5070,1117,137,344,9089
Louisiana,Bawcomville,2592,607,733,429,73,314,2156
Louisiana,Banks Springs,1378,388,208,134,57,112,899
Louisiana,Youngsville,12753,2246,6097,738,45,294,9420
Louisiana,Central,28577,5324,13271,2536,329,1403,22863
Louisiana,Broussard,11412,2660,4662,1087,154,382,8945
Louisiana,DeRidder,11050,3187,3516,1166,425,652,8946
Louisiana,Killian,1375,162,754,116,29,64,1125
Louisiana,Simsboro village,959,285,336,98,3,69,791
Louisiana,Bourg,2591,428,1198,117,13,102,1858
Louisiana,Mermentau village,740,180,245,59,29,57,570
Louisiana,Branch,207,54,61,33,0,9,157
Louisiana,Buras,907,203,291,114,25,83,716
Louisiana,Henderson,2280,522,880,187,19,104,1712
Louisiana,Simmesport,1727,520,327,165,15,191,1218
Louisiana,Evergreen,302,75,121,48,4,29,277
Louisiana,Winnfield,4502,1035,1422,557,151,426,3591
Louisiana,Sikes village,209,22,92,16,0,10,140
Louisiana,Amite City,4393,1353,1268,536,242,333,3732
Louisiana,Erwinville,2168,668,949,113,56,104,1890
Louisiana,Egan,573,168,231,46,0,92,537
Louisiana,Crescent,460,200,185,38,0,37,460
Louisiana,Convent,455,91,162,34,47,10,344
Louisiana,Choctaw,731,196,332,30,7,58,623
Louisiana,Center Point,458,91,70,89,16,68,334
Louisiana,Catahoula,1193,169,570,53,0,70,862
Louisiana,Calhoun,520,98,351,0,0,0,449
Louisiana,Cade,1967,346,655,152,127,124,1404
Louisiana,Brownsville,3857,1341,988,473,141,142,3085
Louisiana,Georgetown village,497,108,165,13,15,9,310
Louisiana,Creola village,225,62,41,4,16,0,123
Louisiana,Hackberry,1421,196,622,185,28,44,1075
Louisiana,Breaux Bridge,8299,2206,2815,724,55,667,6467
Louisiana,Paincourtville,909,160,373,57,13,71,674
Louisiana,Madisonville,792,182,327,101,9,10,629
Louisiana,Forest village,286,40,146,33,2,13,234
Louisiana,Edgard,2053,845,447,366,51,70,1779
Louisiana,Chatham,680,185,229,17,6,61,498
Louisiana,Brusly,2739,599,1105,202,0,169,2075
Louisiana,Crowley,12960,3966,3422,1618,211,963,10180
Louisiana,Anacoco village,1161,272,525,73,14,44,928
Louisiana,Mamou,3197,1020,573,369,76,343,2381
Louisiana,Florien village,619,143,219,42,16,54,474
Louisiana,Elmwood,5525,2084,1480,718,132,203,4617
Louisiana,Sunset,2926,852,1052,206,39,124,2273
Louisiana,Brownfields,5092,1290,1716,673,184,360,4223
Louisiana,Rosedale village,869,251,261,80,32,43,667
Louisiana,Deville,1159,116,610,69,12,147,954
Louisiana,Powhatan village,273,106,22,0,8,29,165
Louisiana,Mathews,2649,640,961,343,30,118,2092
Louisiana,Delta village,260,41,109,12,0,8,170
Louisiana,Lake Providence,2930,880,647,210,22,277,2036
Louisiana,Chauvin,2579,501,1121,287,70,155,2134
Louisiana,Krotz Springs,934,284,288,101,30,63,766
Louisiana,St. Joseph,854,328,172,64,46,73,683
Louisiana,Fenton village,310,55,108,46,7,43,259
Louisiana,Hessmer village,880,228,381,72,21,38,740
Louisiana,Iota,1798,383,675,138,56,92,1344
Louisiana,Prien,7976,1277,3958,558,43,356,6192
Louisiana,Killona,714,279,113,93,20,33,538
Louisiana,Junction City village,560,137,146,17,0,27,327
Louisiana,Erath,2047,578,722,220,46,126,1692
Louisiana,Kenner,66910,19319,23819,5884,1113,3774,53909
Louisiana,Natchez village,597,313,109,29,4,8,463
Louisiana,Addis,4952,1260,1970,339,8,112,3689
Louisiana,Grambling,5187,2928,815,337,86,210,4376
Louisiana,St. Gabriel,7200,3687,1625,835,99,310,6556
Louisiana,Bayou Vista,4567,1449,1580,355,14,225,3623
Louisiana,Mer Rouge village,504,217,119,36,15,45,432
Louisiana,Sterlington,2495,629,1069,86,14,66,1864
Louisiana,Monroe,48663,18400,11368,4344,1362,2689,38163
Louisiana,Pine Prairie village,1182,429,346,159,14,98,1046
Louisiana,Jamestown village,144,3,101,14,2,7,127
Louisiana,Livonia,1393,274,550,192,11,112,1139
Louisiana,Fordoche,1046,255,374,84,18,111,842
Louisiana,Eden Isle,7554,1397,3742,764,307,348,6558
Louisiana,Morgan City,11452,3871,3361,1144,229,708,9313
Louisiana,Alexandria,47539,14387,13724,5584,1523,3069,38287
Louisiana,Campti,1072,556,152,71,28,44,851
Louisiana,Slaughter,1030,138,541,110,3,44,836
Louisiana,Marrero,32088,9281,9656,4018,796,1987,25738
Louisiana,Lake Arthur,2751,779,888,322,62,128,2179
Louisiana,Ida village,202,36,98,32,0,23,189
Louisiana,Galliano,7131,1234,3259,692,89,516,5790
Louisiana,Des Allemands,1597,376,853,94,22,120,1465
Louisiana,New Sarpy,1393,573,235,116,50,107,1081
Louisiana,Oakdale,7640,2188,2286,923,469,621,6487
Louisiana,Tickfaw village,687,152,254,66,4,41,517
Louisiana,Epps village,976,483,256,78,30,55,902
Louisiana,Larose,7529,1610,2962,656,132,422,5782
Louisiana,Independence,1850,465,511,219,37,109,1341
Louisiana,Greensburg,788,342,171,89,16,70,688
Louisiana,Mangham,548,151,165,56,7,58,437
Louisiana,Kilbourne village,337,75,138,28,1,54,296
Louisiana,Delhi,2872,806,911,258,129,218,2322
Louisiana,Coushatta,2672,899,623,210,46,117,1895
Louisiana,Spearsville village,140,21,45,11,10,12,99
Louisiana,Pierre Part,2319,524,1127,173,0,219,2043
Louisiana,Belle Rose,1846,547,760,124,21,148,1600
Louisiana,Urania,1413,661,362,192,31,25,1271
Louisiana,Vidalia,4041,843,1370,369,122,373,3077
Louisiana,Athens village,361,52,157,19,1,45,274
Louisiana,Harrisonburg village,336,84,120,21,6,32,263
Louisiana,Montgomery,643,155,195,112,24,18,504
Maine,Orono,9474,6439,1587,610,28,305,8969
Maine,Randolph,1996,501,676,314,57,133,1681
Maine,Houlton,4693,1149,1936,461,14,532,4092
Maine,Bucksport,2654,445,1231,368,0,166,2210
Maine,Oxford,1239,143,426,260,0,72,901
Maine,South Paris,2158,392,840,412,74,105,1823
Maine,Bridgton,2198,613,899,316,33,96,1957
Maine,Westbrook,18417,5603,7073,2211,138,783,15808
Maine,Limestone,1426,492,524,72,6,75,1169
Maine,Searsport,1030,302,292,172,0,203,969
Maine,Van Buren,1687,511,625,175,30,175,1516
Maine,Hartland,803,221,216,110,18,112,677
Maine,Pittsfield,2873,796,1014,339,9,165,2323
Maine,Wiscasset,1042,314,373,178,42,70,977
Maine,Farmington,3878,1957,888,448,26,178,3497
Maine,Farmingdale,2068,395,791,511,4,51,1752
Maine,Clinton,992,186,529,141,0,61,917
Maine,Madison,2502,601,899,439,38,283,2260
Maine,Yarmouth,5608,1184,2321,761,69,420,4755
Maine,Norway,2703,517,913,274,0,297,2001
Maine,Topsham,6103,1247,2989,622,0,405,5263
Maine,Livermore Falls,1589,334,507,308,18,93,1260
Maine,York Harbor,2542,439,1321,237,14,257,2268
Maine,Saco,19342,5053,8038,2006,111,920,16128
Maine,Kennebunkport,1121,158,616,72,5,94,945
Maine,Milford,2191,633,874,156,33,90,1786
Maine,Gardiner,5667,1644,2146,604,42,262,4698
Maine,Bangor,32098,11151,10172,4085,388,1910,27706
Maine,Cape Neddick,2316,552,1228,163,0,283,2226
Maine,Bowdoinham,632,52,463,64,0,0,579
Maine,Fort Kent,2291,707,932,225,0,198,2062
Maine,Winterport,1195,176,707,125,2,63,1073
Maine,Blue Hill,1011,184,448,73,10,118,833
Maine,Blaine,261,47,154,24,0,18,243
Maine,Ashland,528,112,273,59,4,22,470
Maine,East Millinocket,1673,310,685,253,13,151,1412
Maine,Fairfield,3152,741,1092,534,33,146,2546
Maine,South Portland,25515,8151,9280,3204,192,1246,22073
Maine,Freeport,1412,219,695,141,3,88,1146
Maine,Fryeburg,1548,368,620,269,12,71,1340
Maine,Bar Harbor,2172,896,551,337,65,42,1891
Maine,Greenville,1075,252,491,97,8,135,983
Maine,Caribou,7749,1493,3605,774,122,460,6454
Maine,South Eliot,3325,593,1606,399,25,134,2757
Maine,Waterville,16515,5473,5238,2086,240,1009,14046
Maine,Wilton,1982,276,733,440,0,108,1557
Maine,Woodland,948,178,392,147,13,44,774
Maine,Lincoln,2703,432,966,546,48,422,2414
Maine,Chisholm,1411,311,658,139,21,45,1174
Maine,Anson,1057,310,328,151,0,51,840
Maine,Mechanic Falls,1894,347,767,258,0,171,1543
Maine,Hallowell,2506,687,1010,238,6,150,2091
Maine,North Berwick,1389,411,478,209,18,65,1181
Maine,Brunswick,15244,4595,5688,2140,36,910,13369
Maine,Kittery Point,1086,232,484,220,0,105,1041
Maine,Hampden,3889,1058,1904,353,0,131,3446
Maine,Unity,321,102,49,81,0,40,272
Maine,Scarborough,4796,769,2110,541,95,384,3899
Maine,Rumford,3771,1187,1297,656,112,289,3541
Maine,Lake Arrowhead,2358,590,1286,130,37,40,2083
Maine,Madawaska,2633,490,1374,269,34,236,2403
Maine,Calais,2998,629,1148,484,52,295,2608
Maine,Skowhegan,6434,1484,2180,837,39,631,5171
Maine,Machias,1060,275,274,196,6,162,913
Maine,Portland,66735,26045,21360,7027,436,2544,57412
Maine,Falmouth Foreside,1544,270,755,155,9,107,1296
Maine,Bingham,763,115,300,101,12,89,617
Maine,Mexico,1626,410,792,170,11,88,1471
Maine,Millinocket,4314,756,1957,678,42,377,3810
Maine,Berwick,2415,445,1021,366,45,72,1949
Maine,Old Orchard Beach,8809,2335,3681,1521,77,563,8177
Maine,Biddeford,21452,7324,7260,2612,355,1109,18660
Maine,Old Town,7549,2522,2512,979,60,317,6390
Maine,Sanford,21015,4759,8108,2613,316,1291,17087
Maine,Alfred,1034,152,386,223,0,65,826
Maine,Winter Harbor,284,31,129,47,6,21,234
Maine,Washburn,1065,135,575,144,7,48,909
Maine,Steep Falls,1720,605,668,105,0,0,1378
Maine,Standish,255,14,64,126,0,51,255
Maine,Howland,1106,279,419,115,6,71,890
Maine,South Windham,1113,615,247,134,12,58,1066
Maine,Newcastle,613,144,235,89,0,75,543
Maine,Naples,515,94,304,32,0,1,431
Maine,Mars Hill,881,211,367,88,19,60,745
Maine,Mapleton,807,211,350,61,6,46,674
Maine,Lubec,321,57,150,90,0,18,315
Maine,Littlejohn Island,30,0,30,0,0,0,30
Maine,Little Falls,982,264,376,51,21,27,739
Maine,Gray,898,187,369,184,29,24,793
Maine,Falmouth,2049,348,984,222,88,136,1778
Maine,Eagle Lake,527,129,240,49,7,47,472
Maine,Damariscotta,1286,325,508,177,5,119,1134
Maine,Cousins Island,587,100,354,30,0,35,519
Maine,Castine,828,647,120,1,3,35,806
Maine,Casco,765,239,331,32,15,77,694
Maine,Southwest Harbor,757,181,326,56,6,85,654
Maine,Norridgewock,1283,314,413,298,0,99,1124
Maine,Dexter,2287,649,710,447,31,145,1982
Maine,Oakland,2292,516,937,367,13,226,2059
Maine,Cumberland Center,2644,362,1229,309,0,40,1940
Maine,Brunswick Station,637,160,260,64,0,26,510
Maine,Rockland,7190,1896,2401,1229,62,404,5992
Maine,Camden,3442,771,1484,447,54,424,3180
Maine,Guilford,743,159,263,152,0,44,618
Maine,Lisbon Falls,4189,966,1725,526,46,102,3365
Maine,Lewiston,36097,10410,12478,4505,484,2330,30207
Maine,Presque Isle,9162,2570,3351,999,69,747,7736
Maine,Fort Fairfield,1610,372,654,273,16,195,1510
Maine,Kittery,4376,789,1946,599,17,273,3624
Maine,Kennebunk,5809,1046,2648,737,13,598,5042
Maine,Boothbay Harbor,1131,296,419,171,0,162,1048
Maine,Newport,1760,184,805,266,37,138,1430
Maine,Winthrop,2594,581,1139,422,0,98,2240
Maine,Winslow,5004,1122,1880,786,1,349,4138
Maine,Eastport,1351,296,539,206,6,133,1180
Maine,Waldoboro,1260,238,436,212,15,230,1131
Maine,Bath,8320,2002,3093,1251,79,361,6786
Maine,North Windham,5820,1234,2521,635,25,213,4628
Maine,Augusta,18635,5129,5796,3751,162,1158,15996
Maine,Brewer,9123,2163,3470,1222,103,620,7578
Maine,West Kennebunk,1023,193,422,187,1,69,872
Maine,Auburn,23064,5891,8835,2780,158,1129,18793
Maine,Richmond,1602,314,660,219,31,111,1335
Maine,Milo,2233,541,699,434,45,120,1839
Maine,Thomaston,2018,519,696,185,116,115,1631
Maine,Ellsworth,7960,1843,3341,937,34,549,6704
Maine,Dixfield,1292,329,452,213,0,47,1041
Maine,Gorham,6711,2278,2341,805,17,341,5782
Maine,Belfast,6696,1413,3102,679,79,313,5586
Maine,Dover-Foxcroft,2496,574,946,451,9,198,2178
Maryland,Rosaryville,10705,3038,4864,817,186,312,9217
Maryland,Seat Pleasant,4759,1689,1067,504,212,278,3750
Maryland,Walker Mill,11780,4704,2620,1277,299,886,9786
Maryland,Sudlersville,415,75,110,67,16,60,328
Maryland,Princess Anne,3444,1313,847,224,67,99,2550
Maryland,Lake Arbor,10456,4046,3109,1057,211,426,8849
Maryland,Morningside,1238,461,278,148,15,116,1018
Maryland,Springdale,2947,989,1131,171,77,48,2416
Maryland,Union Bridge,828,236,300,106,3,75,720
Maryland,Prince Frederick,3189,861,915,391,79,415,2661
Maryland,Frenchtown-Rumbly,121,36,67,0,0,0,103
Maryland,Smith Island,193,9,117,10,0,6,142
Maryland,Oakland,1823,522,619,241,19,224,1625
Maryland,Elkridge,20519,4480,8657,1517,426,507,15587
Maryland,Ellicott City,72247,13527,36554,4072,892,2522,57567
Maryland,Bel Air South,48269,10219,22052,3786,523,2114,38694
Maryland,Fallston,8836,1486,4937,325,178,347,7273
Maryland,Havre de Grace,13555,2965,6026,1381,220,767,11359
Maryland,Carney,29743,7351,11677,2436,411,2615,24490
Maryland,Garrison,8388,2657,2857,775,219,378,6886
Maryland,Hampstead,6340,1432,2573,778,68,368,5219
Maryland,Milford Mill,29974,10395,8201,3373,812,1410,24191
Maryland,Chance,482,82,209,42,0,51,384
Maryland,White Marsh,9455,2501,3880,879,187,392,7839
Maryland,Church Creek,105,17,53,10,0,10,90
Maryland,Middletown,4553,933,2199,219,46,130,3527
Maryland,Mountain Lake Park,2148,514,842,275,68,159,1858
Maryland,Galena,708,149,305,71,10,56,591
Maryland,California,14298,3230,5841,1149,206,530,10956
Maryland,Golden Beach,2875,471,1298,312,112,224,2417
Maryland,Lexington Park,11848,3988,3670,1280,341,166,9445
Maryland,Catonsville,41515,12249,16044,3093,613,2728,34727
Maryland,Chevy Chase View,997,223,513,36,3,21,796
Maryland,Forest Glen,6589,1493,2704,709,92,259,5257
Maryland,Delmar,3172,774,1013,359,113,157,2416
Maryland,Kemp Mill,13838,2871,6144,1146,141,406,10708
Maryland,Myersville,1838,342,951,75,9,35,1412
Maryland,Stevensville,6973,1546,2974,618,88,216,5442
Maryland,Barclay,230,118,72,1,0,4,195
Maryland,South Laurel,28048,7978,9984,2124,738,936,21760
Maryland,Takoma Park,17622,5165,6687,1219,318,576,13965
Maryland,St. Leonard,460,103,242,17,9,28,399
Maryland,Solomons,2113,266,1098,121,50,356,1891
Maryland,Adelphi,15751,5684,5349,941,267,540,12781
Maryland,Brentwood,3468,1170,977,286,112,109,2654
Maryland,Cheverly,6452,1720,2393,462,368,230,5173
Maryland,Clinton,40027,12024,15117,3331,641,1827,32940
Maryland,Glenn Dale,14191,3933,5931,1139,126,548,11677
Maryland,New Carrollton,12932,4319,4079,1001,222,491,10112
Maryland,Woodmore,4541,1226,2016,307,153,131,3833
Maryland,Centreville,4678,976,2235,389,15,306,3921
Maryland,Colmar Manor,1398,477,409,102,44,52,1084
Maryland,Kent Narrows,475,51,258,99,0,67,475
Maryland,Dames Quarter,71,4,34,5,0,21,64
Maryland,Camp Springs,21602,6807,6933,2374,479,1122,17715
Maryland,Port Deposit,618,153,196,106,27,30,512
Maryland,Potomac Heights,1190,258,360,165,117,102,1002
Maryland,Frederick,70166,19360,26402,6474,1146,3237,56619
Maryland,Friendsville,573,141,227,41,21,30,460
Maryland,Hyattsville,18209,6167,5894,1401,491,520,14473
Maryland,Preston,847,152,334,58,21,68,633
Maryland,Fairmount Heights,1789,803,458,102,25,144,1532
Maryland,Forestville,11719,4018,3328,1219,426,619,9610
Maryland,Fort Washington,24183,6364,10336,2105,619,1321,20745
Maryland,Friendly,9793,2883,3826,870,266,455,8300
Maryland,Mount Rainier,8110,3209,2324,692,235,231,6691
Maryland,North Brentwood,755,263,252,55,19,33,622
Maryland,Kensington,2269,425,984,241,37,72,1759
Maryland,Martin's Additions village,983,182,522,35,3,30,772
Maryland,Montgomery Village,33798,9536,12609,2798,537,1049,26529
Maryland,Denton,4406,1340,1486,290,53,263,3432
Maryland,Mardela Springs,461,79,151,78,9,25,342
Maryland,Salisbury,32536,13029,7282,3123,766,1574,25774
Maryland,Brookview,45,9,20,4,1,4,38
Maryland,Hurlock,2327,563,706,366,26,151,1812
Maryland,Mount Airy,9395,2071,4122,706,80,418,7397
Maryland,Thurmont,6563,1126,2914,625,168,240,5073
Maryland,Grantsville,664,128,248,103,11,111,601
Maryland,Woodlawn CDP (Baltimore County),38951,12602,13369,3714,737,1887,32309
Maryland,Brookeville,165,25,100,15,0,0,140
Maryland,Chevy Chase Village,1943,293,1140,43,5,57,1538
Maryland,Gaithersburg,67529,18174,27248,5410,1228,2017,54077
Maryland,North Kensington,9347,2148,4107,697,102,414,7468
Maryland,Travilah,11633,2091,6650,364,34,380,9519
Maryland,Washington Grove,568,120,238,74,3,35,470
Maryland,Pittsville,1433,446,461,207,15,97,1226
Maryland,Lochearn,26271,8711,8330,2457,727,1944,22169
Maryland,Mays Chapel,12303,2529,5896,1050,77,447,9999
Maryland,Overlea,12384,3216,4668,1320,392,743,10339
Maryland,Reisterstown,26933,7804,9760,2331,466,1424,21785
Maryland,Rosedale,19336,5138,7467,1566,207,1196,15574
Maryland,Cabin John,2085,473,1053,200,15,44,1785
Maryland,Clarksburg,23548,3573,11227,1065,208,346,16419
Maryland,Garrett Park,1010,179,479,59,11,53,781
Maryland,Glen Echo,325,60,159,16,0,8,243
Maryland,North Bethesda,50262,13905,20693,4063,633,2525,41819
Maryland,Potomac,45824,8173,25095,1770,390,1919,37347
Maryland,Coral Hills,9460,3988,1873,1033,406,459,7759
Maryland,Lusby,1994,484,731,263,13,97,1588
Maryland,Upper Marlboro,689,255,170,108,14,25,572
Maryland,Calverton,18076,4476,7327,1333,292,1892,15320
Maryland,Glenarden,6170,1976,1674,688,117,317,4772
Maryland,Goldsboro,246,72,80,20,2,11,185
Maryland,Henderson,153,28,56,15,0,6,105
Maryland,North Laurel,24621,6608,9996,1253,254,466,18577
Maryland,Braddock Heights,3258,464,1715,240,47,159,2625
Maryland,Burkittsville,140,27,61,18,2,7,115
Maryland,Loch Lynn Heights,499,99,226,43,10,27,405
Maryland,Chevy Chase Section Five village,668,82,362,25,0,17,486
Maryland,Edgemere,8633,1977,3504,938,144,765,7328
Maryland,Perry Hall,28129,7217,12075,2285,439,1492,23508
Maryland,Aspen Hill,52807,16228,19762,3661,879,1828,42358
Maryland,Darnestown,6424,1447,3349,285,108,210,5399
Maryland,Poolesville,5170,1200,2512,310,0,105,4127
Maryland,Redland,16978,4347,8149,830,169,558,14053
Maryland,Silver Spring,79750,26465,29266,5303,1321,1957,64312
Maryland,Edmonston,1354,515,447,93,13,22,1090
Maryland,North Beach,2594,604,883,319,34,192,2032
Maryland,Chillum,35798,14143,9932,2296,863,1191,28425
Maryland,Cottage City,1269,359,461,118,39,60,1037
Maryland,Forest Heights,2573,913,663,168,81,133,1958
Maryland,Cloverly,15062,3630,7477,711,112,553,12483
Maryland,Germantown,90844,23925,36052,6820,1241,2624,70662
Maryland,Somerset,1136,165,610,35,3,68,881
Maryland,South Kensington,8769,1499,4288,554,78,450,6869
Maryland,Accokeek,11895,2788,5558,977,61,370,9754
Maryland,Brandywine,9761,3051,4114,461,139,217,7982
Maryland,Middle River,25346,6418,9145,2373,505,1617,20058
Maryland,Damascus,15094,3149,7440,944,167,322,12022
Maryland,Bethesda,62448,13719,30054,3879,450,2809,50911
Maryland,Riverdale Park,7219,2493,2470,300,99,207,5569
Maryland,Langley Park,19278,9376,3408,625,259,246,13914
Maryland,Berwyn Heights,3257,1199,1216,235,50,109,2809
Maryland,Cape St. Claire,8928,1907,4048,632,135,319,7041
Maryland,Aberdeen,15701,4554,5318,1808,402,799,12881
Maryland,Aberdeen Proving Ground,2723,885,813,211,36,48,1993
Maryland,Riverside,5839,1485,2320,462,192,171,4630
Maryland,Arbutus,20259,5637,7717,1795,458,887,16494
Maryland,Cockeysville,22071,6864,7950,1630,554,995,17993
Maryland,Rossville,15392,4507,5349,1450,244,779,12329
Maryland,Ashton-Sandy Spring,6136,1397,2803,335,40,349,4924
Maryland,Arnold,23518,4780,11065,1631,270,836,18582
Maryland,Brooklyn Park,15036,4410,5153,1503,190,1018,12274
Maryland,Deale,4905,935,2200,543,171,181,4030
Maryland,Brunswick,6193,1687,2449,584,39,224,4983
Maryland,La Plata,9252,2611,2969,967,227,731,7505
Maryland,East New Market,453,107,145,55,11,24,342
Maryland,Galestown,82,26,25,6,4,12,73
Maryland,New Market,1295,178,589,76,3,33,879
Maryland,Rosemont village,336,52,185,27,12,10,286
Maryland,Kitzmiller,265,52,114,48,1,20,235
Maryland,Parole,16232,3458,7592,1709,324,1421,14504
Maryland,Maryland City,17736,5492,6169,1695,405,269,14030
Maryland,Naval Academy,5834,5554,155,14,4,4,5731
Maryland,Odenton,41846,9214,17117,4440,793,1765,33329
Maryland,Eldersburg,31454,6576,15407,2168,384,1295,25830
Maryland,Hillandale,6223,1491,2875,392,124,393,5275
Maryland,Annapolis,39147,12602,13393,3587,747,1549,31878
Maryland,Crofton,28379,6020,12346,2130,434,962,21892
Maryland,Easton,16551,3593,6639,1748,238,1311,13529
Maryland,Fort Ritchie,123,16,40,23,0,0,79
Maryland,Sykesville,3944,736,1781,310,42,166,3035
Maryland,Pasadena,28338,6924,12323,2519,362,1101,23229
Maryland,Leonardtown,3678,672,1379,391,36,210,2688
Maryland,Grasonville,3556,643,1508,288,61,151,2651
Maryland,Kingstown,1944,484,725,246,36,122,1613
Maryland,Templeville,161,38,49,1,5,4,97
Maryland,Queen Anne,253,38,102,45,3,6,194
Maryland,Linthicum,10895,2493,4549,971,118,806,8937
Maryland,Mayo,8171,1643,4103,631,92,340,6809
Maryland,Riviera Beach,12577,2561,5619,1172,352,606,10310
Maryland,Funkstown,811,206,337,148,0,61,752
Maryland,Williamsport,2264,610,635,385,55,172,1857
Maryland,Bel Air North,31582,6461,15415,1762,353,1391,25382
Maryland,Edgewood,26219,7760,8602,2267,681,914,20224
Maryland,Bowleys Quarters,6519,1473,3035,622,95,261,5486
Maryland,Essex,40480,11852,12266,4300,925,2880,32223
Maryland,Hampton,4725,665,2637,321,32,197,3852
Maryland,Deal Island,371,33,247,15,5,71,371
Maryland,Ferndale,17455,5001,6607,1776,271,600,14255
Maryland,Fort Meade,10297,2336,4343,273,118,73,7143
Maryland,Cordova,655,108,314,47,0,23,492
Maryland,Trappe,1210,287,478,107,38,66,976
Maryland,Pocomoke City,4082,1253,1057,436,33,410,3189
Maryland,La Vale,3421,643,1870,353,19,225,3110
Maryland,Perryville,4395,965,1563,515,203,280,3526
Maryland,Walkersville,6095,1499,2675,433,62,332,5001
Maryland,Vienna,351,100,161,24,2,17,304
Maryland,Ballenger Creek,19889,5301,7382,1726,294,1061,15764
Maryland,Emmitsburg,3058,928,1104,261,46,159,2498
Maryland,Jessup,8359,5226,1415,916,257,188,8002
Maryland,Glen Burnie,69813,20207,24778,7078,1666,3327,57056
Maryland,Woodlawn CDP (Prince George's County),7405,2186,2492,569,120,345,5712
Maryland,Severna Park,38576,6725,18868,2505,322,1717,30137
Maryland,Taneytown,6774,1554,2840,660,128,285,5467
Maryland,Parkville,31633,10433,10535,2732,580,1414,25694
Maryland,Towson,58347,22058,20122,3941,848,3033,50002
Maryland,Brookmont,3633,709,1665,354,0,158,2886
Maryland,Chevy Chase,2965,404,1662,74,35,116,2291
Maryland,Chevy Chase,9611,1699,4795,581,100,554,7729
Maryland,Chevy Chase Section Three village,722,103,414,18,7,26,568
Maryland,Hagerstown,40186,11745,11497,4697,858,2037,30834
Maryland,Riva,4027,785,2141,279,27,98,3330
Maryland,Tilghman Island,819,154,394,112,9,53,722
Maryland,Fountainhead-Orchard Hills,5823,1273,2345,611,21,430,4680
Maryland,Hancock,1481,291,609,150,23,96,1169
Maryland,Robinwood,8123,2066,3085,830,131,561,6673
Maryland,Berlin,4606,903,1711,489,70,316,3489
Maryland,Snow Hill,2143,649,643,175,20,203,1690
Maryland,Stockton,139,54,48,9,0,0,111
Maryland,Cumberland,19845,5590,6257,2478,405,1496,16226
Maryland,Midland,688,121,249,102,9,47,528
Maryland,Cecilton,884,195,295,136,3,110,739
Maryland,Rising Sun,2812,717,905,362,39,81,2104
Maryland,Bryans Road,7325,1981,3113,706,48,256,6104
Maryland,Cambridge,12401,4048,3403,1315,283,908,9957
Maryland,Lonaconing,1194,180,468,132,9,141,930
Maryland,Westernport,2018,522,671,170,69,175,1607
Maryland,Elkton,15675,4322,5149,1757,339,969,12536
Maryland,Bowie,58368,15315,23937,5311,1003,2850,48416
Maryland,Willards,856,265,246,121,17,41,690
Maryland,Marydel,337,119,107,14,7,11,258
Maryland,Kingsville,4404,744,2476,279,18,236,3753
Maryland,New Windsor,1341,280,550,169,18,50,1067
Maryland,Indian Head,3819,1039,1166,438,122,73,2838
Maryland,Girdletree,100,9,51,14,0,8,82
Maryland,St. Michaels,1057,220,451,148,24,100,943
Maryland,Highfield-Cascade,805,164,346,112,20,47,689
Maryland,Mount Aetna,675,159,325,45,13,30,572
Maryland,Mount Lena,640,97,235,58,31,30,451
Maryland,Paramount-Long Meadow,2981,487,1398,244,33,156,2318
Maryland,San Mar,168,40,32,36,4,54,166
Maryland,Ocean City,6990,1881,3084,925,140,576,6606
Maryland,Ocean Pines,12246,1793,6808,1041,90,973,10705
Maryland,North East,3624,746,1502,295,28,222,2793
Maryland,Hughesville,2105,569,1172,84,35,45,1905
Maryland,Waldorf,74587,22027,26573,6513,952,2519,58584
Maryland,Bel Air,10068,2509,4072,1167,134,587,8469
Maryland,Jarrettsville,2992,597,1611,143,0,86,2437
Maryland,Joppatowne,12560,3019,5423,1044,254,645,10385
Maryland,Crownsville,1569,417,651,122,0,163,1353
Maryland,Highland Beach,87,22,47,8,0,1,78
Maryland,Lake Shore,20260,4177,10238,1296,122,730,16563
Maryland,Boonsboro,3500,716,1364,333,10,213,2636
Maryland,Severn,50052,12633,21575,3839,967,1214,40228
Maryland,Shady Side,5839,1435,2657,425,40,194,4751
Maryland,Manchester,4836,1083,2013,435,58,208,3797
Maryland,Cavetown,1117,168,661,66,0,53,948
Maryland,Clear Spring,460,168,134,83,6,27,418
Maryland,Halfway,10784,2382,4770,1040,251,636,9079
Maryland,Rohrersville,150,16,96,22,0,0,134
Maryland,St. James,3100,828,1565,122,56,100,2671
Maryland,Wilson-Conococheague,2330,663,1075,207,0,152,2097
Maryland,Chesapeake City,763,157,328,105,47,51,688
Maryland,Charlestown,1391,377,492,187,15,56,1127
Maryland,Algonquin,1257,133,837,81,0,38,1089
Maryland,Parsonsburg,421,29,207,12,0,27,275
Maryland,Jefferson,2155,505,1068,136,30,85,1824
Maryland,Indian Springs,38,0,38,0,0,0,38
Maryland,Ilchester,26647,6124,11840,1950,178,529,20621
Maryland,Hutton,183,0,105,0,0,19,124
Maryland,Highland,1066,185,668,27,9,50,939
Maryland,Greensburg,340,59,173,35,0,9,276
Maryland,Jennings,281,80,89,40,0,0,209
Maryland,Grahamtown,285,60,207,0,0,18,285
Maryland,Glenmont,16389,4367,6864,885,220,761,13097
Maryland,Glassmanor,17628,7222,3815,1549,555,375,13516
Maryland,Gilmore,227,28,69,62,0,18,177
Maryland,Georgetown,79,14,45,0,0,12,71
Maryland,Garretts Mill,468,32,244,17,0,46,339
Maryland,Gapland,128,23,52,20,0,15,110
Maryland,Gorman,40,0,40,0,0,0,40
Maryland,Gambrills,2829,505,1491,212,23,132,2363
Maryland,Jesterville,216,52,51,0,89,0,192
Maryland,Kemps Mill,32,0,32,0,0,0,32
Maryland,McCoole,700,98,364,68,0,40,570
Maryland,Lutherville,6773,1359,3235,373,133,327,5427
Maryland,Long Beach,2015,637,690,331,34,71,1763
Maryland,Little Orleans,28,0,17,0,0,11,28
Maryland,Linganore,8978,1452,4748,527,22,183,6932
Maryland,Libertytown,983,277,306,116,14,53,766
Maryland,Jugtown,302,54,130,38,10,10,242
Maryland,Leisure World,9321,1070,4196,1443,132,2206,9047
Maryland,Lansdowne,8571,2839,2019,576,228,523,6185
Maryland,Lanham,10301,3511,3490,715,181,449,8346
Maryland,Landover,22041,8427,5238,1831,799,1020,17315
Maryland,Konterra,2853,629,1267,277,57,198,2428
Maryland,Klondike,114,25,46,11,0,0,82
Maryland,Kennedyville,445,74,241,39,0,10,364
Maryland,Layhill,4836,1367,1993,393,36,264,4053
Maryland,Madison,195,20,138,10,5,11,184
Maryland,Galesville,558,143,219,81,34,57,534
Maryland,Friendship Heights Village,5225,1407,2200,396,51,483,4537
Maryland,Drum Point,2692,604,1505,183,0,53,2345
Maryland,Downsville,331,55,175,59,0,0,289
Maryland,Detmold,192,12,101,0,0,19,132
Maryland,Derwood,1992,311,1162,141,12,80,1706
Maryland,Dawson,68,0,37,10,0,21,68
Maryland,Darlington,442,112,230,43,0,33,418
Maryland,Eakles Mill,0,0,0,0,0,0,0
Maryland,Dargan,166,71,67,14,0,0,152
Maryland,Croom,2490,377,1592,124,32,133,2258
Maryland,Cresaptown,5977,2952,1611,675,73,227,5538
Maryland,Crellin,86,0,31,22,18,15,86
Maryland,Corriganville,525,140,182,68,6,54,450
Maryland,Cobb Island,831,201,355,40,39,72,707
Maryland,Clarysville,43,0,43,0,0,0,43
Maryland,Danville,283,72,140,10,0,16,238
Maryland,Fulton,4429,461,2266,168,30,191,3116
Maryland,Eckhart Mines,801,174,452,29,0,78,733
Maryland,Elliott,37,0,23,8,6,0,37
Maryland,Friendship,232,12,147,9,0,9,177
Maryland,Franklin,201,50,46,48,7,50,201
Maryland,Four Corners,8566,1680,4186,379,57,295,6597
Maryland,Flintstone,152,37,26,10,0,41,114
Maryland,Fishing Creek,248,60,171,17,0,0,248
Maryland,Finzel,659,103,325,26,40,33,527
Maryland,Edesville,195,82,44,9,0,27,162
Maryland,Fairwood,6084,1244,2858,368,78,55,4603
Maryland,Fairplay,558,65,383,31,0,0,479
Maryland,Fairlee,470,134,119,52,12,0,317
Maryland,Ernstville,14,0,14,0,0,0,14
Maryland,Ellerslie,405,66,222,6,7,26,327
Maryland,Edgewater,9689,2327,3845,1402,178,446,8198
Maryland,Edgemont,255,40,168,0,0,18,226
Maryland,Fairview,27,0,27,0,0,0,27
Maryland,Mapleville,254,34,167,0,0,0,201
Maryland,Marlboro Meadows,3487,1088,1128,438,85,224,2963
Maryland,Marlboro Village,9803,4023,2965,744,181,190,8103
Maryland,Point of Rocks,1940,356,947,85,8,26,1422
Maryland,Pomfret,683,182,278,59,6,19,544
Maryland,Pondsville,73,13,26,13,0,21,73
Maryland,Potomac Park,848,131,357,107,6,60,661
Maryland,Powellville,78,41,0,10,0,18,69
Maryland,Pylesville,1178,221,550,29,58,0,858
Maryland,Pleasant Grove,438,96,140,125,0,11,372
Maryland,Quantico,192,54,100,0,0,0,154
Maryland,Rawlings,464,83,264,53,0,15,415
Maryland,Reid,44,0,22,0,0,0,22
Maryland,Ringgold,168,17,96,23,0,15,151
Maryland,Rock Point,103,23,72,8,0,0,103
Maryland,Sabillasville,312,103,134,35,0,22,294
Maryland,St. George Island,584,121,120,96,0,37,374
Maryland,Queen Anne,870,70,584,34,10,56,754
Maryland,Sandy Hook,101,45,24,0,0,32,101
Maryland,Piney Point,838,152,450,111,0,27,740
Maryland,Peppermill Village,4628,1660,1253,449,146,302,3810
Maryland,Middleburg,19,0,0,19,0,0,19
Maryland,Midlothian,371,91,187,31,0,18,327
Maryland,Monrovia,379,71,275,0,0,0,346
Maryland,Mount Briar,241,54,107,0,0,37,198
Maryland,Mount Savage,798,222,323,40,37,80,702
Maryland,Nanticoke,311,56,225,19,0,11,311
Maryland,Pinesburg,261,84,154,10,0,13,261
Maryland,Nanticoke Acres,20,0,20,0,0,0,20
Maryland,National Harbor,4322,1279,1558,544,101,139,3621
Maryland,Nikep,19,0,19,0,0,0,19
Maryland,Ocean,0,0,0,0,0,0,0
Maryland,Oldtown,41,13,20,8,0,0,41
Maryland,Oxon Hill,17720,6177,5649,1891,610,897,15224
Maryland,Pecktonville,344,45,190,35,0,0,270
Maryland,National,125,0,55,0,0,10,65
Maryland,Savage,6671,2157,2771,514,102,207,5751
Maryland,Seabrook,18345,6062,5578,1751,405,766,14562
Maryland,Shaft,361,44,214,21,0,18,297
Maryland,Woodland,22,13,0,0,0,9,22
Maryland,Wheaton,50459,15786,18971,3071,835,1322,39985
Maryland,Whitehaven,83,17,0,0,15,25,57
Maryland,Williston,110,18,92,0,0,0,110
Maryland,Worton,53,8,12,14,0,8,42
Maryland,Yarrowsburg,294,92,202,0,0,0,294
Maryland,Westphalia,9040,2603,3331,786,341,266,7327
Maryland,Zihlman,315,78,137,34,0,30,279
Maryland,Dunkirk,2449,450,1225,151,58,107,1991
Maryland,Huntingtown,3609,990,1565,213,45,116,2929
Maryland,Melwood,3656,802,1575,286,73,249,2985
Maryland,Scaggsville,9430,2093,4624,600,90,283,7690
Maryland,Queensland,1823,651,800,74,35,44,1604
Maryland,Mechanicsville,1765,277,893,85,10,36,1301
Maryland,Bensville,13247,3266,6283,737,142,416,10844
Maryland,West Denton,116,65,0,34,0,0,99
Maryland,Waterview,18,0,18,0,0,0,18
Maryland,Vale Summit,125,52,40,23,0,0,115
Maryland,Silver Hill,4921,2116,883,556,106,319,3980
Maryland,Spencerville,2218,693,884,97,61,48,1783
Maryland,Spring Gap,45,18,17,0,0,10,45
Maryland,Spring Ridge,5859,1224,2583,524,26,223,4580
Maryland,Suitland,24444,10095,5325,2633,647,836,19536
Maryland,Summerfield,13781,5153,3379,1336,508,582,10958
Maryland,Swanton,68,0,57,11,0,0,68
Maryland,Tall Timbers,390,26,306,15,0,0,347
Maryland,Taylors Island,196,56,121,10,0,0,187
Maryland,Tilghmanton,814,299,197,114,0,84,694
Maryland,Timonium,10140,2262,4658,562,160,1017,8659
Maryland,Tolchester,400,98,241,6,0,20,365
Maryland,Trego-Rohrersville Station,121,32,89,0,0,0,121
Maryland,Tyaskin,170,72,64,17,17,0,170
Maryland,Urbana,11788,1735,5162,991,147,148,8183
Maryland,Choptank,201,44,111,0,0,0,155
Maryland,Moscow,232,45,83,34,11,37,210
Maryland,Chesapeake Ranch Estates,9732,2758,3293,1019,178,310,7558
Maryland,Cedarville,546,181,259,51,0,24,515
Maryland,Randallstown,34897,10310,12841,3001,833,2202,29187
Maryland,Barnesville,140,19,78,14,2,3,116
Maryland,Burtonsville,10604,3101,4270,771,113,279,8534
Maryland,Fairland,24831,7270,9073,2251,538,753,19885
Maryland,North Chevy Chase village,558,62,318,26,0,28,434
Maryland,Hillsboro,130,44,45,24,0,5,118
Maryland,Sharptown,815,185,308,96,18,47,654
Maryland,Bladensburg,9397,2752,2503,948,234,427,6864
Maryland,Landover Hills,1833,511,612,170,41,26,1360
Maryland,Marlow Heights,5869,2027,1723,544,158,325,4777
Maryland,Marlton,9216,3039,3108,949,84,279,7459
Maryland,Temple Hills,7864,3189,1624,951,206,281,6251
Maryland,Chester,4573,746,2145,485,156,347,3879
Maryland,Charlton,245,60,144,8,0,9,221
Maryland,Fairmount,318,122,128,35,0,13,298
Maryland,Laurel,25834,8101,8624,2333,693,738,20489
Maryland,Hillcrest Heights,16185,6690,3434,1694,698,753,13269
Maryland,Largo,11604,4042,3875,1168,192,369,9646
Maryland,West Laurel,4292,1000,2103,252,38,147,3540
Maryland,Millington,600,227,127,92,20,28,494
Maryland,Queenstown,553,73,229,94,10,34,440
Maryland,Crisfield,2593,751,795,204,29,187,1966
Maryland,Eden,826,225,72,148,97,105,647
Maryland,Mount Vernon,917,158,470,114,0,20,762
Maryland,West Pocomoke,301,23,156,43,34,23,279
Maryland,Owings Mills,34477,11202,10859,3399,1009,1525,27994
Maryland,Dundalk,62768,19357,20103,5904,1558,4340,51262
Maryland,Fruitland,5204,1970,1832,291,65,172,4330
Maryland,Baltimore,614700,265469,135921,55151,16900,32233,505674
Maryland,District Heights,5975,2253,1063,724,143,488,4671
Maryland,Eagle Harbor,32,2,20,1,0,1,24
Maryland,Oxford,586,64,339,87,6,44,540
Maryland,Keedysville,1154,202,602,69,33,33,939
Maryland,Smithsburg,2964,572,1296,251,47,62,2228
Maryland,Newark,297,99,148,21,0,29,297
Maryland,West Ocean City,4319,1242,1837,373,48,212,3712
Maryland,Whaleyville,108,29,45,0,0,34,108
Maryland,Woodsboro,1077,222,512,93,8,55,890
Maryland,Accident,244,40,100,29,10,11,190
Maryland,Deer Park,459,155,184,32,17,25,413
Maryland,Leitersburg,434,112,156,80,0,43,391
Maryland,Federalsburg,2665,781,574,280,27,161,1823
Maryland,Chesapeake Beach,5922,1279,2271,540,115,246,4451
Maryland,Eldorado,41,11,18,5,0,2,36
Maryland,Betterton,385,66,137,38,5,34,280
Maryland,Westminster,18553,5736,6507,1573,275,1136,15227
Maryland,Frostburg,8626,4483,1933,663,95,435,7609
Maryland,Port Tobacco Village,4,0,4,0,0,0,4
Maryland,Olney,35280,7743,17440,1960,585,1045,28773
Maryland,North Potomac,24148,4418,13140,1086,168,546,19358
Maryland,Rock Hall,1361,263,516,128,34,125,1066
Maryland,Secretary,439,65,198,54,9,27,353
Maryland,Perryman,2712,646,870,249,90,244,2099
Maryland,Columbia,103663,27425,44073,7904,1281,4110,84793
Maryland,Pleasant Hills,3765,752,2049,206,27,150,3184
Maryland,Sharpsburg,806,190,361,90,0,41,682
Maryland,Greensboro,2476,667,632,200,14,179,1692
Maryland,Church Hill,838,195,363,48,9,23,638
Maryland,Owings,2569,441,1260,146,23,94,1964
Maryland,Bakersville,52,8,30,0,0,0,38
Maryland,Baltimore Highlands,7959,2549,2332,729,174,248,6032
Maryland,Barrelville,47,14,21,6,0,6,47
Maryland,Bartonsville,1712,413,732,154,40,31,1370
Maryland,Beaver Creek,356,110,145,44,0,15,314
Maryland,Bel Air,1524,287,551,148,0,100,1086
Maryland,Benedict,358,14,253,0,0,91,358
Maryland,Bier,149,0,108,27,0,0,135
Maryland,Big Pool,56,9,32,0,0,8,49
Maryland,Big Spring,90,31,26,20,0,0,77
Maryland,Bishopville,766,218,397,0,0,55,670
Maryland,Ridgely,1558,348,583,125,21,135,1212
Maryland,Bloomington,216,50,88,44,0,9,191
Maryland,Bowling Green,1198,288,593,110,0,51,1042
Maryland,Bowmans Addition,568,166,227,63,0,22,478
Maryland,Breathedsville,103,12,55,12,0,15,94
Maryland,Brock Hall,11664,3051,4994,919,96,274,9334
Maryland,Broomes Island,329,172,118,27,0,12,329
Maryland,Brownsville,41,16,25,0,0,0,41
Maryland,Bryantown,644,64,339,37,0,56,496
Maryland,Buckeystown,1318,115,732,46,0,236,1129
Maryland,Butlertown,362,63,167,55,0,24,309
Maryland,Calvert Beach,972,194,354,128,10,28,714
Maryland,Carlos,80,29,39,12,0,0,80
Maryland,Cearfoss,106,0,70,10,0,9,89
Maryland,Bagtown,279,76,157,14,7,8,262
Maryland,Baden,1712,407,794,133,50,96,1480
Maryland,Bivalve,387,0,195,0,0,31,226
Maryland,Aquasco,825,220,383,73,11,57,744
Maryland,Arden on the Severn,1953,349,993,141,18,82,1583
Maryland,Andrews AFB,2964,539,1284,73,3,0,1899
Maryland,Beltsville,17589,5161,6058,1348,315,961,13843
Maryland,Capitol Heights,4512,1663,1004,490,108,279,3544
Maryland,College Park,32183,21557,6019,1063,279,631,29549
Maryland,East Riverdale,15467,5245,4265,709,361,565,11145
Maryland,Kettering,13637,4342,4545,1695,288,931,11801
Maryland,Mitchellville,11215,3237,4610,810,137,356,9150
Maryland,White Oak,19010,6105,6372,1969,391,505,15342
Maryland,Pikesville,33387,7097,14309,2904,519,2168,26997
Maryland,Colesville,13894,3177,6631,1138,170,708,11824
Maryland,Rockville,67062,17331,28134,4969,998,3060,54492
Maryland,Maugansville,3122,625,1299,257,71,199,2451
Maryland,Mercersville,115,10,18,71,0,0,99
Maryland,Luke,109,44,27,8,0,1,80
Maryland,Barton,433,111,190,33,5,23,362
Maryland,Annapolis Neck,11590,2091,6133,1004,111,551,9890
Maryland,Allen,384,176,208,0,0,0,384
Maryland,Charlotte Hall,2026,346,702,110,51,260,1469
Maryland,Chewsville,394,28,259,9,0,0,296
Maryland,Herald Harbor,2615,380,1280,265,7,114,2046
Maryland,Antietam,76,11,46,12,0,0,69
Maryland,University Park,2641,707,1116,181,22,90,2116
Maryland,Greenbelt,23203,7765,6734,2385,628,583,18095
Maryland,Laytonsville,367,80,180,26,2,14,302
Maryland,Chestertown,5113,2249,1092,632,99,607,4679
Maryland,Hebron,1218,365,441,111,17,34,968
Maryland,Adamstown,2263,385,1111,115,26,36,1673
Massachusetts,Hudson,15508,4204,6726,1188,324,902,13344
Massachusetts,Littleton Common,3402,714,1521,228,89,184,2736
Massachusetts,Reading,25100,5472,12021,1454,117,1187,20251
Massachusetts,East Brookfield,1124,323,426,105,26,43,923
Massachusetts,Mashpee Neck,988,210,534,84,11,8,847
Massachusetts,Oxford,5662,1307,2262,568,85,339,4561
Massachusetts,North Falmouth,2698,540,1474,96,51,263,2424
Massachusetts,Woods Hole,883,149,407,93,9,88,746
Massachusetts,Millers Falls,1239,470,410,95,22,95,1092
Massachusetts,Townsend,1372,250,469,225,6,87,1037
Massachusetts,Fiskdale,3166,652,1262,345,31,162,2452
Massachusetts,Holyoke,40376,16239,10695,3318,743,1630,32625
Massachusetts,Yarmouth Port,5045,870,2557,475,71,630,4603
Massachusetts,Waltham,62979,25527,22070,4352,527,2593,55069
Massachusetts,Somerville,80434,42334,22818,4185,745,2623,72705
Massachusetts,Shirley,1782,490,564,351,15,237,1657
Massachusetts,Hopkinton,2844,640,1303,194,21,197,2355
Massachusetts,Boston,679413,327935,177201,43307,16149,22813,587405
Massachusetts,West Dennis,2179,459,1149,244,27,156,2035
Massachusetts,Falmouth,3508,895,1430,503,7,416,3251
Massachusetts,Medford,57771,21035,22189,3730,576,2934,50464
Massachusetts,East Pepperell,1592,321,832,151,11,58,1373
Massachusetts,Sandwich,2866,685,1541,281,23,118,2648
Massachusetts,North Plymouth,3787,1174,1230,482,60,222,3168
Massachusetts,Hanscom AFB,2048,226,967,59,6,0,1258
Massachusetts,Woburn,40298,11790,16348,3198,522,2125,33983
Massachusetts,Edgartown,422,189,122,52,13,31,407
Massachusetts,Chelsea,39852,15063,10622,2614,1473,1356,31128
Massachusetts,Monument Beach,2984,754,1500,336,17,160,2767
Massachusetts,Holbrook,11036,3549,4358,946,83,572,9508
Massachusetts,Norwood,29201,7492,12452,2362,434,1718,24458
Massachusetts,East Falmouth,5782,1482,2433,722,56,376,5069
Massachusetts,Harwich Center,1511,226,725,161,14,140,1266
Massachusetts,Monomoscoy Island,112,20,59,17,0,16,112
Massachusetts,Seabrook,445,82,281,30,9,15,417
Massachusetts,Seconsett Island,17,17,0,0,0,0,17
Massachusetts,West Chatham,1272,238,631,115,26,59,1069
Massachusetts,South Deerfield,1859,444,733,213,40,56,1486
Massachusetts,Holland,1365,367,634,138,0,75,1214
Massachusetts,Mansfield Center,7892,2080,3530,582,15,363,6570
Massachusetts,Bellingham,4652,1136,1988,494,27,344,3989
Massachusetts,Arlington,45147,11707,20337,2907,360,1622,36933
Massachusetts,Middleborough Center,7333,2301,2436,878,85,389,6089
Massachusetts,Marlborough,39776,11422,16505,3389,553,1450,33319
Massachusetts,White Island Shores,2322,817,894,126,9,162,2008
Massachusetts,Ayer,2604,680,861,407,86,52,2086
Massachusetts,Belmont,26043,5654,12207,1445,226,1145,20677
Massachusetts,Cochituate,6942,1299,3532,386,31,285,5533
Massachusetts,Maynard,10600,2366,5117,741,66,438,8728
Massachusetts,Newton,88660,24644,39310,4720,539,3874,73087
Massachusetts,Stoneham,22144,5074,10113,1950,242,1315,18694
Massachusetts,West Concord,7402,2025,3034,661,135,392,6247
Massachusetts,Norton Center,2879,2008,532,84,23,63,2710
Massachusetts,Acushnet Center,3136,812,1185,439,63,150,2649
Massachusetts,Monson Center,1811,537,722,233,44,75,1611
Massachusetts,Amherst Center,20253,16866,1893,484,81,361,19685
Massachusetts,Winchester,22677,3701,11397,1117,69,1079,17363
Massachusetts,Hull,10424,2799,4246,1514,145,642,9346
Massachusetts,Dennis Port,3373,757,1196,603,0,245,2801
Massachusetts,Northwest Harwich,4033,927,1808,359,16,368,3478
Massachusetts,Foxborough,5912,1435,2125,880,95,497,5032
Massachusetts,South Yarmouth,11624,3245,4931,1112,103,898,10289
Massachusetts,Pepperell,2573,733,897,333,31,125,2119
Massachusetts,Shelburne Falls,1756,521,565,282,25,132,1525
Massachusetts,Burlington,27059,5732,13248,1736,104,1638,22458
Massachusetts,Dennis,2360,343,1551,134,32,177,2237
Massachusetts,Webster,11769,3614,3684,1526,327,661,9812
Massachusetts,Andover,9217,2986,3501,715,62,530,7794
Massachusetts,Ocean Grove,2963,865,1018,449,86,102,2520
Massachusetts,Needham,30735,5776,15413,1367,160,1431,24147
Massachusetts,Quincy,94121,31486,37399,7251,1507,4398,82041
Massachusetts,Abington,16330,4443,7105,1398,218,683,13847
Massachusetts,Kingston,6205,1255,2983,466,125,197,5026
Massachusetts,Mattapoisett Center,3594,1022,1679,419,38,68,3226
Massachusetts,South Duxbury,3613,622,1958,112,17,115,2824
Massachusetts,Wareham Center,3690,1059,970,474,76,248,2827
Massachusetts,Cambridge,115665,59027,34195,6448,898,2944,103512
Massachusetts,Pinehurst,7275,1541,3653,465,92,283,6034
Massachusetts,Bourne,1169,196,486,139,0,150,971
Massachusetts,Buzzards Bay,3431,1032,1143,599,55,222,3051
Massachusetts,Belchertown,2841,682,1257,324,0,102,2365
Massachusetts,Salem,43302,16060,14455,3740,731,2112,37098
Massachusetts,Haverhill,63280,19632,21557,6118,1033,2802,51142
Massachusetts,Agawam Town,28744,6869,12080,3128,481,1707,24265
Massachusetts,Orange,3837,1005,1658,313,80,180,3236
Massachusetts,Weymouth Town,56384,15959,22737,5193,613,3187,47689
Massachusetts,Bliss Corner,5137,1327,1996,636,125,567,4651
Massachusetts,North Eastham,1548,227,795,247,0,145,1414
Massachusetts,Chatham,1480,306,738,165,7,154,1370
Massachusetts,South Ashburnham,917,135,437,90,14,12,688
Massachusetts,East Douglas,2908,738,1225,175,99,144,2381
Massachusetts,Topsfield,3362,464,1636,252,0,183,2535
Massachusetts,Fall River,89339,28304,28816,8465,1974,5838,73397
Massachusetts,Swampscott,14755,3128,7119,955,97,617,11916
Massachusetts,Peabody,52865,13569,22037,4562,757,4037,44962
Massachusetts,Marblehead,20488,3639,10298,1754,112,888,16691
Massachusetts,Wakefield,26960,6453,12474,2333,168,1359,22787
Massachusetts,Lowell,111249,41831,32280,9721,2139,4648,90619
Massachusetts,Everett,45856,15430,14858,3292,1041,1676,36297
Massachusetts,Onset,824,305,240,122,43,41,751
Massachusetts,North Pembroke,3255,863,1463,199,33,192,2750
Massachusetts,Warren,812,254,288,84,0,94,720
Massachusetts,North Brookfield,2269,610,1005,172,17,128,1932
Massachusetts,Gardner,20555,6073,7035,2277,501,1142,17028
Massachusetts,Newburyport,17990,3902,8124,2243,125,816,15210
Massachusetts,Framingham,71649,20388,30083,5338,1111,3230,60150
Massachusetts,Winthrop Town,18535,5195,7285,1936,309,1103,15828
Massachusetts,Longmeadow,15830,3029,7875,878,26,908,12716
Massachusetts,North Seekonk,2534,520,1397,188,0,52,2157
Massachusetts,North Westport,4515,1153,1578,701,31,337,3800
Massachusetts,South Amherst,5527,3326,1257,243,39,99,4964
Massachusetts,Amesbury Town,17378,4579,7074,1870,203,814,14540
Massachusetts,Blandford,310,59,178,39,0,7,283
Massachusetts,Braintree Town,37207,8889,15528,2682,363,2352,29814
Massachusetts,Brookfield,752,300,211,87,7,48,653
Massachusetts,Cheshire,628,241,196,103,0,21,561
Massachusetts,Chester,795,263,287,62,5,23,640
Massachusetts,Deerfield,677,261,228,63,0,38,590
Massachusetts,Devens,1913,760,396,387,109,32,1684
Massachusetts,Easthampton Town,16023,4726,6226,1829,277,1041,14099
Massachusetts,Franklin Town,33022,7608,15381,2030,363,1201,26583
Massachusetts,Greenfield Town,17468,5321,6198,1929,185,1219,14852
Massachusetts,Barnstable Town,44314,10703,19437,5180,559,2367,38246
Massachusetts,Huntington,654,198,293,98,0,19,608
Massachusetts,Methuen Town,50019,14840,19783,4053,735,2374,41785
Massachusetts,Palmer Town,12251,3569,4480,1633,246,619,10547
Massachusetts,Petersham,249,69,111,23,0,28,231
Massachusetts,Russell,428,88,163,90,4,43,388
Massachusetts,Siasconset,96,11,64,0,0,21,96
Massachusetts,Southbridge Town,16894,5057,5877,1656,390,964,13944
Massachusetts,Southfield,0,0,0,0,0,0,0
Massachusetts,The Pinehills,1350,199,897,134,14,106,1350
Massachusetts,Watertown Town,35103,11832,13936,2632,471,1503,30374
Massachusetts,West Springfield Town,28666,8210,10524,3039,319,1535,23627
Massachusetts,Harwich Port,1739,383,791,235,10,197,1616
Massachusetts,Madaket,276,132,122,17,0,5,276
Massachusetts,Williamstown,4446,2788,936,206,33,114,4077
Massachusetts,Upton,2529,483,1373,149,41,65,2111
Massachusetts,Brookline,59234,21866,23594,2672,407,1661,50200
Massachusetts,Lexington,33480,5793,17526,1584,166,1364,26433
Massachusetts,Malden,61094,19263,24007,4422,932,2187,50811
Massachusetts,Melrose,28116,7046,13197,1908,221,1123,23495
Massachusetts,Lenox,1998,487,659,267,14,388,1815
Massachusetts,Beverly,41731,13537,15715,3804,526,2172,35754
Massachusetts,Lynn,93617,31697,28352,7759,2663,4241,74712
Massachusetts,Lynnfield,12847,2303,6561,509,32,728,10133
Massachusetts,Rockport,5245,920,2692,547,53,395,4607
Massachusetts,Barre,1068,408,377,181,0,13,979
Massachusetts,Leominster,41579,10557,15821,4374,567,2596,33915
Massachusetts,Worcester,185195,72582,52349,17726,3413,9463,155533
Massachusetts,Wilmington,23658,5780,11220,1544,159,988,19691
Massachusetts,Pittsfield,43058,13202,15230,4946,545,2323,36246
Massachusetts,Housatonic,656,164,249,86,31,61,591
Massachusetts,Lee,1841,504,747,180,11,109,1551
Massachusetts,Granby,1318,336,497,197,55,154,1239
Massachusetts,Athol,8412,2879,2469,1060,162,329,6899
Massachusetts,Boxford,2744,419,1493,154,15,73,2154
Massachusetts,Gloucester,30049,7132,13678,2924,302,1900,25936
Massachusetts,Saugus,28158,7211,12244,2461,355,1666,23937
Massachusetts,Northborough,6171,1292,2941,507,157,216,5113
Massachusetts,Rutland,2121,435,1059,250,14,53,1811
Massachusetts,Westborough,3986,1106,1697,349,36,147,3335
Massachusetts,Marion Center,1070,295,509,82,0,51,937
Massachusetts,West Brookfield,1330,446,464,119,0,167,1196
Massachusetts,Hanson,1640,414,899,73,14,48,1448
Massachusetts,Dover,2533,410,1408,80,25,47,1970
Massachusetts,Vineyard Haven,1887,593,528,203,127,169,1620
Massachusetts,Revere,53966,16496,18841,5280,1182,3040,44839
Massachusetts,South Dennis,3684,692,1554,523,43,335,3147
Massachusetts,North Amherst,6891,4711,1512,114,52,116,6505
Massachusetts,Ware,5907,1649,1798,812,95,404,4758
Massachusetts,Millis-Clicquot,4350,1120,1794,357,70,188,3529
Massachusetts,Wellesley,29201,8282,12624,1097,190,805,22998
Massachusetts,Marshfield Hills,2337,325,1205,247,15,151,1943
Massachusetts,Groton,1147,359,423,139,14,26,961
Massachusetts,Plymouth,7122,2291,2307,910,138,507,6153
Massachusetts,Forestdale,4403,922,2211,201,106,178,3618
Massachusetts,Popponesset,184,34,133,9,0,8,184
Massachusetts,Popponesset Island,8,8,0,0,0,0,8
Massachusetts,Provincetown,2628,933,1070,273,20,228,2524
Massachusetts,Sagamore,3673,859,1792,255,53,178,3137
Massachusetts,West Falmouth,1835,406,1003,116,0,25,1550
Massachusetts,West Yarmouth,5271,1458,2105,502,101,522,4688
Massachusetts,Northfield,1237,289,498,179,18,76,1060
Massachusetts,Westfield,41599,13376,15287,3633,808,2347,35451
Massachusetts,Attleboro,44548,11004,18294,4190,566,2368,36422
Massachusetts,Duxbury,1668,351,965,61,9,66,1452
Massachusetts,New Bedford,95117,33231,27356,9296,2316,5525,77724
Massachusetts,Nantucket,8034,2577,2695,958,114,221,6565
Massachusetts,Bridgewater,9255,5586,1729,481,72,315,8183
Massachusetts,Green Harbor-Cedar Crest,2565,603,1379,190,0,87,2259
Massachusetts,North Adams,13089,4337,3942,1842,314,813,11248
Massachusetts,North Scituate,4804,986,2326,273,81,215,3881
Massachusetts,Sharon,5655,1075,2816,306,34,124,4355
Massachusetts,Walpole,6401,1387,2665,475,46,434,5007
Massachusetts,Brockton,95426,32139,28259,8190,2587,4318,75493
Massachusetts,Marshfield,4976,1209,1992,439,11,186,3837
Massachusetts,Weweantic,1880,382,616,346,23,82,1449
Massachusetts,Brewster,1757,353,1066,105,14,120,1658
Massachusetts,East Dennis,2366,391,1462,108,10,236,2207
Massachusetts,East Harwich,4859,1083,2609,379,13,367,4451
Massachusetts,East Sandwich,3478,605,1894,358,7,214,3078
Massachusetts,New Seabury,774,34,450,110,9,101,704
Massachusetts,Pocasset,3069,676,1500,286,36,381,2879
Massachusetts,Raynham Center,4522,1241,1883,264,16,127,3531
Massachusetts,Randolph,33924,11259,12021,2624,982,1978,28864
Massachusetts,Somerset,18207,3963,8464,1646,221,1290,15584
Massachusetts,Northampton,28568,11127,9143,2964,296,1211,24741
Massachusetts,Turners Falls,4100,1265,1376,537,49,244,3471
Massachusetts,Medfield,6776,1190,3247,332,29,362,5160
Massachusetts,Milton,27568,7415,11512,1535,261,1201,21924
Massachusetts,Hingham,6290,1223,3034,342,6,233,4838
Massachusetts,Chicopee,55661,17438,18421,6392,1145,3165,46561
Massachusetts,Springfield,154596,60632,37138,13720,4045,6755,122290
Massachusetts,Teaticket,1597,335,760,182,8,128,1413
Massachusetts,Smith Mills,4717,1160,1913,462,58,422,4015
Massachusetts,Dedham,25377,6462,10931,1854,328,1810,21385
Massachusetts,Orleans,1867,347,742,406,21,217,1733
Massachusetts,Wilbraham,3385,696,1598,270,25,265,2854
Massachusetts,Taunton,56963,16515,19940,6065,942,2985,46447
Massachusetts,North Lakeville,2936,769,1208,325,49,142,2493
Massachusetts,Hatfield,1352,316,696,120,19,96,1247
Massachusetts,Cordaville,2905,562,1359,141,33,50,2145
Massachusetts,Salisbury,4927,1319,2060,637,28,325,4369
Massachusetts,Fitchburg,40737,14038,12849,3527,734,2029,33177
Massachusetts,Hopedale,3488,894,1278,492,44,163,2871
Massachusetts,Rowley,1628,245,709,284,0,89,1327
Massachusetts,Lunenburg,2023,385,811,374,25,118,1713
Massachusetts,Essex,1376,289,636,143,0,91,1159
Massachusetts,Spencer,5705,1969,2016,668,48,301,5002
Massachusetts,Danvers,27631,6543,11672,2479,343,1931,22968
Massachusetts,Sturbridge,2169,429,1126,212,4,17,1788
Massachusetts,Winchendon,3662,1062,1254,514,57,211,3098
Massachusetts,Whitinsville,6941,1395,2833,738,42,280,5288
Massachusetts,South Lancaster,1588,269,759,167,90,71,1356
Massachusetts,Milford,25656,6152,10275,2360,581,1034,20402
Massachusetts,Nahant,3495,994,1611,315,58,188,3166
Massachusetts,Lawrence,79841,29264,21203,6052,2786,2534,61839
Massachusetts,Ipswich,4384,964,1775,512,65,296,3612
Massachusetts,Great Barrington,2492,885,677,454,44,123,2183
Massachusetts,Adams,5572,1556,2247,639,26,307,4775
Massachusetts,West Wareham,2173,432,853,383,24,214,1906
Massachusetts,Scituate,5482,1054,2614,450,22,382,4522
Massachusetts,Ocean Bluff-Brant Rock,5190,1376,2134,545,34,268,4357
Massachusetts,Clinton,7181,2203,2495,742,283,265,5988
Massachusetts,Baldwinville,1894,519,708,254,0,165,1646
Michigan,Central Lake village,969,170,433,136,17,51,807
Michigan,Bridgeport,6443,1699,2389,570,155,496,5309
Michigan,Ellsworth village,357,97,173,22,14,14,320
Michigan,Sault Ste. Marie,13712,4911,3640,1666,149,1021,11387
Michigan,Pellston village,822,145,337,88,22,43,635
Michigan,Brooklyn village,1160,220,425,140,25,113,923
Michigan,Grosse Pointe,5218,1193,2444,431,21,234,4323
Michigan,Durand,3317,1083,943,478,60,365,2929
Michigan,Mendon village,918,174,393,87,9,36,699
Michigan,Vandercook Lake,4781,1007,1760,645,16,188,3616
Michigan,Garden City,26809,7293,10092,3214,252,1697,22548
Michigan,Grosse Pointe Park,11207,2477,5397,844,58,359,9135
Michigan,Clawson,12029,3646,4878,1348,52,638,10562
Michigan,Farmington Hills,81482,19896,36606,7532,523,4258,68815
Michigan,Schoolcraft village,1357,318,588,149,3,94,1152
Michigan,Colon village,1243,218,509,140,14,105,986
Michigan,Evart,1587,378,489,246,45,80,1238
Michigan,Bronson,2378,744,769,282,55,121,1971
Michigan,Grass Lake village,1227,361,521,66,13,35,996
Michigan,Dowling,353,45,185,11,16,29,286
Michigan,Rose City,586,139,159,112,21,53,484
Michigan,Caberfae,30,7,11,4,0,3,25
Michigan,Carp Lake,410,56,209,61,0,34,360
Michigan,Cedar,95,30,38,16,0,0,84
Michigan,Chums Corner,1150,273,510,62,0,15,860
Michigan,Conway,205,45,77,38,0,28,188
Michigan,Copper Harbor,71,12,49,9,0,1,71
Michigan,Cross Village,87,16,60,3,0,4,83
Michigan,Crystal Downs Country Club,82,2,67,0,0,13,82
Michigan,Brutus,132,32,51,8,3,10,104
Michigan,Crystal Mountain,64,13,43,6,0,0,62
Michigan,Dollar Bay,955,215,362,42,22,44,685
Michigan,Howard City village,1643,346,564,222,16,72,1220
Michigan,Eagle Harbor,100,4,72,5,0,12,93
Michigan,Eagle River,84,8,56,9,0,6,79
Michigan,Eastport,207,36,92,22,0,31,181
Michigan,Filer City,81,45,30,6,0,0,81
Michigan,Fostoria,606,158,220,91,10,20,499
Michigan,Glen Arbor,133,16,81,16,0,17,130
Michigan,Delton,915,94,386,171,20,89,760
Michigan,Brethren,441,89,186,39,0,14,328
Michigan,Boon,235,47,94,20,0,2,163
Michigan,Bendon,186,39,79,28,0,5,151
Michigan,Skidway Lake,3426,626,1281,512,17,351,2787
Michigan,West Branch,2256,429,742,364,50,280,1865
Michigan,Comstock Park,10374,3077,3562,1334,70,306,8349
Michigan,Cutlerville,16623,4732,5628,1859,165,656,13040
Michigan,East Grand Rapids,11642,1642,5996,721,60,223,8642
Michigan,DeWitt,4667,934,2297,253,39,101,3624
Michigan,Lake Isabella village,2112,337,1150,124,9,69,1689
Michigan,Douglas,953,207,346,199,5,89,846
Michigan,Chelsea,5295,1031,2310,492,4,503,4340
Michigan,Advance,323,28,251,24,0,2,305
Michigan,Alba,332,30,169,38,0,9,246
Michigan,Alden,92,7,56,9,0,18,90
Michigan,Amasa,262,67,96,12,6,31,212
Michigan,Arcadia,271,51,151,35,0,15,252
Michigan,Attica,740,188,397,64,10,31,690
Michigan,Bath,2213,403,1003,210,0,128,1744
Michigan,Bay Port,434,86,159,92,4,37,378
Michigan,Bay View,226,55,150,16,0,0,221
Michigan,Bear Lake,396,53,203,56,2,29,343
Michigan,Tustin village,237,43,95,37,0,9,184
Michigan,Coleman,1406,312,508,209,8,77,1114
Michigan,Fairgrove village,572,162,215,76,7,16,476
Michigan,Frankfort,1108,217,488,156,18,179,1058
Michigan,Three Oaks village,1463,385,559,181,6,53,1184
Michigan,Zilwaukee,1650,462,709,120,8,60,1359
Michigan,Baraga village,2306,1292,422,205,51,71,2041
Michigan,McBride village,193,43,75,19,0,9,146
Michigan,Harper Woods,13959,5118,3738,1431,230,824,11341
Michigan,Southfield,73392,24442,22701,9147,1210,4704,62204
Michigan,Gladwin,2883,702,940,382,27,232,2283
Michigan,Metamora village,630,144,232,92,0,31,499
Michigan,White Pigeon village,1449,355,528,156,18,73,1130
Michigan,Sterling village,606,143,232,66,0,52,493
Michigan,Traverse City,15474,4457,5846,2015,87,894,13299
Michigan,Clarksville village,417,91,177,56,0,16,340
Michigan,Ionia,11187,4634,2722,1765,147,266,9534
Michigan,Mount Pleasant,25691,15272,5122,1801,127,888,23210
Michigan,Shepherd village,1492,413,576,213,15,42,1259
Michigan,Canadian Lakes,2925,273,1995,141,55,162,2626
Michigan,Madison Heights,30226,9769,10627,3377,317,1367,25457
Michigan,Britton village,643,170,272,63,2,21,528
Michigan,Clayton village,339,77,129,27,0,21,254
Michigan,Prescott village,192,33,78,29,4,18,162
Michigan,Level Park-Oak Park,3769,931,1515,600,46,127,3219
Michigan,Algonac,4040,921,1634,487,31,230,3303
Michigan,Lincoln village,364,99,105,58,5,42,309
Michigan,Grawn,1225,243,444,64,0,28,779
Michigan,Sterling Heights,132470,33126,58270,9683,881,8067,110027
Michigan,Onaway,782,225,223,129,10,80,667
Michigan,Berrien Springs village,1590,524,554,140,24,54,1296
Michigan,Niles,11265,3258,3213,1401,202,611,8685
Michigan,Boyne Falls village,423,80,146,50,12,33,321
Michigan,Charlevoix,2364,725,879,332,46,131,2113
Michigan,Watervliet,1663,373,606,205,26,89,1299
Michigan,Indian River,1879,298,959,268,7,160,1692
Michigan,Onsted village,1005,221,389,126,10,46,792
Michigan,Wolverine village,247,75,86,21,2,16,200
Michigan,Wayland,4190,787,1393,583,74,243,3080
Michigan,Crystal Falls,1701,402,657,249,2,77,1387
Michigan,Westwood,9280,3597,2831,838,122,500,7888
Michigan,Caledonia village,1657,301,702,130,15,44,1192
Michigan,Cedar Springs,3651,1068,1128,545,39,62,2842
Michigan,Sparta village,4332,1382,1462,441,13,275,3573
Michigan,Walker,24768,6801,10452,1936,104,958,20251
Michigan,Yale,2010,442,718,263,27,197,1647
Michigan,Carney village,202,55,67,42,0,17,181
Michigan,Otsego,3976,855,1626,481,23,251,3236
Michigan,Ironwood,4999,1463,1857,589,58,437,4404
Michigan,Alpena,10086,2457,3467,1580,196,662,8362
Michigan,Fennville,1949,543,651,157,41,67,1459
Michigan,Woodland Beach,2049,416,584,282,22,184,1488
Michigan,Farwell village,853,232,276,115,13,69,705
Michigan,Breedsville village,177,43,87,14,7,1,152
Michigan,Hartford,2605,713,780,208,58,118,1877
Michigan,South Haven,4341,695,2021,482,86,442,3726
Michigan,Pearl Beach,2996,449,1799,297,29,154,2728
Michigan,Newaygo,1928,487,604,205,35,92,1423
Michigan,Byron Center,6710,942,3201,436,0,243,4822
Michigan,Forest Hills,27947,4817,14909,1407,98,881,22112
Michigan,Richmond,5874,1309,2383,524,7,370,4593
Michigan,St. Clair,5350,1130,2408,525,38,256,4357
Michigan,Powers village,441,78,131,51,11,122,393
Michigan,Center Line,8303,2549,2582,1003,293,390,6817
Michigan,Romeo village,3916,990,1496,418,60,308,3272
Michigan,Robin Glen-Indiantown,835,256,221,86,19,32,614
Michigan,Au Gres,830,170,329,139,4,89,731
Michigan,Omer,322,61,132,29,8,17,247
Michigan,Beaverton,1438,495,318,222,38,84,1157
Michigan,Breckenridge village,1243,269,459,155,34,60,977
Michigan,Houghton,7934,5257,1354,327,32,257,7227
Michigan,Three Rivers,7680,1729,2458,935,117,376,5615
Michigan,Otter Lake village,380,96,155,50,1,25,327
Michigan,Flint,97161,38387,19880,12103,2063,4154,76587
Michigan,Hopkins village,756,192,286,43,2,27,550
Michigan,Albion,8324,3461,1984,653,188,403,6689
Michigan,Beecher,9128,3724,1734,840,227,473,6998
Michigan,Burton,28754,7319,10885,3445,223,1467,23339
Michigan,Pleasant Ridge,2389,571,1131,178,5,75,1960
Michigan,Gaylord,3667,914,1090,429,125,327,2885
Michigan,Nashville village,1728,352,570,260,20,132,1334
Michigan,Edwardsburg village,1200,335,359,135,8,86,923
Michigan,Marcellus village,1171,257,397,143,37,55,889
Michigan,Ossineke,926,163,436,84,16,60,759
Michigan,Vandalia village,398,73,140,31,7,22,273
Michigan,Mason,8447,2252,3208,975,108,346,6889
Michigan,Stony Point,1695,410,627,317,0,57,1411
Michigan,Brown City,1192,340,421,151,10,64,986
Michigan,Fruitport village,1361,282,604,149,23,51,1109
Michigan,Montague,2493,519,980,312,27,150,1988
Michigan,Ravenna village,1238,243,541,93,14,65,956
Michigan,Roosevelt Park,3806,1167,1199,539,20,294,3219
Michigan,Wolverine Lake village,4582,1015,2185,403,21,238,3862
Michigan,Fenton,11336,2362,4586,1486,70,784,9288
Michigan,Lake Linden village,1078,315,420,124,8,55,922
Michigan,Hardwood Acres,423,22,220,21,0,0,263
Michigan,Port Huron,29175,8885,8455,4201,497,1451,23489
Michigan,Henderson,327,61,166,31,0,17,275
Michigan,Manchester village,2037,444,861,287,0,91,1683
Michigan,Ypsilanti,20939,13175,3394,1218,233,564,18584
Michigan,Ecorse,9372,3568,1353,1141,392,878,7332
Michigan,Hamtramck,21941,6667,7580,875,209,696,16027
Michigan,Beverly Hills village,10440,1923,5257,777,50,509,8516
Michigan,Birmingham,21066,4168,10060,1741,59,779,16807
Michigan,Lake Orion village,3131,676,1350,367,27,213,2633
Michigan,Milford village,6484,1363,2861,844,22,227,5317
Michigan,Novi,59625,12608,28244,3693,352,2799,47696
Michigan,Oxford village,3553,807,1527,511,18,84,2947
Michigan,Kingston village,405,89,166,44,13,10,322
Michigan,Middleville village,3397,530,1422,285,34,127,2398
Michigan,Dowagiac,5779,1828,1363,842,46,359,4438
Michigan,Litchfield,1291,318,507,174,3,19,1021
Michigan,Reading,1090,257,416,110,12,49,844
Michigan,Waldron village,494,91,229,33,7,29,389
Michigan,Hancock,4577,1470,1619,553,26,388,4056
Michigan,Williamston,3930,1093,1603,295,29,168,3188
Michigan,Lambertville,9394,1731,4617,810,40,486,7684
Michigan,Middletown,799,226,347,102,0,11,686
Michigan,Maybee village,667,155,301,43,3,12,514
Michigan,Lennon village,541,145,210,38,4,17,414
Michigan,Byron village,480,104,219,61,10,9,403
Michigan,Augusta village,918,196,347,110,22,57,732
Michigan,South Lyon,11786,2445,5015,1436,52,670,9618
Michigan,Climax village,759,163,348,84,0,36,631
Michigan,Camden village,700,143,227,96,1,18,485
Michigan,Laurium village,2179,582,834,243,11,115,1785
Michigan,Edgemont Park,2287,719,949,216,8,86,1978
Michigan,Lansing,116699,41963,31257,14237,1235,4806,93498
Michigan,Walled Lake,7193,2132,2256,1360,106,398,6252
Michigan,Goodrich village,1941,374,821,181,15,103,1494
Michigan,Lake Fenton,5331,1091,2375,557,68,431,4522
Michigan,Standish,1529,418,466,275,6,112,1277
Michigan,Twining village,201,64,58,22,0,10,154
Michigan,Greenville,8394,2089,2537,1186,111,678,6601
Michigan,Allegan,5044,1356,1767,470,88,219,3900
Michigan,Plainwell,3802,610,1752,512,0,167,3041
Michigan,Marshall,7021,1598,2481,888,75,687,5729
Michigan,Tekonsha village,684,182,214,110,17,41,564
Michigan,Benton Heights,4263,1518,762,376,39,147,2842
Michigan,Manistique,2941,718,929,471,82,266,2466
Michigan,Milan,5944,1318,2127,812,23,178,4458
Michigan,Petersburg,1194,255,518,103,19,52,947
Michigan,North Muskegon,3789,664,1696,391,27,232,3010
Michigan,Hesperia village,889,203,318,122,27,42,712
Michigan,Eaton Rapids,5216,1197,1843,719,113,356,4228
Michigan,Coopersville,4386,1044,1714,292,40,219,3309
Michigan,Centreville village,1397,364,494,194,48,107,1207
Michigan,Sturgis,10855,2709,3724,1388,222,416,8459
Michigan,Holland,33503,11229,11454,2779,356,1719,27537
Michigan,Norton Shores,24357,5481,10755,2439,78,1312,20065
Michigan,Harvey,1612,530,473,199,0,113,1315
Michigan,Leslie,1995,443,720,225,70,61,1519
Michigan,Palmer,486,122,208,36,6,22,394
Michigan,St. Helen,2681,528,1175,501,16,179,2399
Michigan,Forestville village,77,13,42,3,0,9,67
Michigan,Okemos,23912,7514,9743,1562,59,813,19691
Michigan,Detroit Beach,2021,528,854,207,0,75,1664
Michigan,Twin Lake,1751,299,1117,46,0,71,1533
Michigan,Spring Lake village,2563,447,1241,207,16,185,2096
Michigan,Posen village,223,40,75,31,0,30,176
Michigan,Westland,82120,24107,27856,10114,1193,5120,68390
Michigan,Lake City,883,196,322,66,16,79,679
Michigan,Marion village,798,169,276,99,19,73,636
Michigan,Taylor,61574,17740,19934,7431,872,3633,49610
Michigan,Riverview,12167,3012,4768,1601,50,1201,10632
Michigan,Houghton Lake,3544,757,1264,754,34,247,3056
Michigan,Grand Haven,10974,2212,5254,1135,95,710,9406
Michigan,Flushing,8012,1623,3625,781,91,574,6694
Michigan,Akron village,444,127,178,39,11,19,374
Michigan,Unionville village,513,116,235,75,0,11,437
Michigan,Pentwater village,838,132,475,60,7,62,736
Michigan,Shelby village,2220,462,880,206,43,90,1681
Michigan,Walkerville village,225,46,74,27,2,5,154
Michigan,Marquette,20932,10815,5191,1812,146,981,18945
Michigan,Hudsonville,7344,1347,3428,418,30,353,5576
Michigan,Rockwood,3202,792,1332,273,16,258,2671
Michigan,Essexville,3357,903,1256,365,0,245,2769
Michigan,Woodhaven,12551,3148,5350,1382,133,562,10575
Michigan,Lexington village,984,179,416,177,6,122,900
Michigan,Marlette,1874,458,602,242,51,96,1449
Michigan,Whitehall,2730,621,987,403,25,279,2315
Michigan,Copemish village,153,34,57,19,6,24,140
Michigan,Custer village,281,57,101,33,0,20,211
Michigan,Ishpeming,6482,1575,2187,1004,76,448,5290
Michigan,Negaunee,4563,902,1955,417,12,253,3539
Michigan,West Ishpeming,2837,454,1499,338,21,98,2410
Michigan,Ferrysburg,3003,391,1637,255,82,233,2598
Michigan,Wyandotte,25138,6902,9545,2969,274,1506,21196
Michigan,Daggett village,215,37,107,27,1,4,176
Michigan,St. Clair Shores,59781,15829,23748,6609,287,4199,50672
Michigan,Lowell,4060,794,1687,465,25,196,3167
Michigan,Pilgrim,27,13,10,0,0,4,27
Michigan,Ponshewaing,54,0,46,8,0,0,54
Michigan,Presque Isle Harbor,590,49,422,47,4,39,561
Michigan,Rapid City,1465,300,716,117,6,88,1227
Michigan,St. James,162,32,69,21,0,28,150
Michigan,Sand Lake,1553,240,774,176,26,154,1370
Michigan,Snover,460,70,173,83,0,27,353
Michigan,South Boardman,557,124,235,57,10,7,433
Michigan,Stronach,182,51,62,12,8,20,153
Michigan,Village of Grosse Pointe Shores,2860,451,1600,139,0,209,2399
Michigan,Vineyard Lake,694,131,328,95,9,55,618
Michigan,Wacousta,1637,321,804,106,0,108,1339
Michigan,Walloon Lake,274,41,144,44,0,31,260
Michigan,Watersmeet,459,65,246,17,0,26,354
Michigan,Wedgewood,221,45,145,0,5,6,201
Michigan,Wellston,244,63,125,9,0,19,216
Michigan,White Pine,434,100,209,56,2,36,403
Michigan,Zeba,432,125,131,55,0,32,343
Michigan,Dexter,4603,841,1772,459,79,190,3341
Michigan,Parkdale,680,102,309,120,1,81,613
Michigan,Omena,239,44,127,6,5,14,196
Michigan,Oden,299,117,101,18,0,15,251
Michigan,Oak Hill,756,211,275,70,0,49,605
Michigan,Hickory Corners,256,98,88,65,0,0,251
Michigan,Jasper,381,90,111,49,0,18,268
Michigan,Horton Bay,552,118,294,60,3,23,498
Michigan,Interlochen,361,49,199,51,0,2,301
Michigan,Ironton,107,13,46,11,0,17,87
Michigan,Jennings,315,68,53,80,26,10,237
Michigan,K. I. Sawyer,3094,784,783,524,25,86,2202
Michigan,Lake Leelanau,126,6,100,9,0,0,115
Michigan,Lake Victoria,781,171,440,71,0,32,714
Michigan,Ovid,1903,474,597,228,23,152,1474
Michigan,Leland,312,53,122,78,0,28,281
Michigan,Loomis,172,55,62,38,0,10,165
Michigan,Lupton,313,89,92,59,3,48,291
Michigan,Manistee Lake,510,81,186,90,0,39,396
Michigan,Maple City,136,35,40,33,0,3,111
Michigan,Maple Grove,74,0,57,0,0,17,74
Michigan,Marenisco,172,24,94,19,2,8,147
Michigan,Nessen City,65,6,29,12,2,4,53
Michigan,New Troy,738,154,184,108,20,50,516
Michigan,Norwood,172,13,104,18,0,3,138
Michigan,Levering,181,71,50,19,3,0,143
Michigan,Haring,509,140,170,158,0,0,468
Michigan,Bay Shore,748,215,284,94,0,8,601
Michigan,Caseville,711,118,279,158,4,97,656
Michigan,St. Ignace,2257,503,776,412,24,229,1944
Michigan,Eastlake village,454,102,188,68,0,41,399
Michigan,Fountain village,194,38,63,26,0,13,140
Michigan,Free Soil village,87,24,35,10,0,12,81
Michigan,Trowbridge Park,2270,777,920,158,0,136,1991
Michigan,Maple Rapids village,633,201,284,28,13,26,552
Michigan,Spring Arbor,2634,1307,849,133,0,177,2466
Michigan,Burr Oak village,774,176,268,91,13,30,578
Michigan,Fowler village,1357,347,610,64,0,84,1105
Michigan,Bay City,33463,10026,10631,4558,358,1663,27236
Michigan,Le Roy village,298,66,125,12,8,16,227
Michigan,Reed City,2625,714,707,429,24,191,2065
Michigan,Auburn,1947,516,800,201,16,138,1671
Michigan,Pinconning,1424,439,345,252,11,93,1140
Michigan,Gaastra,331,60,166,26,2,26,280
Michigan,Kalamazoo,76040,37461,16746,6356,908,2498,63969
Michigan,Parchment,1969,600,574,266,21,89,1550
Michigan,Grant,907,197,296,83,28,104,708
Michigan,Kent City village,1059,258,363,119,17,38,795
Michigan,Mackinac Island,960,438,323,58,10,45,874
Michigan,Carsonville village,517,115,202,61,7,19,404
Michigan,Temperance,8798,1946,4363,619,28,473,7429
Michigan,South Rockwood village,1828,493,791,221,7,67,1579
Michigan,Lakes of the North,866,156,524,52,18,53,803
Michigan,Jonesville,2403,682,798,216,68,194,1958
Michigan,Ontonagon village,1551,336,705,174,24,149,1388
Michigan,Constantine village,2021,434,793,229,22,98,1576
Michigan,Bancroft village,530,70,230,51,10,13,374
Michigan,Morrice village,1210,211,550,46,18,68,893
Michigan,Vernon village,715,161,331,82,9,28,611
Michigan,Perrinton village,621,151,169,94,3,26,443
Michigan,St. Louis,7198,3374,1738,898,110,289,6409
Michigan,Caro,4064,944,1275,715,50,406,3390
Michigan,Kingsley village,1498,380,586,145,9,25,1145
Michigan,Beulah village,211,81,79,32,0,15,207
Michigan,Port Austin village,699,198,280,101,7,71,657
Michigan,Port Hope village,217,33,136,7,0,27,203
Michigan,Sebewaing village,1510,274,744,198,29,140,1385
Michigan,New Era village,439,78,232,35,4,21,370
Michigan,Freeport village,472,105,196,36,1,15,353
Michigan,Carleton village,2399,565,862,298,17,134,1876
Michigan,Dundee village,4133,891,1611,663,19,225,3409
Michigan,Luna Pier,1236,211,499,227,20,65,1022
Michigan,Harbor Beach,1943,500,703,221,6,147,1577
Michigan,New Haven village,4751,1432,1450,430,0,233,3545
Michigan,Stockbridge village,1349,344,522,129,22,88,1105
Michigan,Eastpointe,32576,12347,8763,2969,508,1387,25974
Michigan,Rosebush village,356,99,119,39,2,32,291
Michigan,Barryton village,445,110,111,93,7,48,369
Michigan,Mecosta village,478,177,160,42,16,16,411
Michigan,Stanwood village,237,52,83,26,6,9,176
Michigan,Bellevue village,1338,383,444,205,7,68,1107
Michigan,Minden City village,166,30,86,9,1,14,140
Michigan,Sandusky,2545,666,802,345,45,260,2118
Michigan,McBain,583,106,232,83,2,89,512
Michigan,Fremont,4060,857,1599,555,0,206,3217
Michigan,Kalkaska village,2217,488,833,318,26,204,1869
Michigan,Northview,15391,3705,6491,1798,64,724,12782
Michigan,Menominee,8214,2061,3019,1116,172,532,6900
Michigan,Lake Odessa village,2154,559,675,244,55,136,1669
Michigan,Muir village,664,179,158,89,21,29,476
Michigan,Saranac village,1432,308,553,220,14,112,1207
Michigan,Clare,3045,700,1223,403,17,158,2501
Michigan,Morley village,489,123,162,81,7,28,401
Michigan,Hubbardston village,328,81,159,23,2,20,285
Michigan,Canada Creek Ranch,297,17,239,11,0,22,289
Michigan,Atlanta,687,113,270,129,0,96,608
Michigan,Cassopolis village,1671,554,490,186,49,91,1370
Michigan,Stanton,1391,419,390,231,10,72,1122
Michigan,Burt,1001,191,454,90,10,69,814
Michigan,L'Anse village,2024,520,681,296,25,133,1655
Michigan,Benzonia village,494,143,153,95,2,26,419
Michigan,Elberta village,167,41,48,18,11,17,135
Michigan,Lake Ann village,208,24,138,30,0,10,202
Michigan,Thompsonville village,526,134,167,61,20,40,422
Michigan,Wakefield,1537,398,584,241,6,173,1402
Michigan,Stevensville village,1079,200,498,127,7,145,977
Michigan,Hemlock,1286,303,384,275,0,157,1119
Michigan,Deerfield village,926,170,416,107,12,28,733
Michigan,Morenci,2501,656,760,296,18,146,1876
Michigan,Martin village,448,97,171,56,10,29,363
Michigan,Saugatuck,850,182,422,94,10,15,723
Michigan,Homer village,1799,445,642,177,41,63,1368
Michigan,Springfield,5208,1743,1603,471,95,268,4180
Michigan,Paw Paw Lake,3605,715,1444,452,42,282,2935
Michigan,St. Joseph,8314,2182,3659,988,98,359,7286
Michigan,Adrian,20640,7672,5359,2496,347,1116,16990
Michigan,Ithaca,2805,614,1170,255,34,120,2193
Michigan,St. Johns,7910,2286,2931,707,102,414,6440
Michigan,Sherwood village,410,98,148,64,3,11,324
Michigan,Grand Blanc,7925,1941,2919,1027,187,475,6549
Michigan,Allen village,262,60,109,28,0,18,215
Michigan,Hubbell,929,170,449,63,5,56,743
Michigan,South Range village,658,169,263,47,12,64,555
Michigan,Estral Beach village,358,82,165,54,0,21,322
Michigan,Monroe,19947,5083,7104,2325,218,1027,15757
Michigan,South Monroe,6176,1503,2209,809,42,632,5195
Michigan,West Monroe,3339,830,1227,311,0,270,2638
Michigan,Eagle village,139,38,56,12,0,6,112
Michigan,Escanaba,12298,3067,4071,2056,229,804,10227
Michigan,Gladstone,4794,1062,1865,566,63,418,3974
Michigan,Baldwin village,1184,497,243,183,66,80,1069
Michigan,Addison village,721,162,225,80,19,20,506
Michigan,Vermontville village,756,138,245,136,7,20,546
Michigan,Flat Rock,9932,2356,3867,993,66,397,7679
Michigan,Hillman village,690,156,262,103,15,83,619
Michigan,Davison,4951,934,1780,925,70,302,4011
Michigan,Hubbard Lake,859,97,553,79,0,84,813
Michigan,Applegate village,290,62,121,29,4,13,229
Michigan,Montgomery village,359,81,131,39,4,15,270
Michigan,Bingham Farms village,1101,188,573,58,3,159,981
Michigan,De Tour Village village,271,26,164,25,2,31,248
Michigan,Alanson village,787,166,304,90,2,36,598
Michigan,Petoskey,5707,1661,1964,766,51,421,4863
Michigan,Benton Harbor,9920,3977,1818,986,220,429,7430
Michigan,Fair Plain,7138,2323,2421,752,131,392,6019
Michigan,Lakewood Club village,1172,205,478,149,38,71,941
Michigan,Republic,458,107,144,54,0,66,371
Michigan,Wayne,17063,5780,5161,2062,245,934,14182
Michigan,Garden village,181,54,74,17,0,14,159
Michigan,Birch Run village,1646,455,572,219,15,120,1381
Michigan,Village of Clarkston,968,177,479,70,6,30,762
Michigan,Chatham village,216,46,75,28,0,27,176
Michigan,Hillsdale,8125,2916,2323,939,71,503,6752
Michigan,Lewiston,1177,248,592,146,0,100,1086
Michigan,Hersey village,309,62,127,34,4,17,244
Michigan,White Cloud,1245,330,337,207,47,52,973
Michigan,Union City village,1683,407,559,215,51,99,1331
Michigan,Lapeer,8731,2737,2366,1425,194,673,7395
Michigan,Clinton village,2428,551,961,250,21,125,1908
Michigan,Vanderbilt village,592,167,175,113,26,46,527
Michigan,Rochester Hills,74011,15732,35862,5484,332,3468,60878
Michigan,Pontiac,60116,22122,13015,6941,1325,2880,46283
Michigan,Hanover village,461,122,138,71,1,11,343
Michigan,Springport village,812,155,289,96,26,28,594
Michigan,Croswell,2543,733,782,426,20,111,2072
Michigan,Melvin village,153,45,49,18,0,27,139
Michigan,Howell,9597,2600,3034,1423,125,665,7847
Michigan,Pinckney village,2488,568,1033,275,26,52,1954
Michigan,Corunna,3374,936,1183,360,44,227,2750
Michigan,Owosso,14604,4511,4655,1588,161,749,11664
Michigan,Perry,2156,497,810,236,55,93,1691
Michigan,Whittemore,469,101,167,56,3,45,372
Michigan,Pewamo village,469,127,186,35,1,26,375
Michigan,Portland,3920,776,1523,320,87,163,2869
Michigan,Mulliken village,526,106,270,47,4,16,443
Michigan,Stephenson,866,205,296,114,20,72,707
Michigan,Buckley village,837,161,292,84,3,37,577
Michigan,Manton,1171,335,335,191,3,57,921
Michigan,Shorewood-Tower Hills-Harbert,1638,264,1099,92,14,84,1553
Michigan,Mio,1848,473,571,386,35,92,1557
Michigan,Dryden village,1110,243,436,114,6,52,851
Michigan,Huntington Woods,6340,1071,3237,355,13,203,4879
Michigan,Elk Rapids village,1490,273,772,155,27,106,1333
Michigan,Caspian,550,163,136,92,0,104,495
Michigan,Weidman,754,236,215,117,0,66,634
Michigan,Potterville,2672,781,968,197,29,103,2078
Michigan,Sunfield village,497,138,193,36,3,21,391
Michigan,Farmington,10590,2577,4776,981,42,507,8883
Michigan,Ferndale,20211,9427,6003,2170,202,478,18280
Michigan,Hazel Park,16592,6663,4266,1949,216,1006,14100
Michigan,Lincoln Park,36883,10982,11443,3894,654,1957,28930
Michigan,Grand Beach village,284,26,192,18,0,32,268
Michigan,Lost Lake Woods,344,10,219,31,3,46,309
Michigan,Galien village,465,157,153,61,4,19,394
Michigan,Lake Michigan Beach,1234,163,602,207,0,42,1014
Michigan,Elsie village,1146,269,430,82,9,97,887
Michigan,Clifford village,298,39,123,51,4,23,240
Michigan,Norway,2786,456,1370,376,13,235,2450
Michigan,Columbiaville village,946,269,283,92,33,44,721
Michigan,Turner village,142,38,51,21,2,5,117
Michigan,Ashley village,551,112,215,86,7,67,487
Michigan,Brighton,7626,2078,3068,789,37,647,6619
Michigan,Michiana village,183,22,117,19,1,16,175
Michigan,Shoreham village,968,173,490,98,2,38,801
Michigan,Boyne City,3750,781,1620,543,20,184,3148
Michigan,Mayville village,920,216,331,139,18,89,793
Michigan,Linden,3882,571,1703,464,22,179,2939
Michigan,Montrose,1540,357,534,201,10,107,1209
Michigan,Mount Morris,2887,946,848,366,41,100,2301
Michigan,Millington village,1014,247,353,123,6,67,796
Michigan,Vassar,2586,758,848,264,20,170,2060
Michigan,Hart,2303,561,687,344,26,137,1755
Michigan,Muskegon Heights,10735,3792,1996,1318,232,569,7907
Michigan,Owendale village,287,85,80,27,0,19,211
Michigan,Wolf Lake,3871,1173,1474,473,48,165,3333
Michigan,Scottville,1235,365,383,202,16,39,1005
Michigan,Zeeland,5581,909,2415,534,0,511,4369
Michigan,Prudenville,1951,404,834,243,36,130,1647
Michigan,Roscommon village,1101,335,221,152,43,89,840
Michigan,Millersburg village,212,47,74,33,2,19,175
Michigan,Franklin village,3332,513,1789,143,10,121,2576
Michigan,Lake Angelus,265,26,195,9,0,13,243
Michigan,Leonard village,350,65,185,25,2,12,289
Michigan,Bear Lake village,177,56,40,26,7,15,144
Michigan,Bloomingdale village,624,168,241,73,5,24,511
Michigan,Elkton village,808,203,265,113,10,51,642
Michigan,Lakeview village,1108,207,428,141,10,95,881
Michigan,Iron Mountain,7406,1867,2861,951,97,352,6128
Michigan,Quinnesec,1017,187,568,138,0,48,941
Michigan,Kinde village,538,98,178,53,12,26,367
Michigan,Pigeon village,1289,206,522,164,10,136,1038
Michigan,Chesaning village,2390,638,831,286,0,118,1873
Michigan,Big Rapids,10392,6397,1614,865,58,330,9264
Michigan,Olivet,1636,885,313,146,7,41,1392
Michigan,Waverly,24546,7157,9976,2716,277,1110,21236
Michigan,Belding,5737,1228,2004,790,34,339,4395
Michigan,Mount Clemens,16358,6036,4215,2325,315,1004,13895
Michigan,Roseville,47603,15547,14159,5902,674,3034,39316
Michigan,Utica,4945,1425,1830,614,6,401,4276
Michigan,Rockford,6186,1159,2656,604,14,186,4619
Michigan,Capac village,1928,580,706,219,6,90,1601
Michigan,Emmett village,262,76,106,18,2,12,214
Michigan,Fraser,14638,3581,5968,1537,98,923,12107
Michigan,Cadillac,10394,2359,3696,1281,166,698,8200
Michigan,Harrietta village,175,33,91,12,0,9,145
Michigan,Grand Ledge,7805,1960,2975,900,21,518,6374
Michigan,Harrisville,396,102,140,59,6,55,362
Michigan,Fowlerville village,2874,564,1186,399,2,120,2271
Michigan,New Lothrop village,681,160,298,26,3,37,524
Michigan,Dansville village,641,111,258,70,4,33,476
Michigan,Muskegon,37969,14010,8621,5651,562,2151,30995
Michigan,Almont village,2761,670,1115,297,42,160,2284
Michigan,Blissfield village,3194,770,1185,428,28,124,2535
Michigan,East Lansing,48374,34674,8008,1735,79,1077,45573
Michigan,Jenison,17794,2967,8979,954,54,1262,14216
Michigan,Webberville village,1224,262,557,117,0,46,982
Michigan,Romulus,23515,6935,7318,2433,381,1313,18380
Michigan,Ludington,8057,1787,3020,1103,80,649,6639
Michigan,Warren,135192,41256,47143,12951,1771,8195,111316
Michigan,Beal City,488,99,227,36,0,23,385
Michigan,Mancelona village,1486,382,373,243,28,87,1113
Michigan,Barton Hills village,287,39,176,24,0,15,254
Michigan,Saline,9223,2401,3949,783,96,475,7704
Michigan,Quincy village,1454,286,607,147,5,71,1116
Michigan,Cement City village,524,134,187,77,18,22,438
Michigan,Harrison,2159,679,729,300,10,161,1879
Michigan,Reese village,1390,333,550,123,32,126,1164
Michigan,Rogers City,2693,679,1175,249,22,204,2329
Michigan,Michigamme,240,27,133,27,1,21,209
Michigan,New Buffalo,1634,453,664,192,5,150,1464
Michigan,Portage,48421,12171,20605,4209,303,1945,39233
Michigan,Richland village,741,116,357,79,6,59,617
Michigan,South Gull Lake,1158,170,631,113,0,111,1025
Michigan,Grandville,15952,3627,6635,1492,141,791,12686
Michigan,Sand Lake village,532,112,172,72,3,34,393
Michigan,Wyoming,75532,21050,26508,7744,826,2862,58990
Michigan,Marine City,4125,965,1708,532,51,270,3526
Michigan,Marysville,9739,1975,4408,1012,7,562,7964
Michigan,Harbor Springs,1129,253,450,148,1,179,1031
Michigan,Memphis,1173,329,451,156,3,52,991
Michigan,Northport village,459,70,258,46,0,51,425
Michigan,Bloomfield Hills,4009,801,2019,211,44,246,3321
Michigan,Sylvan Lake,1798,401,765,279,18,59,1522
Michigan,Otisville village,977,204,346,144,3,43,740
Michigan,Munising,2242,583,716,331,45,181,1856
Michigan,Gwinn,2145,449,1052,269,0,114,1884
Michigan,Wixom,13870,4011,5462,1448,54,411,11386
Michigan,Parma village,598,131,267,44,2,14,458
Michigan,Au Sable,1324,289,470,171,40,143,1113
Michigan,Mackinaw City village,855,237,356,92,8,65,758
Michigan,Michigan Center,4741,890,2357,559,20,141,3967
Michigan,Napoleon,1018,298,416,34,14,50,812
Michigan,Belleville,3898,802,1411,630,54,284,3181
Michigan,Dearborn Heights,56089,15593,20294,4879,748,3354,44868
Michigan,Gibraltar,4529,1034,1962,571,36,209,3812
Michigan,Grosse Pointe Farms,9224,1500,4876,364,13,365,7118
Michigan,Highland Park,10915,5060,1410,1224,188,792,8674
Michigan,Northville,5971,1015,2823,736,0,337,4911
Michigan,Bangor,1773,506,578,195,9,108,1396
Michigan,Ann Arbor,120641,60063,36841,7266,496,2853,107519
Michigan,Paw Paw village,3398,799,1011,621,70,119,2620
Michigan,Beechwood,3450,891,1118,343,84,80,2516
Michigan,Berkley,15360,3973,6219,1735,120,569,12616
Michigan,Allendale,20776,11122,5486,541,42,377,17568
Michigan,River Rouge,7536,3012,2032,649,214,300,6207
Michigan,Trenton,18368,4355,7660,2123,156,1372,15666
Michigan,Kentwood,51525,15362,18519,4652,716,2149,41398
Michigan,Armada village,1796,339,788,174,9,173,1483
Michigan,Vicksburg village,3172,659,1379,266,69,94,2467
Michigan,Grand Rapids,197081,73943,57752,16333,2294,8340,158662
Michigan,Plymouth,9054,2213,4010,832,32,451,7538
Michigan,Comstock Northwest,6144,1939,2084,509,102,321,4955
Michigan,Mattawan village,2333,559,814,275,20,99,1767
Michigan,Laingsburg,1273,295,565,77,3,59,999
Michigan,Port Sanilac village,604,105,317,69,8,53,552
Michigan,Honor village,240,60,85,26,0,31,202
Michigan,Bessemer,1890,475,774,178,29,133,1589
Michigan,Midland,41963,9895,17991,4134,388,1892,34300
Michigan,Sanford village,743,188,309,153,2,33,685
Michigan,Carson City,1097,307,266,141,52,96,862
Michigan,Edmore village,1297,321,453,184,21,73,1052
Michigan,Pierson village,189,65,39,29,0,8,141
Michigan,Lawrence village,974,269,254,161,16,34,734
Michigan,Sheridan village,656,137,268,74,13,40,532
Michigan,Merrill village,720,181,278,63,2,48,572
Michigan,Dearborn,95089,24261,36482,5933,958,4398,72032
Michigan,Detroit,677155,294874,121103,65686,17505,36552,535720
Michigan,Grosse Pointe Woods,15559,3014,8080,850,57,817,12818
Michigan,Inkster,24615,8874,4778,2692,475,1263,18082
Michigan,Gobles,781,161,298,89,9,52,609
Michigan,East Jordan,2341,486,955,282,20,153,1896
Michigan,Cheboygan,4726,1108,1851,535,35,391,3920
Michigan,Frankenmuth,5147,1023,2371,388,0,573,4355
Michigan,New Baltimore,12365,2388,5703,1116,69,481,9757
Michigan,Iron River,2856,697,870,538,14,300,2419
Michigan,Eastwood,5858,2101,1401,945,130,146,4723
Michigan,Jackson,32800,10344,8306,4679,446,1382,25157
Michigan,Tawas City,1795,491,619,242,8,195,1555
Michigan,Mesick village,358,62,151,65,9,21,308
Michigan,East Tawas,2732,487,1129,566,28,184,2394
Michigan,Oscoda,748,137,203,219,31,72,662
Michigan,Empire village,262,64,118,43,2,14,241
Michigan,Greilickville,1717,259,926,127,0,162,1474
Michigan,Suttons Bay village,514,61,291,60,3,48,463
Michigan,Lyons village,919,281,304,71,23,42,721
Michigan,Charlotte,9091,2210,3136,1268,158,579,7351
Michigan,Dimondale village,1266,294,603,66,33,61,1057
Michigan,Big Bay,183,39,87,41,0,12,179
Michigan,Buchanan,4351,874,1526,663,0,314,3377
Michigan,Coloma,1658,384,568,188,24,95,1259
Michigan,Whitmore Lake,6771,1735,2655,770,111,170,5441
Michigan,Coldwater,12284,3308,3713,1902,247,791,9961
Michigan,Bellaire village,958,230,411,99,20,55,815
Michigan,Grayling,1846,509,513,296,37,144,1499
Michigan,North Branch village,944,206,367,149,14,60,796
Michigan,Imlay City,3581,878,1138,453,46,221,2736
Michigan,Kingsford,5022,1153,2061,573,43,395,4225
Michigan,Fife Lake village,393,84,173,73,0,12,342
Michigan,Decatur village,2001,380,744,217,17,164,1522
Michigan,Lawton village,1613,258,652,220,17,125,1272
Michigan,Alma,9051,3382,2478,1125,43,540,7568
Michigan,Bad Axe,2980,608,1091,452,37,229,2417
Michigan,Ubly village,789,189,287,113,6,46,641
Michigan,Buena Vista,6351,2092,943,979,178,688,4880
Michigan,Freeland,7125,1915,2766,1005,63,158,5907
Michigan,Concord village,1171,239,418,138,0,67,862
Michigan,Saginaw,48997,18444,10879,5634,1061,2526,38544
Michigan,Hudson,2465,548,945,274,44,82,1893
Michigan,Barnes Lake-Millers Lake,1194,109,747,104,19,48,1027
Michigan,Manitou Beach-Devils Lake,1730,245,997,225,24,118,1609
Michigan,Baroda village,798,177,306,126,9,51,669
Michigan,Bridgman,2534,540,1139,266,34,153,2132
Michigan,Brownlee Park,1480,419,370,229,55,124,1197
Michigan,Burlington village,282,61,130,26,7,14,238
Michigan,Westphalia village,992,180,491,51,11,53,786
Michigan,St. Charles village,2086,504,790,249,14,156,1713
Michigan,Deckerville village,789,173,288,97,36,79,673
Michigan,Peck village,586,112,242,54,15,39,462
Michigan,Allen Park,27353,6989,11717,2321,191,1606,22824
Michigan,Manistee,6071,1741,2180,772,30,355,5078
Michigan,Onekama village,466,94,182,46,7,22,351
Michigan,Ahmeek village,96,33,13,29,0,9,84
Michigan,Newberry village,1352,322,466,159,15,135,1097
Michigan,Rochester,13130,2989,6056,919,44,683,10691
Michigan,Troy,83881,18416,42249,4821,259,3572,69317
Michigan,Clio,2524,584,753,447,88,288,2160
Michigan,Holly village,6194,1710,2343,731,61,303,5148
Michigan,Kaleva village,475,123,154,96,0,27,400
Michigan,Lathrup Village,4150,958,1941,324,110,180,3513
Michigan,Orchard Lake Village,2456,548,1333,174,6,60,2121
Michigan,Ortonville village,1711,556,537,218,12,57,1380
Michigan,Argentine,2478,488,1142,353,17,113,2113
Michigan,Gaines village,382,88,168,42,10,5,313
Michigan,Swartz Creek,5531,1430,2190,534,71,474,4699
Michigan,Cass City village,2495,476,1139,282,16,200,2113
Michigan,Gagetown village,279,45,138,18,6,36,243
Michigan,Rothbury village,410,132,124,23,4,21,304
Michigan,Oak Park,29849,10943,8458,3241,284,1635,24561
Michigan,Alpha village,146,35,28,42,0,15,120
Michigan,Holt,25536,5842,10055,3038,322,1233,20490
Michigan,Royal Oak,59107,20115,22842,5524,276,2563,51320
Michigan,Livonia,94567,22483,44564,7558,523,5279,80407
Michigan,Melvindale,10419,3213,3015,1013,120,459,7820
Michigan,Auburn Hills,23107,9563,7614,2086,185,793,20241
Michigan,Oakley village,307,48,124,45,2,19,238
Michigan,Tecumseh,8346,2042,3474,1051,0,413,6980
Michigan,Hastings,7284,1731,2764,860,105,446,5906
Michigan,Woodland village,494,122,186,57,8,23,396
Michigan,North Adams village,528,121,205,57,9,21,413
Michigan,Copper City village,222,48,78,36,2,12,176
Michigan,Calumet village,748,209,244,93,22,38,606
Michigan,Shields,5993,1203,2584,692,60,574,5113
Michigan,Luther village,298,78,106,31,14,18,247
Michigan,Athens village,1008,273,377,131,8,43,832
Michigan,Eau Claire village,741,168,263,62,0,13,506
Michigan,Galesburg,2120,512,562,376,35,103,1588
Michigan,Southgate,29268,7363,11511,3528,194,2274,24870
Michigan,Haslett,19721,5350,8267,1918,82,1118,16735
Michigan,Keego Harbor,3196,862,1114,527,55,169,2727
Michigan,Battle Creek,51475,14405,15873,6783,812,2533,40406
Michigan,Casnovia village,365,102,130,20,4,10,266
Minnesota,Buckman,283,110,79,14,0,9,212
Minnesota,Kingston,176,34,72,8,0,10,124
Minnesota,Willernie,378,155,90,54,4,25,328
Minnesota,Birchwood Village,936,168,496,67,9,34,774
Minnesota,Hugo,14587,3058,6694,1273,70,294,11389
Minnesota,Marine on St. Croix,761,127,410,49,3,40,629
Minnesota,Genola,72,25,17,8,0,2,52
Minnesota,Hillman,40,12,13,3,0,3,31
Minnesota,Kinbrae,8,0,6,0,0,0,6
Minnesota,Round Lake,450,109,196,31,3,20,359
Minnesota,Worthington,13148,3640,4529,862,149,671,9851
Minnesota,Cologne,1825,289,858,77,7,38,1269
Minnesota,Waconia,11981,2069,5503,827,86,433,8918
Minnesota,Hokah,617,156,249,53,0,25,483
Minnesota,Truman,1073,271,483,69,25,98,946
Minnesota,Goodview,4105,1276,1651,408,7,149,3491
Minnesota,Oronoco,1486,199,797,68,0,31,1095
Minnesota,Rochester,113913,28457,48042,9048,744,4484,90775
Minnesota,Minnesota City,162,28,84,8,0,2,122
Minnesota,Farmington,22714,4633,9620,1677,72,500,16502
Minnesota,Montevideo,5139,1307,1850,584,80,376,4197
Minnesota,Rice,1556,309,613,129,13,20,1084
Minnesota,Apple Valley,51931,11251,23909,3982,435,1930,41507
Minnesota,Hampton,785,219,272,52,2,12,557
Minnesota,Hendrum,334,74,147,23,0,16,260
Minnesota,Holland,160,32,73,18,5,6,134
Minnesota,Pipestone,4093,717,1681,436,62,353,3249
Minnesota,Trosky,91,15,52,8,0,8,83
Minnesota,Vesta,300,53,128,29,4,27,241
Minnesota,Trimont,754,155,300,87,12,37,591
Minnesota,Raymond,744,173,311,48,3,40,575
Minnesota,Houston,1078,227,411,106,12,89,845
Minnesota,Hinckley,1537,483,361,264,26,100,1234
Minnesota,Mentor,254,33,111,25,3,7,179
Minnesota,Nielsville,122,21,53,9,0,4,87
Minnesota,Trail,58,34,14,3,0,2,53
Minnesota,Andover,32499,7132,15463,2138,218,796,25747
Minnesota,Elysian,631,99,370,42,3,36,550
Minnesota,Kinney,138,21,60,7,2,19,109
Minnesota,Meadowlands,119,29,31,19,5,24,108
Minnesota,Holloway,105,14,52,26,0,2,94
Minnesota,Waldorf,227,38,102,22,3,13,178
Minnesota,Waseca,9056,2413,3434,839,170,481,7337
Minnesota,Cedar Mills,62,7,23,5,0,10,45
Minnesota,Isanti,5565,1402,2053,685,48,35,4223
Minnesota,Harding,142,39,43,22,5,8,117
Minnesota,Royalton,1302,290,547,88,5,68,998
Minnesota,Wilmont,407,88,182,32,12,18,332
Minnesota,Alpha,124,16,52,13,2,11,94
Minnesota,Jackson,3225,760,1453,318,30,201,2762
Minnesota,Prinsburg,517,57,291,9,0,36,393
Minnesota,Regal,53,14,24,3,0,0,41
Minnesota,Montgomery,2936,926,982,308,36,69,2321
Minnesota,Clinton,401,105,144,40,0,40,329
Minnesota,Hermantown,9621,2000,4449,820,56,527,7852
Minnesota,Leonidas,48,3,29,11,0,1,44
Minnesota,Orr,269,96,87,42,2,7,234
Minnesota,Northrop,171,41,72,20,0,21,154
Minnesota,Vineland,832,304,130,60,7,39,540
Minnesota,Bruno,87,10,32,14,1,6,63
Minnesota,Pine City,3072,858,1063,468,63,163,2615
Minnesota,Crookston,7782,2341,2818,463,139,519,6280
Minnesota,East Grand Forks,8635,2024,3256,694,146,586,6706
Minnesota,Lyle,454,109,194,52,0,22,377
Minnesota,Arlington,2342,626,961,153,9,148,1897
Minnesota,Gaylord,1877,375,811,139,12,212,1549
Minnesota,New Auburn,545,81,295,57,0,17,450
Minnesota,Maynard,414,71,176,56,3,11,317
Minnesota,Cosmos,513,101,208,78,8,31,426
Minnesota,Dassel,1518,307,576,177,11,94,1165
Minnesota,Sauk Rapids,13528,3433,5062,1174,160,482,10311
Minnesota,Lilydale,902,96,494,88,2,195,875
Minnesota,Darwin,328,64,136,36,0,19,255
Minnesota,Wrenshall,477,110,202,42,0,16,370
Minnesota,Leonard,33,1,24,2,0,0,27
Minnesota,Shevlin,155,49,57,21,4,4,135
Minnesota,Burnsville,61283,16518,24566,5536,881,2278,49779
Minnesota,Mendota,250,88,96,17,0,6,207
Minnesota,Belle Plaine,7029,1541,2967,514,22,291,5335
Minnesota,Vermillion,498,113,254,18,1,18,404
Minnesota,Oak Grove,8582,1832,4260,674,44,218,7028
Minnesota,St. Francis,7551,1923,2891,667,63,170,5714
Minnesota,Annandale,3349,470,1532,356,13,217,2588
Minnesota,Delano,5959,1009,2649,417,10,320,4405
Minnesota,Cook,496,97,149,74,3,118,441
Minnesota,Virginia,8531,2437,2696,1196,170,771,7270
Minnesota,Byron,5366,987,2432,340,0,130,3889
Minnesota,Ellendale,777,154,286,84,0,67,591
Minnesota,Breckenridge,3246,828,1222,325,53,235,2663
Minnesota,Wolverton,150,16,84,6,0,6,112
Minnesota,Dexter,308,50,146,67,2,9,274
Minnesota,Woodstock,113,21,58,8,6,2,95
Minnesota,Verndale,557,158,193,51,10,23,435
Minnesota,Mounds View,12959,3604,4678,1359,115,458,10214
Minnesota,Fosston,1604,353,586,190,3,166,1298
Minnesota,Shakopee,40418,9434,16337,2964,382,1180,30297
Minnesota,Anoka,17419,5042,5952,2036,276,1099,14405
Minnesota,Babbitt,1460,273,675,186,0,159,1293
Minnesota,Tower,445,106,190,16,10,39,361
Minnesota,Otsego,16189,2937,7690,904,36,445,12012
Minnesota,Brookston,119,32,43,14,0,12,101
Minnesota,Ely,3398,887,1367,422,90,266,3032
Minnesota,Proctor,3059,646,1402,270,24,204,2546
Minnesota,Dunnell,187,50,80,18,1,10,159
Minnesota,Welcome,714,125,324,62,8,35,554
Minnesota,Cokato,2714,621,949,265,52,227,2114
Minnesota,Buhl,1052,285,405,147,14,86,937
Minnesota,Chisholm,4934,997,1777,573,40,370,3757
Minnesota,Duluth,86004,31611,28636,8276,484,4063,73070
Minnesota,McKinley,172,31,82,11,0,4,128
Minnesota,Winton,122,41,50,17,0,1,109
Minnesota,Underwood,387,50,192,41,3,23,309
Minnesota,Akeley,341,69,128,46,16,37,296
Minnesota,La Salle,72,19,28,6,0,3,56
Minnesota,Claremont,664,175,207,97,8,19,506
Minnesota,The Lakes,630,78,424,32,0,38,572
Minnesota,Eden Prairie,63900,13413,31685,4169,389,1535,51191
Minnesota,Edina,51136,9739,24601,3777,280,2835,41232
Minnesota,North Mankato,13704,3171,5984,1171,71,625,11022
Minnesota,Beaver Creek,390,95,221,7,1,3,327
Minnesota,Hills,693,93,365,45,11,53,567
Minnesota,Shoreview,26627,5497,12958,2393,104,1160,22112
Minnesota,Edgerton,1230,164,598,80,11,133,986
Minnesota,Mendota Heights,11284,2223,6005,828,56,524,9636
Minnesota,Finlayson,325,81,103,53,0,24,261
Minnesota,Granada,270,63,115,17,3,19,217
Minnesota,Gonvick,295,65,99,21,1,34,220
Minnesota,Miesville,126,26,64,5,0,11,106
Minnesota,New Trier,92,28,41,9,0,3,81
Minnesota,Perley,63,15,27,5,5,6,58
Minnesota,Randolph,452,67,206,48,0,17,338
Minnesota,Beaver Bay,140,8,93,20,2,8,131
Minnesota,Ada,1820,339,745,185,4,131,1404
Minnesota,Jordan,6155,1604,2249,472,59,212,4596
Minnesota,Henriette,93,36,21,21,0,3,81
Minnesota,Kerrick,70,33,12,7,0,1,53
Minnesota,Clara City,1406,206,692,81,3,122,1104
Minnesota,Lake Lillian,298,69,127,25,1,19,241
Minnesota,New Prague,7746,1704,3228,582,13,380,5907
Minnesota,Gilbert,1902,474,772,249,5,113,1613
Minnesota,Hoyt Lakes,2081,313,1097,268,20,115,1813
Minnesota,Iron Junction,113,17,54,16,1,5,93
Minnesota,Prior Lake,25880,4810,12484,1954,91,777,20116
Minnesota,Audubon,594,163,218,71,13,16,481
Minnesota,Lexington,1953,660,563,319,50,34,1626
Minnesota,Beardsley,197,41,81,26,0,13,161
Minnesota,Graceville,686,74,292,79,5,106,556
Minnesota,Barnesville,2579,474,1096,190,0,158,1918
Minnesota,Dilworth,4370,721,2071,352,39,166,3349
Minnesota,Watson,185,36,75,18,2,9,140
Minnesota,Monticello,13439,3019,5239,1472,67,402,10199
Minnesota,Montrose,3136,621,1203,316,19,56,2215
Minnesota,Ceylon,332,91,132,26,7,23,279
Minnesota,Eveleth,3633,1423,1039,369,47,153,3031
Minnesota,Ramsey,26225,5799,12218,1638,236,596,20487
Minnesota,White Earth,571,252,50,55,0,50,407
Minnesota,Randall,663,148,213,91,1,20,473
Minnesota,Hanover,3298,476,1590,173,0,67,2306
Minnesota,Grove City,643,168,197,64,6,39,474
Minnesota,Correll,48,17,16,3,2,3,41
Minnesota,Elbow Lake,82,15,26,6,0,13,60
Minnesota,Hitterdal,182,26,104,18,0,8,156
Minnesota,Sabin,639,101,304,49,0,14,468
Minnesota,Blaine,63319,13592,28493,4897,437,2221,49640
Minnesota,Centerville,3962,720,1817,241,24,106,2908
Minnesota,Circle Pines,4954,1108,2159,549,62,156,4034
Minnesota,Coon Rapids,62376,15769,24936,6467,951,2840,50963
Minnesota,Sunfish Lake,557,131,321,19,0,7,478
Minnesota,West St. Paul,19750,6261,6800,1904,279,964,16208
Minnesota,Silver Bay,1748,312,917,139,9,143,1520
Minnesota,Hatfield,31,7,16,2,0,0,25
Minnesota,Two Harbors,3541,799,1274,492,82,319,2966
Minnesota,Gary,280,80,125,17,0,5,227
Minnesota,Halstad,632,145,229,62,14,74,524
Minnesota,Denham,33,5,12,11,0,1,29
Minnesota,Rutledge,165,39,70,20,0,17,146
Minnesota,Climax,277,52,88,48,11,10,209
Minnesota,Fertile,1089,264,413,113,11,114,915
Minnesota,Fisher,504,113,183,27,6,30,359
Minnesota,Gully,67,33,17,0,3,3,56
Minnesota,McIntosh,619,116,208,96,10,95,525
Minnesota,Detroit Lakes,9134,2315,3270,996,52,790,7423
Minnesota,Pine Point,384,145,37,12,43,14,251
Minnesota,Columbia Heights,19958,6342,6233,2232,379,1076,16262
Minnesota,Altura,509,109,229,18,5,16,377
Minnesota,Bovey,814,147,294,104,7,49,601
Minnesota,Roscoe,107,15,47,16,1,9,88
Minnesota,Wolf Lake,9,4,0,2,0,1,7
Minnesota,East Bethel,11808,2729,6048,662,40,268,9747
Minnesota,Ham Lake,16282,3169,8309,1149,99,408,13134
Minnesota,Fridley,27614,7882,9925,2527,371,1193,21898
Minnesota,Roosevelt,131,23,62,5,5,5,100
Minnesota,Roseau,2679,612,1126,278,0,205,2221
Minnesota,Battle Lake,690,140,310,66,4,108,628
Minnesota,New York Mills,1310,330,414,153,17,73,987
Minnesota,Ottertail,480,80,259,59,0,24,422
Minnesota,Parkers Prairie,1007,156,414,73,3,151,797
Minnesota,Gem Lake,489,71,234,38,2,13,358
Minnesota,Cambridge,8587,1889,2887,1131,125,647,6679
Minnesota,Humboldt,33,0,15,5,0,0,20
Minnesota,Dawson,1701,310,786,93,41,168,1398
Minnesota,Madison,1540,305,693,166,13,172,1349
Minnesota,Flensburg,229,51,108,12,6,8,185
Minnesota,Little Falls,8664,2008,3307,871,45,687,6918
Minnesota,Motley,636,166,193,115,8,49,531
Minnesota,Pierz,1528,283,598,165,9,146,1201
Minnesota,Sobieski,195,39,98,9,0,13,159
Minnesota,Crystal,22934,7061,8170,2506,311,993,19041
Minnesota,Deephaven,3864,497,2032,245,17,166,2957
Minnesota,Greenfield,2960,506,1634,138,5,83,2366
Minnesota,Maple Plain,1844,352,724,216,26,102,1420
Minnesota,Rockford,4585,1116,1989,295,49,81,3530
Minnesota,St. Louis Park,48423,17104,17244,4221,546,1993,41108
Minnesota,Brainerd,13389,4281,3390,1929,164,828,10592
Minnesota,Lino Lakes,21150,4800,10186,1442,130,448,17006
Minnesota,Paynesville,2482,556,935,230,72,224,2017
Minnesota,Lake Park,745,181,239,71,6,30,527
Minnesota,Winger,195,38,70,26,0,8,142
Minnesota,Farwell,27,4,12,6,0,3,25
Minnesota,Westport,38,14,14,3,0,4,35
Minnesota,Dundas,1555,193,735,115,14,35,1092
Minnesota,Sleepy Eye,3414,652,1557,293,0,227,2729
Minnesota,Williams,120,47,40,11,0,15,113
Minnesota,Naytahwaush,420,165,38,32,2,23,260
Minnesota,Luverne,4561,840,2002,333,52,281,3508
Minnesota,Steen,208,52,75,13,0,8,148
Minnesota,Wheaton,1491,280,655,141,9,172,1257
Minnesota,Porter,193,61,89,6,0,17,173
Minnesota,Mantorville,1082,290,493,74,8,30,895
Minnesota,Browerville,909,226,390,89,2,35,742
Minnesota,Osakis,1707,310,694,221,24,161,1410
Minnesota,Staples,3029,677,1147,370,109,169,2472
Minnesota,Belgrade,1012,186,408,90,14,71,769
Minnesota,Clearwater,1776,393,737,142,18,43,1333
Minnesota,Cold Spring,4117,786,1568,346,0,366,3066
Minnesota,Holdingford,570,89,243,65,3,43,443
Minnesota,St. Anthony city (Stearns County),115,23,58,1,0,0,82
Minnesota,St. Rosa,41,24,16,0,0,1,41
Minnesota,Cohasset,2724,482,1358,227,15,186,2268
Minnesota,Deer River,954,197,381,113,2,58,751
Minnesota,Warba,134,16,65,17,1,4,103
Minnesota,Zemple,124,29,44,17,3,8,101
Minnesota,Lafayette,499,117,206,49,3,16,391
Minnesota,Mankato,41701,19359,11950,2573,285,1442,35609
Minnesota,Erskine,438,75,193,57,0,49,374
Minnesota,Savage,30615,6543,14296,1726,234,589,23388
Minnesota,Nassau,63,10,33,5,0,5,53
Minnesota,Stockton,755,204,303,49,2,29,587
Minnesota,Cottage Grove,36221,7939,16658,2232,236,1037,28102
Minnesota,Foreston,553,160,186,77,2,6,431
Minnesota,Bock,92,31,16,13,9,6,75
Minnesota,Milaca,2876,667,1043,275,36,305,2326
Minnesota,Renville,1380,359,582,46,7,117,1111
Minnesota,Excelsior,2448,755,894,335,11,102,2097
Minnesota,Medicine Lake,422,105,183,45,0,11,344
Minnesota,Minnetrista,7408,1044,4161,220,80,138,5643
Minnesota,Arco,98,16,27,15,0,9,67
Minnesota,Ivanhoe,563,94,290,59,0,63,506
Minnesota,Tyler,1381,214,570,122,14,137,1057
Minnesota,Fergus Falls,13647,3138,5726,1184,203,1157,11408
Minnesota,Richville,99,26,46,3,0,5,80
Minnesota,Karlstad,825,233,277,67,3,80,660
Minnesota,Redby,1428,587,104,104,6,52,853
Minnesota,Wells,2321,478,910,130,18,222,1758
Minnesota,Oslo,237,55,96,30,0,12,193
Minnesota,Brooklyn Park,79792,21656,29790,5453,1123,2659,60681
Minnesota,Woodland,407,46,274,25,2,3,350
Minnesota,Chanhassen,25357,4828,13097,1418,123,564,20030
Minnesota,Minnetonka Beach,632,74,369,31,4,12,490
Minnesota,Tonka Bay,1410,269,779,98,3,49,1198
Minnesota,Vergas,355,82,144,36,3,37,302
Minnesota,Lake City,5165,963,2418,499,26,517,4423
Minnesota,Lewisville,238,53,87,34,1,24,199
Minnesota,Center City,650,154,356,51,2,19,582
Minnesota,North Branch,10321,2263,4556,976,40,450,8285
Minnesota,Minnesota Lake,625,123,323,68,0,27,541
Minnesota,Donaldson,14,3,4,7,0,0,14
Minnesota,St. Cloud,67513,26205,20776,6357,560,2432,56330
Minnesota,Freeport,815,141,391,8,0,46,586
Minnesota,Richmond,1568,376,665,98,13,98,1250
Minnesota,Dovray,57,6,32,7,4,4,53
Minnesota,Spring Lake Park,6459,1578,2341,791,142,424,5276
Minnesota,Albertville,7377,1089,3187,735,71,98,5180
Minnesota,Shelly,134,44,48,18,0,13,123
Minnesota,Vining,54,7,25,4,0,4,40
Minnesota,Mazeppa,850,135,394,87,4,32,652
Minnesota,Brooklyn Center,30899,9641,9578,2362,326,1262,23169
Minnesota,Long Beach,309,27,210,16,0,10,263
Minnesota,Butterfield,586,145,237,45,5,33,465
Minnesota,Madelia,2690,644,1003,125,70,208,2050
Minnesota,West Concord,873,158,368,59,10,28,623
Minnesota,Newfolden,358,102,153,25,1,12,293
Minnesota,East Gull Lake,950,186,528,79,0,34,827
Minnesota,Hackensack,244,69,61,41,10,17,198
Minnesota,Pillager,447,97,172,57,2,12,340
Minnesota,Plato,281,56,130,23,0,17,226
Minnesota,Cannon Falls,4064,947,1690,407,65,219,3328
Minnesota,Evan,67,10,25,21,0,2,58
Minnesota,Goodhue,1175,221,530,87,0,30,868
Minnesota,Northome,227,48,114,25,0,17,204
Minnesota,Ranier,646,149,248,92,3,93,585
Minnesota,Mahnomen,1222,389,339,122,5,116,971
Minnesota,Chandler,341,59,172,21,10,13,275
Minnesota,Wood Lake,453,102,221,30,1,14,368
Minnesota,Ponemah,610,275,39,49,0,14,377
Minnesota,Tenstrike,205,20,102,17,0,19,158
Minnesota,Kandiyohi,593,128,264,21,10,12,435
Minnesota,Red Lake Falls,1509,305,713,105,5,66,1194
Minnesota,Milan,360,119,131,15,11,20,296
Minnesota,Okabena,263,39,134,27,1,10,211
Minnesota,Bejou,75,21,30,4,0,9,64
Minnesota,St. Leo,122,35,49,19,4,10,117
Minnesota,Onamia,949,274,284,89,12,96,755
Minnesota,Kenyon,1983,439,771,172,30,162,1574
Minnesota,Dumont,104,27,63,1,0,1,92
Minnesota,Zumbrota,3395,460,1403,494,19,282,2658
Minnesota,Littlefork,654,95,266,72,7,101,541
Minnesota,Hadley,62,13,32,5,0,7,57
Minnesota,Lake Wilson,226,32,127,27,1,19,206
Minnesota,Kenneth,63,7,23,25,1,1,57
Minnesota,Hazel Run,46,6,21,9,0,6,42
Minnesota,Elmore,470,118,156,86,4,40,404
Minnesota,Greenwald,275,68,123,10,1,6,208
Minnesota,Long Prairie,3331,758,1219,286,49,266,2578
Minnesota,Albany,2691,551,980,243,22,292,2088
Minnesota,Eden Valley,968,275,309,118,9,58,769
Minnesota,New Munich,304,57,145,19,1,29,251
Minnesota,Waite Park,7623,2949,2328,492,122,463,6354
Minnesota,Calumet,438,113,150,64,5,23,355
Minnesota,Nashwauk,1119,295,423,132,13,92,955
Minnesota,Nimrod,89,8,42,5,0,15,70
Minnesota,Bloomington,85394,23331,35091,8370,777,4108,71677
Minnesota,Vernon Center,356,70,154,30,4,12,270
Minnesota,Ghent,375,64,193,13,1,12,283
Minnesota,Taunton,146,34,49,26,2,7,118
Minnesota,Chokio,419,77,218,32,0,16,343
Minnesota,New Richland,1156,285,422,154,0,78,939
Minnesota,International Falls,6043,1510,2143,719,201,498,5071
Minnesota,Falcon Heights,5559,1716,2354,274,54,261,4659
Minnesota,Wanamingo,1249,248,538,107,3,64,960
Minnesota,Red Wing,16365,3347,7097,1856,112,944,13356
Minnesota,Pennock,555,124,260,25,6,13,428
Minnesota,Remer,353,100,141,38,5,36,320
Minnesota,Heidelberg,120,30,69,2,0,9,110
Minnesota,Kasota,801,181,306,85,17,39,628
Minnesota,Bena,109,39,21,19,0,3,82
Minnesota,Walker,998,362,280,149,0,60,851
Minnesota,Brownton,728,151,378,49,7,30,615
Minnesota,Good Thunder,603,163,236,57,0,21,477
Minnesota,Spring Valley,2439,441,1008,289,34,180,1952
Minnesota,Funkley,14,3,4,4,0,0,11
Minnesota,Kelliher,281,68,100,52,4,9,233
Minnesota,Wendell,115,16,42,40,0,3,101
Minnesota,Glenville,590,76,350,52,0,41,519
Minnesota,Millville,166,45,86,10,2,6,149
Minnesota,Wabasha,2583,556,1179,254,28,185,2202
Minnesota,Zumbro Falls,246,62,91,22,0,5,180
Minnesota,Ormsby,114,27,49,6,0,9,91
Minnesota,Dodge Center,2708,745,974,242,23,118,2102
Minnesota,Easton,190,22,118,10,6,4,160
Minnesota,Nevis,417,29,205,48,4,33,319
Minnesota,Park Rapids,3998,1061,1467,359,6,289,3182
Minnesota,Storden,273,53,134,19,0,4,210
Minnesota,Cass Lake,646,245,93,88,3,31,460
Minnesota,Glencoe,5495,1202,2032,620,67,420,4341
Minnesota,New Ulm,13248,3368,5737,1118,68,731,11022
Minnesota,Springfield,2056,323,816,227,43,182,1591
Minnesota,Canby,1627,340,729,97,13,165,1344
Minnesota,Avoca,96,12,56,11,0,5,84
Minnesota,Pease,245,61,77,23,1,30,192
Minnesota,Glenwood,2535,447,1016,402,36,259,2160
Minnesota,Rush City,3139,1313,813,343,39,164,2672
Minnesota,Blomkest,143,37,84,11,1,2,135
Minnesota,Scanlon,1157,260,394,125,13,123,915
Minnesota,Caledonia,2769,704,1036,313,14,210,2277
Minnesota,Spring Grove,1331,205,586,141,6,143,1081
Minnesota,Victoria,9032,1377,4891,312,8,78,6666
Minnesota,Strathcona,24,5,17,1,0,0,23
Minnesota,Brewster,479,144,139,70,0,28,381
Minnesota,Dundee,99,24,35,9,0,9,77
Minnesota,Braham,1854,488,547,259,5,107,1406
Minnesota,Cottonwood,1281,260,465,162,8,58,953
Minnesota,Goodridge,156,41,40,33,0,28,142
Minnesota,Morris,5353,2126,1929,197,66,296,4614
Minnesota,Murdock,292,70,126,21,2,3,222
Minnesota,Heron Lake,751,172,306,59,7,60,604
Minnesota,Lakefield,1710,311,679,170,7,144,1311
Minnesota,Cleveland,744,159,340,50,7,23,579
Minnesota,Odessa,108,21,49,10,0,15,95
Minnesota,Deerwood,577,112,198,70,0,43,423
Minnesota,Racine,459,64,193,54,0,18,329
Minnesota,Waltham,132,25,59,10,2,8,104
Minnesota,Little Rock,1137,397,82,118,19,23,639
Minnesota,Evansville,606,149,286,47,6,64,552
Minnesota,Kensington,201,46,78,27,3,18,172
Minnesota,Holt,111,28,52,0,0,3,83
Minnesota,Walters,129,30,31,9,1,11,82
Minnesota,Alvarado,410,76,192,13,2,27,310
Minnesota,Grygla,164,28,74,25,1,4,132
Minnesota,Kiester,491,100,198,57,6,24,385
Minnesota,Middle River,264,45,120,46,0,17,228
Minnesota,Blue Earth,3146,602,1400,406,10,309,2727
Minnesota,Sacred Heart,540,95,154,72,16,40,377
Minnesota,Lakeland,1907,338,980,177,15,65,1575
Minnesota,Lake St. Croix Beach,1029,280,452,123,0,34,889
Minnesota,Aitkin,2282,533,720,263,44,256,1816
Minnesota,McGregor,383,141,85,51,7,47,331
Minnesota,Palisade,233,52,101,15,13,17,198
Minnesota,Lake Crystal,2511,387,1181,190,0,164,1922
Minnesota,Balaton,602,159,244,48,12,31,494
Minnesota,St. Hilaire,213,62,83,27,0,15,187
Minnesota,Erhard,105,24,47,13,3,2,89
Minnesota,Odin,104,11,46,9,4,13,83
Minnesota,Granite Falls,2600,578,1109,294,52,134,2167
Minnesota,Kellogg,502,90,239,43,3,25,400
Minnesota,Warren,1668,360,720,157,3,126,1366
Minnesota,Delavan,277,61,104,33,4,10,212
Minnesota,Winnebago,1355,247,568,176,9,115,1115
Minnesota,Strandquist,84,26,42,11,2,0,81
Minnesota,St. Peter,11784,4896,3665,892,40,454,9947
Minnesota,Grand Marais,1201,259,508,171,11,77,1026
Minnesota,Biscay,106,35,44,14,2,0,95
Minnesota,Silver Lake,889,194,342,71,3,63,673
Minnesota,Dent,191,23,82,19,3,12,139
Minnesota,Perham,3345,813,1101,402,44,255,2615
Minnesota,Miltona,391,64,179,50,0,15,308
Minnesota,Barrett,445,99,169,39,8,38,353
Minnesota,Elbow Lake,1278,255,621,89,17,99,1081
Minnesota,Dennison,157,18,80,10,0,3,111
Minnesota,Lonsdale,3922,714,1607,250,0,55,2626
Minnesota,Hayfield,1356,335,480,174,18,115,1122
Minnesota,Winona,26981,12412,8160,2183,86,1153,23994
Minnesota,Bingham Lake,194,33,95,5,2,4,139
Minnesota,Hammond,75,19,25,13,0,5,62
Minnesota,Doran,23,6,8,5,0,2,21
Minnesota,Bayport,3712,1183,1298,436,65,168,3150
Minnesota,Grant,4138,666,2268,313,24,114,3385
Minnesota,Lakeland Shores,352,65,183,20,0,8,276
Minnesota,Oakdale,28018,8073,10753,2850,234,1163,23073
Minnesota,Taylors Falls,1024,229,435,128,11,26,829
Minnesota,Moose Lake,2823,1274,594,525,51,192,2636
Minnesota,Eitzen,247,73,99,17,0,21,210
Minnesota,Delhi,25,1,11,10,0,3,25
Minnesota,Owatonna,25656,5564,11128,2003,303,1288,20286
Minnesota,Morgan,865,199,283,88,4,91,665
Minnesota,Norwood Young America,3700,815,1702,214,36,191,2958
Minnesota,Hartland,327,76,133,37,5,14,265
Minnesota,Le Roy,1083,224,417,71,6,90,808
Minnesota,Riverton,178,44,59,10,4,3,120
Minnesota,Roseville,35833,10222,14273,2775,177,2618,30065
Minnesota,Rockville,2533,439,1396,93,40,85,2053
Minnesota,Newport,3506,1037,1234,400,54,145,2870
Minnesota,Minneiska,103,13,66,12,2,1,94
Minnesota,St. Vincent,44,11,22,2,0,5,40
Minnesota,Rushmore,359,70,129,38,6,27,270
Minnesota,Hollandale,407,42,219,30,4,11,306
Minnesota,Pine Island,3456,674,1352,347,0,161,2534
Minnesota,Lake Elmo,8794,1735,4497,468,105,191,6996
Minnesota,Warroad,1952,605,709,185,7,130,1636
Minnesota,Wanda,76,17,42,3,0,6,68
Minnesota,Afton,2980,485,1743,181,10,87,2506
Minnesota,Campbell,204,41,97,18,2,7,165
Minnesota,Elgin,1240,289,552,75,12,32,960
Minnesota,Stewartville,6133,1153,2359,654,88,240,4494
Minnesota,Walnut Grove,709,145,286,45,12,54,542
Minnesota,Turtle River,94,28,42,14,0,0,84
Minnesota,Lanesboro,690,79,404,69,0,34,586
Minnesota,Peterson,200,38,105,25,0,7,175
Minnesota,Rushford,1806,330,802,150,12,156,1450
Minnesota,Brandon,608,113,306,29,0,23,471
Minnesota,Ashby,518,74,200,49,20,40,383
Minnesota,Fountain,375,78,202,17,3,15,315
Minnesota,Belview,336,82,151,25,0,52,310
Minnesota,Lamberton,754,133,319,88,8,88,636
Minnesota,Seaforth,85,19,32,6,4,4,65
Minnesota,Big Lake,10699,2671,4166,744,108,197,7886
Minnesota,Oak Park Heights,4842,1527,1623,561,19,611,4341
Minnesota,La Crescent,5087,954,2512,367,28,284,4145
Minnesota,St. Charles,3723,963,1472,300,25,270,3030
Minnesota,Forest Lake,19643,4492,8347,1684,337,793,15653
Minnesota,St. Paul Park,5372,1664,1798,599,65,160,4286
Minnesota,Lake Bronson,183,49,76,22,6,14,167
Minnesota,Bowlus,269,79,66,32,1,18,196
Minnesota,Upsala,529,99,221,38,8,31,397
Minnesota,Bigelow,226,49,84,17,0,8,158
Minnesota,Chisago City,5043,837,2534,344,46,405,4166
Minnesota,Barnum,632,171,193,88,8,25,485
Minnesota,Red Lake,1704,838,136,79,9,43,1105
Minnesota,Garfield,253,53,115,25,1,14,208
Minnesota,Hoffman,587,123,226,60,3,30,442
Minnesota,Manchester,43,5,27,3,0,0,35
Minnesota,Twin Lakes,148,33,54,31,3,8,129
Minnesota,Elk River,24211,5245,10531,2089,211,641,18717
Minnesota,Gilman,265,37,100,32,0,31,200
Minnesota,Bellingham,238,61,128,9,0,7,205
Minnesota,Garvin,128,44,54,11,0,4,113
Minnesota,Ihlen,46,10,24,8,0,2,44
Minnesota,Fairmont,10191,2053,3911,1367,125,941,8397
Minnesota,Barry,10,1,2,0,1,1,5
Minnesota,Lynd,526,146,237,37,7,10,437
Minnesota,Pemberton,275,55,116,31,1,14,217
Minnesota,Grasston,214,70,78,23,0,6,177
Minnesota,Federal Dam,107,20,48,12,0,5,85
Minnesota,Badger,403,81,135,35,4,16,271
Minnesota,Rose Creek,440,107,162,47,0,34,350
Minnesota,Brownsdale,613,108,284,67,14,52,525
Minnesota,Austin,25006,6111,9542,2250,239,1575,19717
Minnesota,Manhattan Beach,73,1,46,2,2,3,54
Minnesota,Jenkins,420,66,170,28,0,21,285
Minnesota,Ironton,642,137,232,88,2,41,500
Minnesota,Emily,608,77,358,66,0,64,565
Minnesota,Cuyuna,288,51,123,44,1,14,233
Minnesota,Crosby,2825,760,1011,274,12,258,2315
Minnesota,St. Anthony city (Hennepin and Ramsey Counties),9027,2150,3597,849,82,544,7222
Minnesota,Plymouth,77213,16413,37399,5442,499,2600,62353
Minnesota,De Graff,134,40,69,6,0,8,123
Minnesota,Danvers,138,22,59,12,1,9,103
Minnesota,Brook Park,121,46,42,9,0,5,102
Minnesota,Rock Creek,1730,410,738,158,19,115,1440
Minnesota,Beltrami,120,21,64,8,0,7,100
Minnesota,Blackduck,856,188,265,114,4,76,647
Minnesota,Cromwell,269,62,115,14,6,25,222
Minnesota,Thief River Falls,8758,2478,2999,948,52,624,7101
Minnesota,Marshall,13706,4200,4841,924,100,631,10696
Minnesota,Clarkfield,937,183,326,77,13,124,723
Minnesota,Hanska,427,114,137,43,5,25,324
Minnesota,Windom,4459,881,2046,376,5,292,3600
Minnesota,Viking,109,26,48,18,0,2,94
Minnesota,Laporte,159,21,59,63,0,4,147
Minnesota,Pelican Rapids,2468,569,942,191,9,108,1819
Minnesota,Elizabeth,157,21,94,3,0,11,129
Minnesota,Appleton,1466,327,504,182,19,154,1186
Minnesota,Stephen,678,115,319,56,9,34,533
Minnesota,Cloquet,11998,3374,4286,1155,63,535,9413
Minnesota,Carlton,1063,217,388,132,7,169,913
Minnesota,Wyoming,7839,1779,3541,545,79,315,6259
Minnesota,Wykoff,447,111,221,25,5,16,378
Minnesota,Whalan,66,20,18,10,0,3,51
Minnesota,Ostrander,276,41,130,23,3,24,221
Minnesota,Mabel,794,134,366,85,7,86,678
Minnesota,Herman,443,51,201,76,2,32,362
Minnesota,Forada,200,48,101,9,0,20,178
Minnesota,Solway,68,13,41,3,0,5,62
Minnesota,Wright,129,30,36,16,2,7,91
Minnesota,Donnelly,261,67,128,17,0,13,225
Minnesota,Russell,340,57,155,26,7,16,261
Minnesota,Minneota,1349,238,625,120,0,121,1104
Minnesota,Richfield,35982,11266,13471,2927,305,1716,29685
Minnesota,Meire Grove,173,58,61,14,0,5,138
Minnesota,West Union,114,33,34,5,0,0,72
Minnesota,Wadena,4051,1180,1186,512,39,310,3227
Minnesota,Aldrich,55,15,27,0,0,7,49
Minnesota,Little Canada,10387,3561,3557,1283,160,446,9007
Minnesota,Avon,1628,309,735,143,0,41,1228
Minnesota,Hewitt,185,35,65,48,1,8,157
Minnesota,Mahtomedi,8095,1432,3996,552,23,423,6426
Minnesota,Hastings,22690,5723,9222,2366,58,1168,18537
Minnesota,Independence,3751,740,1908,130,14,209,3001
Minnesota,Dellwood,1251,203,719,28,8,24,982
Minnesota,Landfall,754,262,186,71,22,23,564
Minnesota,Clements,123,15,56,15,0,5,91
Minnesota,Hayward,256,64,93,39,2,15,213
Minnesota,Emmons,415,70,186,36,10,20,322
Minnesota,Greenbush,835,183,330,63,5,60,641
Minnesota,White Bear Lake,25601,6303,10994,2324,309,1551,21481
Minnesota,St. Marys Point,361,90,171,24,0,14,299
Minnesota,Pine Springs,421,70,219,15,0,60,364
Minnesota,Lewiston,1639,390,749,120,2,67,1328
Minnesota,Foxhome,111,28,47,10,0,5,90
Minnesota,Utica,307,65,115,43,0,0,223
Minnesota,Wilder,55,7,14,13,0,3,37
Minnesota,Pine River,901,247,281,116,7,86,737
Minnesota,Boy River,37,3,15,7,1,1,27
Minnesota,Taopi,44,8,21,2,1,3,35
Minnesota,New London,1202,156,596,90,6,130,978
Minnesota,Leota,174,30,93,5,0,20,148
Minnesota,Swanville,311,79,146,21,0,15,261
Minnesota,Lastrup,173,28,86,13,0,3,130
Minnesota,Elmdale,74,18,44,5,0,4,71
Minnesota,Boyd,106,21,49,14,3,17,104
Minnesota,Lancaster,377,45,230,9,0,15,299
Minnesota,Halma,36,6,14,6,5,3,34
Minnesota,Hancock,798,196,375,34,2,16,623
Minnesota,Mountain Lake,2153,452,762,222,27,173,1636
Minnesota,Tracy,2172,526,759,237,11,159,1692
Minnesota,Winsted,2269,557,879,191,6,96,1729
Minnesota,Lester Prairie,1958,421,721,115,4,99,1360
Minnesota,Florence,23,0,6,3,0,6,15
Minnesota,Deer Creek,256,31,113,42,2,9,197
Minnesota,Clitherall,84,7,22,23,2,15,69
Minnesota,Bluffton,200,36,91,10,0,8,145
Minnesota,Hendricks,727,156,294,37,13,132,632
Minnesota,Spring Park,1829,455,715,254,24,254,1702
Minnesota,Shorewood,7752,1227,4120,422,14,281,6064
Minnesota,Minneapolis,416021,173917,118346,35421,5851,10163,343698
Minnesota,Mapleton,1696,405,675,171,11,109,1371
Minnesota,Medford,1339,234,524,119,15,31,923
Minnesota,Kettle River,162,40,48,35,3,16,142
Minnesota,Brownsville,566,102,285,63,6,6,462
Minnesota,Rogers,12777,1996,6274,731,26,452,9479
Minnesota,Harmony,994,177,538,44,3,129,891
Minnesota,Shafer,1121,274,387,103,6,18,788
Minnesota,Carver,4629,747,2370,208,15,43,3383
Minnesota,Clear Lake,583,120,234,46,12,15,427
Minnesota,Kimball,907,199,369,108,2,14,692
Minnesota,Bricelyn,279,59,103,42,3,13,220
Minnesota,Corcoran,5775,1061,3074,337,24,161,4657
Minnesota,Courtland,676,109,359,43,7,28,546
Minnesota,St. James,4455,1174,1633,377,18,371,3573
Minnesota,Comfrey,399,65,174,31,5,38,313
Minnesota,Henning,904,196,310,140,2,89,737
Minnesota,Norcross,41,4,30,0,0,2,36
Minnesota,Kasson,6295,1164,2936,392,35,182,4709
Minnesota,Alexandria,13380,3262,5426,1296,165,938,11087
Minnesota,Revere,78,35,27,2,1,4,69
Minnesota,Dakota,311,77,139,44,2,21,283
Minnesota,Woodbury,68686,14274,31931,4737,322,1778,53042
Minnesota,Lucan,190,30,103,8,0,5,146
Minnesota,Stewart,576,132,217,87,9,17,462
Minnesota,Alberta,144,37,87,10,0,2,136
Minnesota,Bagley,1496,348,437,208,5,198,1196
Minnesota,Plummer,319,40,125,31,7,26,229
Minnesota,Henderson,893,180,407,81,4,40,712
Minnesota,Baxter,8087,1659,3648,592,22,405,6326
Minnesota,Ogema,191,60,51,14,0,6,131
Minnesota,Hilltop,862,267,245,87,31,36,666
Minnesota,Sturgeon Lake,455,127,181,30,1,20,359
Minnesota,Mountain Iron,2852,643,1258,256,0,196,2353
Minnesota,Bethel,471,101,189,57,2,6,355
Minnesota,Hibbing,16106,3615,6099,1531,129,1178,12552
Minnesota,Waverly,1395,255,671,79,21,23,1049
Minnesota,Maple Lake,2091,439,895,176,21,73,1604
Minnesota,Medina,6191,786,3309,248,34,249,4626
Minnesota,Bemidji,15004,6123,3657,1892,78,888,12638
Minnesota,Ortonville,1965,364,895,202,15,210,1686
Minnesota,Spring Hill,62,16,27,10,0,5,58
Minnesota,Dalton,299,91,104,37,1,6,239
Minnesota,Argyle,722,121,384,63,0,45,613
Minnesota,Orono,8015,1552,4121,573,0,249,6495
Minnesota,Plainview,3270,663,1476,236,11,160,2546
Minnesota,Iona,128,19,61,9,2,8,99
Minnesota,Frost,234,50,91,28,6,7,182
Minnesota,Stacy,1808,365,750,116,17,53,1301
Minnesota,New Germany,443,127,170,32,5,15,349
Minnesota,Quamba,158,57,44,11,1,18,131
Minnesota,Janesville,2545,567,1128,113,9,125,1942
Minnesota,Isle,746,178,247,104,10,73,612
Minnesota,Lismore,231,47,121,9,0,14,191
Minnesota,Taconite,634,145,308,56,3,32,544
Minnesota,Nicollet,1153,166,591,88,20,14,879
Minnesota,Glyndon,1245,229,556,99,14,19,917
Minnesota,Felton,136,35,54,18,0,5,112
Minnesota,Johnson,12,0,8,0,0,0,8
Minnesota,Comstock,95,19,47,12,0,3,81
Minnesota,Kerkhoven,691,137,268,47,8,46,506
Minnesota,Eagle Lake,2924,823,1056,281,0,33,2193
Minnesota,Amboy,661,158,262,61,1,16,498
Minnesota,Tamarack,111,26,43,15,0,10,94
Minnesota,McGrath,36,10,20,3,0,3,36
Minnesota,Hill City,625,120,189,115,16,50,490
Minnesota,Hamburg,521,137,272,25,8,7,449
Minnesota,Rice Lake,293,109,36,14,4,7,170
Minnesota,St. Michael,17328,3802,7777,643,109,502,12833
Minnesota,Litchfield,6631,1451,2682,819,10,452,5414
Minnesota,Brooks,137,26,55,26,0,18,125
Minnesota,Winthrop,1411,281,610,83,0,116,1090
Minnesota,Green Isle,626,143,248,39,4,20,454
Minnesota,Gibbon,842,231,287,63,7,44,632
Minnesota,Elkton,113,27,42,14,2,2,87
Minnesota,Crosslake,2015,281,1261,200,14,104,1860
Minnesota,Waterville,1984,475,788,192,13,121,1589
Minnesota,Spicer,1255,261,542,128,24,70,1025
Minnesota,Borup,87,22,37,2,2,7,70
Minnesota,Chaska,25998,6148,11204,2138,130,681,20301
Minnesota,Mayer,1990,390,972,59,0,41,1462
Minnesota,Georgetown,95,10,36,14,0,8,68
Minnesota,Arden Hills,10290,3443,4121,624,11,457,8656
Minnesota,Mapleview,124,24,42,32,0,7,105
Minnesota,Benson,3086,594,1231,318,20,308,2471
Minnesota,Hanley Falls,419,73,202,19,10,10,314
Minnesota,Magnolia,208,43,102,22,2,8,177
Minnesota,Fulda,1309,211,582,121,15,117,1046
Minnesota,North Oaks,5068,770,3200,88,0,286,4344
Minnesota,Waubun,523,169,129,55,0,16,369
Minnesota,Skyline,333,54,176,24,0,23,277
Minnesota,St. Clair,851,214,312,78,0,29,633
Minnesota,Watertown,4372,588,2130,203,15,229,3165
Minnesota,Ogilvie,451,108,137,56,3,22,326
Minnesota,Longville,158,20,67,9,1,61,158
Minnesota,Lake Shore,929,107,549,128,6,32,822
Minnesota,Chickamaw Beach,127,10,76,16,0,6,108
Minnesota,Rosemount,23885,4448,10980,1694,128,621,17871
Minnesota,Lakeville,62489,12584,29827,3651,224,1471,47757
Minnesota,Callaway,186,58,68,22,0,5,153
Minnesota,Eagan,66363,16257,29740,5554,380,1742,53673
Minnesota,Clearbrook,452,124,132,47,0,78,381
Minnesota,Foley,2647,551,959,258,8,138,1914
Minnesota,Moorhead,42395,14476,15621,2406,282,1475,34260
Minnesota,Hutchinson,13882,3536,5562,1379,126,772,11375
Minnesota,Clontarf,146,25,83,6,0,5,119
Minnesota,Blooming Prairie,1860,458,638,211,16,181,1504
Minnesota,Lindstrom,4516,992,1881,426,15,196,3510
Minnesota,Lengby,57,7,37,3,2,5,54
Minnesota,Willow River,439,95,195,47,2,23,362
Minnesota,Sandstone,2683,932,551,531,168,159,2341
Minnesota,Askov,343,90,134,50,5,18,297
Minnesota,Ruthton,256,45,126,15,0,12,198
Minnesota,Twin Valley,735,163,256,87,2,75,583
Minnesota,South St. Paul,20256,5874,7267,2042,105,847,16135
Minnesota,Le Sueur,4009,877,1638,456,50,253,3274
Minnesota,Sargeant,40,14,17,4,1,2,38
Minnesota,Adams,774,158,361,78,3,75,675
Minnesota,Breezy Point,2305,297,1256,148,26,84,1811
Minnesota,Ulen,521,66,253,41,0,80,440
Minnesota,Hawley,1925,402,786,111,14,85,1398
Minnesota,Rollingstone,646,115,344,60,0,16,535
Minnesota,Rothsay,531,65,258,67,3,33,426
Minnesota,Nashua,12,2,3,3,0,1,9
Minnesota,Kent,57,9,28,6,0,6,49
Minnesota,Elba,78,6,54,5,0,4,69
Minnesota,Eyota,1945,304,916,173,4,66,1463
Minnesota,Zimmerman,5541,1044,2409,544,49,137,4183
Minnesota,Becker,4787,1120,2142,296,102,75,3735
Minnesota,Hallock,1052,250,482,64,1,89,886
Minnesota,Wabasso,790,207,299,70,10,54,640
Minnesota,Willmar,19618,5292,7172,1375,262,1009,15110
Minnesota,Le Center,2650,637,921,260,10,121,1949
Minnesota,Elko New Market,4604,508,2320,198,0,48,3074
Minnesota,Columbus,4037,661,2077,326,19,272,3355
Minnesota,Nowthen,4649,973,2307,329,29,60,3698
Minnesota,St. Augusta,3669,941,1742,255,0,129,3067
Minnesota,Nisswa,1937,367,1064,173,8,68,1680
Minnesota,Backus,334,79,116,46,1,12,254
Minnesota,Westbrook,746,167,304,69,10,93,643
Minnesota,Oklee,473,109,174,45,0,29,357
Minnesota,Grand Meadow,1065,222,424,126,8,66,846
Minnesota,Pequot Lakes,2330,536,900,210,0,150,1796
Minnesota,Garrison,206,55,101,19,1,16,192
Minnesota,Fort Ripley,38,2,19,4,0,5,30
Minnesota,Wayzata,4518,774,2211,536,21,323,3865
Minnesota,St. Bonifacius,2219,493,1047,227,14,89,1870
Minnesota,Long Lake,1768,405,731,232,10,78,1456
Minnesota,Greenwood,686,92,428,79,7,13,619
Minnesota,Ellsworth,469,94,209,19,0,66,388
Minnesota,Adrian,1150,257,509,94,6,84,950
Minnesota,Marietta,156,42,63,16,8,20,149
Minnesota,Louisburg,37,4,14,11,0,5,34
Minnesota,Kennedy,264,56,118,23,8,9,214
Minnesota,Kilkenny,188,51,71,19,2,4,147
Minnesota,Sanborn,346,44,206,30,0,28,308
Minnesota,Geneva,354,81,153,21,0,36,291
Minnesota,Freeborn,264,76,107,22,4,9,218
Minnesota,Sedan,48,20,10,12,0,2,44
Minnesota,Lowry,405,49,200,31,0,24,304
Minnesota,Sunburg,77,26,33,3,1,6,69
Minnesota,Madison Lake,937,225,431,87,0,34,777
Minnesota,Mora,3480,831,1198,351,75,357,2812
Minnesota,Atwater,1005,231,394,118,4,26,773
Minnesota,Jeffers,375,82,140,42,4,28,296
Minnesota,Stillwater,19275,4650,8146,1883,106,665,15450
Minnesota,Redwood Falls,5004,1248,1916,454,40,264,3922
Minnesota,Milroy,223,73,77,17,7,9,183
Minnesota,Fifty Lakes,308,47,183,26,3,15,274
Minnesota,Floodwood,467,120,137,81,14,40,392
Minnesota,Biwabik,706,244,193,123,3,52,615
Minnesota,Aurora,1640,388,645,171,11,156,1371
Minnesota,Howard Lake,1958,494,773,180,9,119,1575
Minnesota,Buffalo,16092,3594,6862,1429,158,350,12393
Minnesota,Sherburn,1058,237,446,86,15,80,864
Minnesota,South Haven,188,33,71,28,2,7,141
Minnesota,Inver Grove Heights,35197,8323,14883,3493,327,1411,28437
Minnesota,Frazee,1439,374,465,166,17,112,1134
Minnesota,Watkins,953,259,290,76,4,83,712
Minnesota,Starbuck,1337,233,544,164,11,111,1063
Minnesota,Villard,286,57,128,23,0,23,231
Minnesota,Buffalo Lake,650,115,244,68,5,74,506
Minnesota,Fairfax,1037,188,432,115,10,92,837
Minnesota,Clarks Grove,678,124,345,61,9,17,556
Minnesota,Albert Lea,17687,4194,6919,1945,183,1300,14541
Minnesota,Rushford Village,843,92,477,51,2,43,665
Minnesota,Preston,1409,257,638,135,20,64,1114
Minnesota,Nelson,187,48,96,16,0,11,171
Minnesota,Millerville,109,25,38,7,0,5,75
Minnesota,Carlos,458,70,198,61,1,12,342
Minnesota,Wilton,174,77,46,20,0,12,155
Minnesota,Robbinsdale,14466,4257,5331,1441,70,737,11836
Minnesota,Osseo,2731,628,1109,298,27,309,2371
Minnesota,Chatfield,2845,524,1293,243,14,166,2240
Minnesota,New Hope,20922,5273,7979,1736,215,1439,16642
Minnesota,Minnetonka,52546,11573,24236,5057,458,2578,43902
Minnesota,Maple Grove,69571,12619,34913,5331,363,1837,55063
Minnesota,Loretto,746,128,329,52,10,22,541
Minnesota,Hopkins,18300,6140,6053,1820,178,624,14815
Minnesota,Golden Valley,21364,4968,9872,1906,102,1349,18197
Minnesota,Dayton,5487,844,3079,247,21,107,4298
Minnesota,Champlin,24478,4809,11895,1597,87,686,19074
Minnesota,Olivia,2477,485,1078,167,11,190,1931
Minnesota,Hector,1005,208,446,127,7,63,851
Minnesota,Franklin,530,162,161,55,18,32,428
Minnesota,Mound,9412,2054,4733,917,79,202,7985
Minnesota,Angle Inlet,0,0,0,0,0,0,0
Minnesota,Scandia,4083,764,2150,304,75,148,3441
Minnesota,Ball Club,174,55,50,30,0,4,139
Minnesota,Nerstrand,348,68,175,17,0,10,270
Minnesota,Cyrus,339,100,135,35,5,15,290
Minnesota,Wahkon,211,49,91,30,3,17,190
Minnesota,Sauk Centre,4404,1026,1804,310,0,274,3414
Minnesota,Faribault,23711,6595,8541,2505,329,1230,19200
Minnesota,Sartell,17076,3842,7174,1311,91,568,12986
Minnesota,Melrose,3634,765,1578,290,7,223,2863
Minnesota,Brooten,632,153,227,57,10,70,517
Minnesota,Grey Eagle,396,53,180,33,0,31,297
Minnesota,Burtrum,118,19,57,10,0,5,91
Minnesota,St. Paul,302760,108118,91358,24952,4223,9248,237899
Minnesota,Morton,342,80,137,59,3,15,294
Minnesota,Danube,521,55,240,36,9,19,359
Minnesota,Northfield,20217,8321,6702,1308,145,814,17290
Minnesota,Morristown,1036,215,401,127,2,93,838
Minnesota,Darfur,68,8,34,7,0,5,54
Minnesota,Bellechester,188,48,65,22,2,22,159
Minnesota,St. Stephen,916,209,434,56,5,11,715
Minnesota,St. Joseph,6938,3196,1842,284,57,105,5484
Minnesota,Elrosa,197,34,107,12,2,12,167
Minnesota,Clarissa,732,134,297,42,12,92,577
Minnesota,Bird Island,884,207,399,78,0,76,760
Minnesota,Currie,222,33,119,36,0,11,199
Minnesota,Slayton,2008,376,826,243,4,218,1667
Minnesota,Hardwick,234,65,110,16,4,11,206
Minnesota,Harris,947,219,451,122,7,35,834
Minnesota,Princeton,4720,1325,1313,660,30,296,3624
Minnesota,Myrtle,77,26,23,15,0,4,68
Minnesota,Conger,127,24,52,17,0,9,102
Minnesota,Alden,654,165,280,52,4,30,531
Minnesota,Dover,832,138,420,37,0,7,602
Minnesota,Canton,343,82,139,32,0,22,275
Minnesota,Tintah,40,10,10,5,0,3,28
Minnesota,Baudette,1057,249,290,178,19,95,831
Minnesota,Mizpah,96,22,24,15,2,11,74
Minnesota,Baker,44,6,25,0,0,3,34
Minnesota,Big Falls,248,19,104,30,19,22,194
Minnesota,Cobden,20,4,10,3,0,1,18
Minnesota,Urbank,92,31,34,0,4,3,72
Minnesota,Lake Benton,677,163,285,68,0,49,565
Minnesota,St. Martin,341,52,151,26,11,10,250
Minnesota,Lake Henry,58,19,24,8,0,4,55
Minnesota,Effie,94,35,35,6,0,9,85
Minnesota,Bigfork,383,58,123,58,2,104,345
Minnesota,Echo,282,92,102,21,5,12,232
Minnesota,Squaw Lake,99,38,15,16,0,6,75
Minnesota,Jasper,606,85,302,51,2,63,503
Minnesota,Browns Valley,565,124,253,32,0,59,468
Minnesota,Keewatin,1001,216,458,162,3,42,881
Minnesota,Bertha,641,161,228,40,9,26,464
Minnesota,New Brighton,22560,5274,9687,1805,293,1104,18163
Minnesota,Osage,314,67,141,23,0,22,253
Minnesota,Nett Lake,361,124,34,41,3,31,233
Minnesota,Midway,18,7,0,1,2,0,10
Minnesota,Merrifield,86,7,69,5,0,0,81
Minnesota,Martin Lake,878,148,453,111,11,10,733
Minnesota,Mahtowa,371,67,190,21,0,18,296
Minnesota,Mahnomen,215,90,14,20,11,12,147
Minnesota,Lansing,161,36,59,22,0,17,134
Minnesota,Lake George,231,45,111,27,4,20,207
Minnesota,Inger,220,80,36,24,0,0,140
Minnesota,Lutsen,265,85,114,43,2,2,246
Minnesota,Homer,213,12,153,12,0,0,177
Minnesota,Garden City,264,53,148,12,0,2,215
Minnesota,Frontenac,228,54,83,31,4,33,205
Minnesota,Fish Lake,113,12,71,7,0,0,90
Minnesota,Finland,214,57,83,42,0,16,198
Minnesota,Fairhaven,408,85,173,43,0,7,308
Minnesota,Esko,1740,234,913,76,19,116,1358
Minnesota,Ebro,78,23,15,14,0,1,53
Minnesota,Big Lake,414,116,169,41,0,30,356
Minnesota,Beaulieu,34,13,10,2,1,2,28
Minnesota,Sebeka,824,177,306,68,3,46,600
Minnesota,Riverland,301,105,21,19,10,9,164
Minnesota,Pine Bend,57,13,24,4,0,2,43
Minnesota,Roy Lake,23,2,12,1,0,2,17
Minnesota,Maplewood,40387,11013,15281,3535,411,2280,32520
Minnesota,Lauderdale,2514,1022,870,179,30,119,2220
Minnesota,Trommald,69,22,39,5,0,1,67
Minnesota,Eagle Bend,458,67,176,63,8,81,395
Minnesota,Marble,590,190,194,62,2,27,475
Minnesota,La Prairie,916,186,415,70,2,17,690
Minnesota,Grand Rapids,11140,2202,4501,1150,70,906,8829
Minnesota,Coleraine,1648,373,699,171,20,91,1354
Minnesota,Menahga,1074,180,384,148,4,142,858
Minnesota,Ronneby,35,3,20,0,0,2,25
Minnesota,North St. Paul,12342,3334,4554,1195,80,673,9836
Minnesota,Vadnais Heights,13376,2581,6513,1113,49,415,10671
Minnesota,Rice Lake,4142,975,1837,532,0,161,3505
Minnesota,Whipholt,111,2,67,14,1,1,85
Minnesota,West Roy Lake,37,10,15,8,0,0,33
Minnesota,Warsaw,679,165,355,26,0,24,570
Minnesota,Twin Lakes,210,32,93,18,1,6,150
Minnesota,The Ranch,2,0,0,1,0,1,2
Minnesota,Stanchfield,57,22,18,7,4,3,54
Minnesota,Soudan,395,79,189,48,0,25,341
Minnesota,Silver Creek,251,78,138,18,0,5,239
Minnesota,Searles,285,30,92,57,0,45,224
Minnesota,South End,43,19,3,3,0,3,28
Minnesota,Coates,232,47,105,25,2,4,183
Mississippi,Corinth,14647,3667,4672,2239,372,1121,12071
Mississippi,Leland,4058,1274,1221,305,144,180,3124
Mississippi,Laurel,18607,5632,4941,1850,752,1457,14632
Mississippi,Heidelberg,830,254,272,62,25,99,712
Mississippi,Diamondhead,8149,1288,4547,630,39,465,6969
Mississippi,Summit,2185,937,412,192,78,106,1725
Mississippi,Montrose,133,21,65,5,1,13,105
Mississippi,Natchez,15188,5084,3543,1861,458,1230,12176
Mississippi,Iuka,2978,565,1233,274,43,343,2458
Mississippi,Tutwiler,4398,2753,628,272,375,73,4101
Mississippi,Sebastopol,387,77,166,33,13,8,297
Mississippi,Union,2126,611,635,193,25,189,1653
Mississippi,Saucier,1191,396,411,116,50,136,1109
Mississippi,Sumrall,1635,370,628,174,3,79,1254
Mississippi,Sunflower,1158,419,230,61,48,66,824
Mississippi,Amory,6983,1720,2567,738,175,562,5762
Mississippi,Petal,10669,2271,3948,1146,115,540,8020
Mississippi,Columbus,24272,8371,6414,2376,547,2257,19965
Mississippi,Terry,1344,427,434,134,15,57,1067
Mississippi,Belzoni,2009,659,523,168,65,109,1524
Mississippi,Greenwood,14280,5407,2877,1096,330,1149,10859
Mississippi,Verona,3105,948,746,526,89,142,2451
Mississippi,Eupora,2317,618,696,160,130,136,1740
Mississippi,Boyle,987,299,308,63,25,23,718
Mississippi,Chunky,415,63,185,58,15,19,340
Mississippi,Starkville,25122,10876,7147,1325,505,1025,20878
Mississippi,New Augusta,688,231,184,73,14,53,555
Mississippi,Centreville,1616,644,275,161,27,131,1238
Mississippi,Anguilla,636,272,130,63,26,22,513
Mississippi,Shubuta,386,146,99,24,9,30,308
Mississippi,Crosby,337,120,70,10,21,20,241
Mississippi,West Hattiesburg,5933,1545,2021,414,226,228,4434
Mississippi,Cary,296,87,93,28,7,39,254
Mississippi,Oakland,541,177,129,41,14,34,395
Mississippi,Soso,464,100,156,76,9,34,375
Mississippi,McComb,12723,3650,3379,1086,422,925,9462
Mississippi,Ellisville,4815,2049,1113,439,61,303,3965
Mississippi,Collinsville,1606,286,963,125,0,109,1483
Mississippi,Glen,541,76,256,37,6,29,404
Mississippi,Wade,966,310,350,153,0,46,859
Mississippi,De Kalb,1278,335,410,147,51,96,1039
Mississippi,Enterprise,650,96,218,66,41,41,462
Mississippi,Sledge,400,170,69,40,30,39,348
Mississippi,Crowder,747,244,160,36,39,47,526
Mississippi,Richton,904,252,210,85,9,119,675
Mississippi,Meridian,38602,10664,11768,4476,1109,2460,30477
Mississippi,West Point,10794,3433,3134,1142,306,664,8679
Mississippi,Sidon,443,178,96,6,23,9,312
Mississippi,Nellieburg,1398,508,490,86,6,124,1214
Mississippi,Silver Creek,126,27,57,12,1,14,111
Mississippi,Columbus AFB,1673,232,822,46,0,18,1118
Mississippi,Lumberton,1839,427,559,184,103,100,1373
Mississippi,Marietta,248,24,138,16,0,34,212
Mississippi,Hattiesburg,46251,20601,9973,3897,1493,2401,38365
Mississippi,Long Beach,15529,3567,6110,2000,268,746,12691
Mississippi,Walnut,1195,257,336,103,63,93,852
Mississippi,Louise,236,101,47,20,7,9,184
Mississippi,Gulfport,71570,20678,20906,9204,1821,3900,56509
Mississippi,Mantee village,220,20,106,34,0,15,175
Mississippi,Kiln,2112,386,976,239,9,198,1808
Mississippi,Port Gibson,1699,584,336,144,109,148,1321
Mississippi,Arnold Line,2501,1185,884,62,0,136,2267
Mississippi,Alcorn State University,1017,862,76,30,0,0,968
Mississippi,Paden village,129,37,43,21,3,7,111
Mississippi,Falkner,819,151,315,78,27,43,614
Mississippi,Aberdeen,5347,1637,1433,411,151,463,4095
Mississippi,Caledonia,1586,262,715,151,0,37,1165
Mississippi,Pontotoc,5997,1573,1883,714,66,371,4607
Mississippi,Beaumont,995,228,301,225,0,115,869
Mississippi,Tillatoba,25,0,25,0,0,0,25
Mississippi,Utica,800,323,244,56,38,35,696
Mississippi,Weir,746,248,193,91,18,25,575
Mississippi,Kossuth village,254,29,149,31,0,8,217
Mississippi,Pittsboro village,184,64,64,23,0,7,158
Mississippi,Jonestown,1124,515,197,32,63,49,856
Mississippi,Walthall village,92,8,57,9,2,5,81
Mississippi,Waynesboro,4910,1606,1077,331,251,412,3677
Mississippi,Richland,7185,1374,2819,895,121,271,5480
Mississippi,Picayune,11140,2589,3901,1070,367,809,8736
Mississippi,Quitman,2001,405,821,253,53,131,1663
Mississippi,West,173,42,68,10,4,20,144
Mississippi,Isola,849,296,189,39,44,50,618
Mississippi,Fayette,1333,643,114,178,37,69,1041
Mississippi,Cleveland,11998,4420,3192,1134,278,751,9775
Mississippi,Bude,785,185,213,114,37,30,579
Mississippi,Mize,229,54,101,17,5,17,194
Mississippi,Algoma,849,130,329,38,21,22,540
Mississippi,Jumpertown,668,103,261,73,10,44,491
Mississippi,Potts Camp,613,153,171,63,9,64,460
Mississippi,Batesville,7303,2250,2137,458,216,410,5471
Mississippi,Purvis,2493,640,669,326,73,203,1911
Mississippi,Liberty,831,162,345,56,20,93,676
Mississippi,Hernando,15807,2955,7093,1198,202,726,12174
Mississippi,Ocean Springs,17613,3945,6315,2423,216,1100,13999
Mississippi,Crawford,428,138,136,13,9,44,340
Mississippi,Bolton,654,190,239,45,35,36,545
Mississippi,Snow Lake Shores,289,22,163,63,6,23,277
Mississippi,Bentonia,335,92,105,66,10,19,292
Mississippi,Woodville,1205,389,325,78,64,47,903
Mississippi,Farmington,2532,353,1201,242,5,97,1898
Mississippi,Metcalfe,900,315,153,58,32,69,627
Mississippi,Rienzi,308,54,137,37,6,32,266
Mississippi,French Camp,268,101,58,5,38,7,209
Mississippi,Big Point,633,94,350,84,33,0,561
Mississippi,Meridian Station,620,359,149,35,0,0,543
Mississippi,Saltillo,4991,988,2069,477,0,196,3730
Mississippi,Nettleton,2103,523,740,357,29,93,1742
Mississippi,Latimer,6861,1381,3268,711,51,292,5703
Mississippi,Clinton,25456,6277,9393,2227,276,1379,19552
Mississippi,Hickory Flat,587,147,159,106,33,32,477
Mississippi,Morgan City,215,115,7,21,8,5,156
Mississippi,Carrollton,148,26,58,12,2,19,117
Mississippi,Lynchburg,2558,467,965,379,74,77,1962
Mississippi,Falcon,146,92,7,11,6,9,125
Mississippi,Biloxi,45568,12900,16126,4576,637,2430,36669
Mississippi,Pass Christian,5669,1540,2080,578,77,241,4516
Mississippi,Pope village,230,48,85,18,0,35,186
Mississippi,Blue Springs village,329,94,87,40,16,4,241
Mississippi,Pelahatchie,1433,266,542,110,35,100,1053
Mississippi,Brandon,23688,4111,11100,2039,350,1199,18799
Mississippi,Shaw,1733,645,358,139,66,118,1326
Mississippi,Moorhead,1792,889,184,90,94,111,1368
Mississippi,Tremont,466,61,184,56,15,30,346
Mississippi,Lexington,2018,912,368,98,62,126,1566
Mississippi,Hazlehurst,3877,1383,785,458,141,439,3206
Mississippi,D'Lo,612,114,199,70,25,57,465
Mississippi,Beauregard village,482,137,143,34,12,9,335
Mississippi,Mound Bayou,1728,779,220,96,60,120,1275
Mississippi,Pearlington,1022,128,395,220,65,88,896
Mississippi,Ripley,5282,1239,1653,607,73,386,3958
Mississippi,Sardis,2245,615,640,175,44,131,1605
Mississippi,Courtland,492,157,139,42,17,33,388
Mississippi,Hickory,654,257,194,35,7,16,509
Mississippi,Carthage,4862,1700,922,524,184,293,3623
Mississippi,New Hope,3759,573,1835,296,27,184,2915
Mississippi,Ackerman,1534,470,479,173,11,152,1285
Mississippi,Artesia,392,170,86,36,15,28,335
Mississippi,Tylertown,1791,447,531,166,107,185,1436
Mississippi,Flowood,8870,1994,3884,1236,108,293,7515
Mississippi,Canton,12330,4458,3124,1127,197,781,9687
Mississippi,Vaiden,592,221,85,82,41,78,507
Mississippi,Ridgeland,24265,7211,8693,2455,332,894,19585
Mississippi,Clarksdale,16174,5640,3775,858,921,1089,12283
Mississippi,Vicksburg,22706,7409,6036,2248,509,1266,17468
Mississippi,Sylvarena village,98,23,37,8,0,15,83
Mississippi,Baldwyn,2998,769,956,547,169,244,2685
Mississippi,Senatobia,7966,3514,2159,732,96,419,6920
Mississippi,Flora,1800,516,604,132,8,84,1344
Mississippi,Sumner,252,51,114,33,0,22,220
Mississippi,Mantachie,1387,288,479,185,43,146,1141
Mississippi,Pace,183,54,69,23,4,12,162
Mississippi,Water Valley,3339,811,1123,255,70,423,2682
Mississippi,Hollandale,2293,813,608,155,34,188,1798
Mississippi,Arcola,338,141,54,28,8,28,259
Mississippi,Moss Point,13487,4850,3984,1397,567,1107,11905
Mississippi,Scooba,954,653,110,13,11,29,816
Mississippi,Meadville,622,132,190,108,11,56,497
Mississippi,Forest,5668,1628,1779,608,278,266,4559
Mississippi,Guntown,2654,386,1105,290,19,84,1884
Mississippi,Shannon,1862,590,540,173,70,80,1453
Mississippi,Satartia village,30,6,2,7,0,10,25
Mississippi,Inverness,915,279,266,66,10,84,705
Mississippi,Lucedale,3059,760,905,416,125,267,2473
Mississippi,Georgetown,262,47,104,32,10,31,224
Mississippi,Renova,949,348,215,45,39,53,700
Mississippi,Beulah,503,211,101,31,21,22,386
Mississippi,Lake,397,101,117,38,8,21,285
Mississippi,Sturgis,229,27,142,20,0,9,198
Mississippi,Doddsville,280,75,33,18,40,13,179
Mississippi,Durant,2908,1249,389,226,112,170,2146
Mississippi,Merigold,402,127,134,44,14,25,344
Mississippi,Benoit,477,212,97,27,11,18,365
Mississippi,Magee,4301,1294,1014,640,144,335,3427
Mississippi,Philadelphia,7284,2249,2080,655,253,509,5746
Mississippi,Lyman,2405,535,1019,215,80,129,1978
Mississippi,Booneville,8767,2378,2851,904,335,551,7019
Mississippi,Indianola,9624,3654,2350,586,427,606,7623
Mississippi,Mendenhall,2835,652,745,219,87,294,1997
Mississippi,Braxton village,240,36,76,42,6,25,185
Mississippi,Ruleville,2719,1091,452,323,143,195,2204
Mississippi,Puckett village,335,46,176,26,4,24,276
Mississippi,Horn Lake,26925,8099,8161,2739,715,1108,20822
Mississippi,Toccopola,288,48,125,35,9,17,234
Mississippi,Pachuta,185,48,62,20,0,34,164
Mississippi,Raleigh,1409,463,377,130,25,143,1138
Mississippi,Taylorsville,1998,498,679,102,47,192,1518
Mississippi,Bay Springs,1511,361,480,119,49,147,1156
Mississippi,Friars Point,1209,471,190,104,46,50,861
Mississippi,Holly Springs,7578,3547,1595,633,153,330,6258
Mississippi,Conehatta,1208,351,265,122,23,34,795
Mississippi,Decatur,1917,1030,432,144,17,56,1679
Mississippi,Lula,243,89,69,28,8,17,211
Mississippi,Calhoun City,1866,452,540,205,52,173,1422
Mississippi,Bassfield,359,59,103,50,18,31,261
Mississippi,Oxford,23037,11040,6544,1210,165,775,19734
Mississippi,Taylor village,260,45,137,16,4,9,211
Mississippi,Wiggins,4552,1313,1384,463,197,349,3706
Mississippi,Escatawpa,2811,607,1281,548,0,189,2625
Mississippi,Gautier,18563,4579,6854,1832,449,944,14658
Mississippi,Vancleave,5048,1110,2209,246,79,329,3973
Mississippi,Greenville,31319,10533,7717,3136,1020,2105,24511
Mississippi,Noxapater,419,78,142,74,4,39,337
Mississippi,Abbeville,395,70,145,57,5,28,305
Mississippi,Seminary,439,102,190,43,0,25,360
Mississippi,Mount Olive,1041,219,231,162,11,71,694
Mississippi,Grenada,12633,3366,3704,1306,426,1089,9891
Mississippi,Myrtle,468,104,149,82,24,24,383
Mississippi,Pearl,26508,6549,9196,3054,439,1413,20651
Mississippi,Stonewall,961,206,367,117,7,118,815
Mississippi,Coffeeville,1108,254,248,174,22,49,747
Mississippi,Newton,3251,893,951,290,122,220,2476
Mississippi,Charleston,2086,569,343,278,69,256,1515
Mississippi,Madison,25522,4292,13210,1216,82,1079,19879
Mississippi,Plantersville,850,213,332,79,19,52,695
Mississippi,Tupelo,38270,9428,12929,4507,723,2097,29684
Mississippi,Pearl River,4205,1308,695,551,94,340,2988
Mississippi,Walls,1347,591,314,73,24,54,1056
Mississippi,Polkville,633,123,229,70,17,45,484
Mississippi,Glendora village,54,27,4,4,2,5,42
Mississippi,Coldwater,1646,489,480,242,44,135,1390
Mississippi,Burnsville,936,225,301,150,17,37,730
Mississippi,Magnolia,2119,947,425,194,89,180,1835
Mississippi,Ecru,1237,234,445,128,22,43,872
Mississippi,Thaxton,909,120,413,58,2,30,623
Mississippi,Brooksville,1063,363,265,32,39,84,783
Mississippi,New Hebron,631,112,254,48,15,26,455
Mississippi,North Carrollton,303,91,78,44,6,35,254
Mississippi,Derma,1045,316,259,65,53,88,781
Mississippi,Woodland village,184,58,34,13,12,10,127
Mississippi,Hillsboro,1124,314,367,68,24,36,809
Mississippi,Holcomb,445,28,163,42,0,75,308
Mississippi,Kearney Park,1434,556,454,47,63,18,1138
Mississippi,Lauderdale,487,0,155,11,0,82,248
Mississippi,Mississippi State,4073,3926,76,19,0,0,4021
Mississippi,Mississippi Valley State University,1348,1081,94,0,0,12,1187
Mississippi,Morgantown,1655,506,514,216,16,170,1422
Mississippi,New Hamilton,523,41,260,77,0,31,409
Mississippi,Hide-A-Way Lake,2332,513,1319,189,18,73,2112
Mississippi,Nicholson,2473,613,891,365,58,79,2006
Mississippi,Robinhood,1438,293,613,228,0,106,1240
Mississippi,Sharon,1020,209,401,76,70,70,826
Mississippi,Toomsuba,980,347,224,41,0,55,667
Mississippi,Mooreville,879,173,214,305,32,58,782
Mississippi,Tunica Resorts,2292,672,858,113,19,10,1672
Mississippi,University,4490,4490,0,0,0,0,4490
Mississippi,White Oak,323,140,91,71,0,21,323
Mississippi,Florence,4384,897,1865,287,104,204,3357
Mississippi,Rawls Springs,920,264,168,246,48,38,764
Mississippi,Henderson Point,197,66,95,9,8,13,191
Mississippi,Hamilton,427,130,154,75,0,23,382
Mississippi,Glendale,2083,442,765,340,85,57,1689
Mississippi,Coahoma,356,170,30,10,24,17,251
Mississippi,Lyon,409,56,195,54,13,25,343
Mississippi,Lambert,1282,522,238,72,157,76,1065
Mississippi,Marks,1741,614,462,136,67,144,1423
Mississippi,Brookhaven,12226,3981,3763,948,391,813,9896
Mississippi,Beechwood,3523,965,1399,257,97,235,2953
Mississippi,Bogue Chitto CDP (Kemper and Neshoba Counties),460,207,36,70,0,0,313
Mississippi,Bogue Chitto CDP (Lincoln County),352,0,173,0,12,53,238
Mississippi,Bridgetown,2538,454,1202,101,65,147,1969
Mississippi,Buckatunna,349,44,128,14,31,22,239
Mississippi,Byram,11657,3124,4385,1251,168,287,9215
Mississippi,Clara,579,81,358,0,0,68,507
Mississippi,Cleary,1412,165,817,91,0,91,1164
Mississippi,Cloverdale,649,213,250,104,19,21,607
Mississippi,Darling,204,99,61,8,0,21,189
Mississippi,DeLisle,1252,454,257,200,59,117,1087
Mississippi,Elliott,995,124,440,107,29,27,727
Mississippi,Farrell,390,200,56,78,5,28,367
Mississippi,Foxworth,536,117,137,55,16,48,373
Mississippi,Byhalia,1537,515,412,139,9,133,1208
Mississippi,Louin,278,56,135,21,5,20,237
Mississippi,Collins,2889,674,765,419,134,215,2207
Mississippi,Winona,4367,1067,1390,604,85,281,3427
Mississippi,New Houlka,651,210,179,55,4,42,490
Mississippi,Columbia,6088,2032,1555,552,218,506,4863
Mississippi,Slate Springs village,94,24,46,9,7,4,90
Mississippi,Bruce,1751,548,534,211,53,109,1455
Mississippi,Big Creek village,273,78,92,20,11,17,218
Mississippi,Mayersville,655,314,108,50,59,37,568
Mississippi,Como,1280,465,250,172,103,99,1089
Mississippi,St. Martin,8203,2538,2456,962,157,412,6525
Mississippi,Crenshaw,928,243,277,63,31,62,676
Mississippi,Pascagoula,21865,6765,6453,2336,453,1370,17377
Mississippi,Gulf Park Estates,6308,1210,2289,715,109,218,4541
Mississippi,Gulf Hills,8252,2278,2388,1341,214,564,6785
Mississippi,State Line,547,244,111,50,11,24,440
Mississippi,Yazoo City,11076,4239,1796,704,376,845,7960
Mississippi,Mathiston,562,107,239,43,14,31,434
Mississippi,Maben,687,248,129,59,17,83,536
Mississippi,Duck Hill,1133,287,408,54,26,103,878
Mississippi,Sherman,783,204,259,97,2,32,594
Mississippi,Hurley,1276,307,601,135,14,33,1090
Mississippi,Prentiss,1223,327,443,126,41,113,1050
Mississippi,D'Iberville,13531,3885,4791,1268,172,491,10607
Mississippi,Rolling Fork,2306,928,649,129,66,139,1911
Mississippi,Gloster,1085,239,312,103,65,60,779
Mississippi,Poplarville,2960,1304,713,162,27,150,2356
Mississippi,Marion,1522,445,417,189,41,87,1179
Mississippi,Alligator,119,32,31,10,0,8,81
Mississippi,Leakesville,1084,278,414,84,54,71,901
Mississippi,Winstonville,153,68,44,3,3,23,141
Mississippi,Shelby,2102,781,354,186,95,100,1516
Mississippi,Duncan,378,156,64,46,24,26,316
Mississippi,Hatley,606,112,270,49,0,39,470
Mississippi,Walnut Grove,809,381,140,109,20,29,679
Mississippi,Lena,161,29,75,22,0,20,146
Mississippi,Schlater,239,89,74,16,4,18,201
Mississippi,McCool,112,21,50,21,0,5,97
Mississippi,Redwater,738,326,242,35,10,17,630
Mississippi,Roxie,581,239,204,13,10,21,487
Mississippi,Olive Branch,36721,7866,15450,3696,666,1269,28947
Mississippi,Tishomingo,414,87,96,57,21,53,314
Mississippi,Morton,3648,1059,982,219,142,217,2619
Mississippi,Tucker,650,237,88,48,12,14,399
Mississippi,New Albany,8714,2328,3003,687,212,564,6794
Mississippi,Kilmichael,878,231,278,74,26,62,671
Mississippi,Tunica,1138,226,485,96,43,81,931
Mississippi,Crystal Springs,4892,1439,1283,544,260,328,3854
Mississippi,Golden,222,29,89,11,0,24,153
Mississippi,Belmont,2073,333,939,146,6,183,1607
Mississippi,Webb,454,155,48,42,17,45,307
Mississippi,Waveland,6358,1376,1854,1170,216,416,5032
Mississippi,Okolona,2591,875,590,201,139,339,2144
Mississippi,Houston,3497,1201,1023,304,8,182,2718
Mississippi,Vardaman,1320,339,384,93,43,65,924
Mississippi,Bay St. Louis,12465,3141,4171,1489,438,885,10124
Mississippi,Osyka,402,96,109,42,11,22,280
Mississippi,Monticello,1393,259,401,195,63,81,999
Mississippi,Drew,2074,875,395,125,86,131,1612
Mississippi,Standing Pine,588,136,206,16,11,0,369
Mississippi,Raymond,2409,1668,415,160,14,76,2333
Mississippi,Learned,91,13,55,5,3,3,79
Mississippi,Ashland,621,133,187,85,26,84,515
Mississippi,Sallis,262,30,124,11,0,29,194
Mississippi,Ethel,623,199,228,37,8,32,504
Mississippi,Kosciusko,6959,1783,1986,788,241,628,5426
Mississippi,North Tunica,923,253,209,83,25,20,590
Mississippi,Southaven,53274,12179,20526,5180,1077,2833,41795
Mississippi,Helena,1233,241,607,171,0,111,1130
Mississippi,Sandersville,734,90,349,82,33,31,585
Mississippi,Rosedale,1648,715,270,106,71,123,1285
Mississippi,Gunnison,416,198,30,34,10,40,312
Mississippi,Fulton,4024,1470,995,420,125,329,3339
Mississippi,Tchula,1884,969,176,94,66,144,1449
Mississippi,Pickens,883,354,171,50,22,58,655
Mississippi,Cruger,370,164,85,24,12,46,331
Mississippi,McLain,302,95,108,12,24,16,255
Mississippi,Wesson,2166,917,661,131,29,89,1827
Mississippi,Goodman,1224,773,116,48,45,30,1012
Mississippi,Smithville,671,167,266,81,9,58,581
Mississippi,Gattman village,95,17,52,10,0,12,91
Mississippi,Dumas,467,115,216,38,6,15,390
Mississippi,Blue Mountain,1132,433,282,92,20,58,885
Mississippi,Silver City,335,105,82,11,14,9,221
Mississippi,Itta Bena,1556,606,281,105,107,155,1254
Mississippi,Eden village,137,33,40,15,2,11,101
Mississippi,Shuqualak,500,233,105,65,39,23,465
Mississippi,Macon,2948,1193,508,118,129,178,2126
Mississippi,Louisville,6298,1874,2008,425,182,423,4912
Mississippi,Jackson,168862,65730,38075,15581,5222,8445,133053
Mississippi,Edwards,886,312,185,105,56,102,760
Missouri,Sibley village,356,73,152,45,12,14,296
Missouri,Crystal Lakes,335,52,187,41,6,9,295
Missouri,Herculaneum,3935,779,1722,287,15,277,3080
Missouri,Koshkonong,206,33,57,39,0,18,147
Missouri,Crystal City,4752,1310,1721,500,74,337,3942
Missouri,Raymore,20743,3275,10076,1914,144,1162,16571
Missouri,Harrisonville,10023,2144,3463,1220,158,667,7652
Missouri,Baldwin Park village,97,11,50,14,0,6,81
Missouri,Sikeston,16366,3857,5932,1671,347,1337,13144
Missouri,Scott City,4503,1100,1525,541,103,180,3449
Missouri,Commerce village,73,20,41,0,0,2,63
Missouri,Albany,2106,440,866,228,14,177,1725
Missouri,Blue Springs,54370,10558,22862,5303,788,1681,41192
Missouri,Union Star,377,69,181,43,4,28,325
Missouri,Clarksdale,283,37,136,42,10,11,236
Missouri,Amity,21,3,5,0,0,13,21
Missouri,Exeter,821,155,342,92,13,50,652
Missouri,Conway,674,157,180,90,14,60,501
Missouri,Glasgow,1163,273,448,143,2,74,940
Missouri,Hughesville village,164,15,94,15,1,11,136
Missouri,Whiteman AFB,4093,1472,1617,38,9,0,3136
Missouri,Clark,286,74,107,23,2,17,223
Missouri,Perry,690,63,316,82,4,88,553
Missouri,Fair Play,471,59,208,50,19,43,379
Missouri,Hannibal,17575,4126,6421,2090,219,1133,13989
Missouri,South Greenfield village,124,2,81,16,0,8,107
Missouri,Goodnight village,20,0,15,0,0,0,15
Missouri,Evergreen village,16,8,6,0,0,1,15
Missouri,Dardenne Prairie,13139,2411,6824,592,134,401,10362
Missouri,Riverview Estates village,79,28,42,0,0,5,75
Missouri,Preston village,330,80,101,30,7,23,241
Missouri,Allendale village,64,2,39,2,0,7,50
Missouri,Hurdland,148,55,68,17,0,4,144
Missouri,Westphalia,393,132,111,33,6,79,361
Missouri,Lambert village,0,0,0,0,0,0,0
Missouri,Oran,1532,278,702,183,30,57,1250
Missouri,Fenton,4034,694,2087,320,19,210,3330
Missouri,Edmundson,1067,249,355,63,27,29,723
Missouri,Des Peres,8567,1317,4835,344,76,209,6781
Missouri,Bridgeton,11690,3446,4195,933,174,770,9518
Missouri,Berkeley,8991,3396,1678,1068,240,556,6938
Missouri,Ballwin,30332,5454,14836,2209,523,1486,24508
Missouri,Florida village,0,0,0,0,0,0,0
Missouri,Henrietta,353,80,122,61,7,16,286
Missouri,Camden,296,51,142,24,12,10,239
Missouri,Wilbur Park village,554,168,241,46,13,25,493
Missouri,Town and Country,11066,1941,6234,420,34,901,9530
Missouri,Mehlville,28376,8561,11436,3047,274,1687,25005
Missouri,Lemay,16814,4321,5353,2620,216,1050,13560
Missouri,Ladue,8586,1209,5021,294,52,360,6936
Missouri,Hillsdale village,1335,533,221,126,90,28,998
Missouri,Grantwood Village,1038,157,593,27,0,52,829
Missouri,Glen Echo Park village,134,31,40,13,2,10,96
Missouri,Bertrand,827,100,401,93,19,95,708
Missouri,Ste. Genevieve,4444,746,1941,438,168,308,3601
Missouri,Truesdale,781,180,212,97,16,39,544
Missouri,Shelbyville,489,66,255,47,4,40,412
Missouri,Wilson City village,51,16,3,6,16,6,47
Missouri,Bellefontaine Neighbors,10613,4158,2337,1171,395,746,8807
Missouri,Stoutland,185,14,73,18,21,34,160
Missouri,Lakeshire,1658,432,494,333,23,73,1355
Missouri,Chula,218,25,109,29,6,4,173
Missouri,Mount Vernon,4493,728,1796,686,96,429,3735
Missouri,Bella Villa,841,236,362,77,3,35,713
Missouri,Beverly Hills,505,212,81,77,25,34,429
Missouri,Black Jack,6943,2169,1918,895,109,572,5663
Missouri,Ellisville,9581,1692,4151,1007,82,802,7734
Missouri,Manchester,18189,4077,8254,1839,171,678,15019
Missouri,Maryland Heights,27128,8444,10780,2208,265,1442,23139
Missouri,Plato village,77,15,38,3,0,3,59
Missouri,Kirbyville village,195,47,89,34,0,10,180
Missouri,Hoberg village,49,5,34,2,0,0,41
Missouri,Horine,1295,370,495,67,12,0,944
Missouri,Independence,117207,28660,42931,14799,2236,6652,95278
Missouri,Clarkson Valley,2640,380,1680,45,18,76,2199
Missouri,Berger,205,44,77,21,8,12,162
Missouri,St. Cloud village,55,19,24,0,0,5,48
Missouri,Washington,13987,2864,6182,1402,278,727,11453
Missouri,Morrison,89,26,37,5,0,10,78
Missouri,La Plata,1362,296,456,206,5,150,1113
Missouri,Mountain View,2658,490,1019,375,35,257,2176
Missouri,Old Monroe,227,37,92,50,0,14,193
Missouri,Weaubleau,587,113,176,72,0,48,409
Missouri,New London,886,196,412,75,0,48,731
Missouri,Appleton City,1240,198,434,176,22,175,1005
Missouri,Green Park,2628,541,1098,317,19,219,2194
Missouri,Bell City,528,106,221,43,6,18,394
Missouri,Arbyrd,434,78,141,64,46,14,343
Missouri,Dadeville village,238,50,97,42,0,3,192
Missouri,Rhineland,125,26,60,9,0,7,102
Missouri,Cliff Village village,30,0,15,5,0,6,26
Missouri,Overland,15787,4831,5071,2058,184,965,13109
Missouri,Doolittle,745,108,330,94,8,44,584
Missouri,Eminence,666,157,218,107,18,83,583
Missouri,West Alton,378,96,137,58,9,41,341
Missouri,Lee's Summit,96325,17093,45268,7433,951,3693,74438
Missouri,Drexel,806,129,353,129,16,43,670
Missouri,Lake Tapawingo,809,148,425,99,10,45,727
Missouri,Sedalia,21642,5119,7392,2892,501,1274,17178
Missouri,Essex,526,147,148,69,13,61,438
Missouri,Lebanon,14637,2460,6034,1689,329,873,11385
Missouri,Osborn,434,74,205,69,0,23,371
Missouri,Rolla,20117,7718,6008,1843,249,900,16718
Missouri,Webb City,11572,2518,4076,1530,177,666,8967
Missouri,Smithton,517,110,228,47,0,16,401
Missouri,Goss,0,0,0,0,0,0,0
Missouri,Rosebud,573,113,211,56,14,27,421
Missouri,Jasper,968,155,368,135,7,66,731
Missouri,Fort Leonard Wood,15882,9272,3764,314,93,20,13463
Missouri,Alma,420,100,208,19,0,28,355
Missouri,Freeburg village,498,117,203,24,3,23,370
Missouri,Seneca,2570,483,1054,187,48,205,1977
Missouri,Centralia,4207,820,1635,436,0,314,3205
Missouri,Ravenwood,449,93,198,32,4,22,349
Missouri,Williamsville,403,125,153,51,4,35,368
Missouri,Nevada,8252,1896,2694,1310,136,661,6697
Missouri,Marthasville,1328,282,542,118,7,31,980
Missouri,Branson West,569,153,263,51,5,38,510
Missouri,Mosby,164,16,51,21,23,9,120
Missouri,Pattonsburg,354,136,81,59,12,7,295
Missouri,Galena,641,134,218,86,6,23,467
Missouri,Portageville,3074,710,993,394,70,198,2365
Missouri,Asbury,246,40,113,19,3,30,205
Missouri,Homestown,114,31,24,15,4,4,78
Missouri,Dearborn,461,80,180,65,2,41,368
Missouri,Amazonia village,317,80,120,21,0,34,255
Missouri,Mokane,186,52,50,20,6,14,142
Missouri,West Line village,107,33,40,16,1,3,93
Missouri,Pendleton village,34,11,10,5,2,4,32
Missouri,Monticello village,132,40,59,11,3,5,118
Missouri,Alton,583,56,244,59,0,132,491
Missouri,Kingston,285,128,86,42,2,15,273
Missouri,Mineral Point,365,57,100,62,13,19,251
Missouri,Willow Springs,2179,388,935,220,44,88,1675
Missouri,Belle,1458,297,556,231,26,117,1227
Missouri,Maysville,1151,209,501,134,24,75,943
Missouri,Seymour,2128,376,869,243,26,185,1699
Missouri,Frontenac,3525,533,2020,199,18,118,2888
Missouri,Oakland,1558,340,654,113,31,231,1369
Missouri,Jennings,14794,6297,3227,1201,427,804,11956
Missouri,Wellston,1775,824,129,165,87,75,1280
Missouri,Valley Park,6832,1551,2956,629,142,473,5751
Missouri,Uplands Park village,357,125,82,42,13,17,279
Missouri,Sunset Hills,8488,1351,4405,557,24,770,7107
Missouri,Pacific,6329,1739,2069,749,123,485,5165
Missouri,Mackenzie village,174,67,64,17,0,1,149
Missouri,Kinloch,276,139,38,29,8,11,225
Missouri,Hazelwood,25399,7341,8436,3081,696,1212,20766
Missouri,Ferguson,20931,7380,5283,2001,586,973,16223
Missouri,Dellwood,4912,2028,926,338,97,236,3625
Missouri,Country Club Hills,1393,581,143,153,69,49,995
Missouri,Concord,17652,3960,7795,1712,117,1325,14909
Missouri,Champ village,5,0,5,0,0,0,5
Missouri,Weatherby,75,13,29,19,1,3,65
Missouri,Woodson Terrace,4062,1116,1385,596,63,136,3296
Missouri,Cameron,9665,3412,2610,1354,317,577,8270
Missouri,Meta,196,45,81,34,10,11,181
Missouri,Argyle,193,29,76,42,0,15,162
Missouri,Fillmore,170,62,42,40,0,10,154
Missouri,Turney village,216,50,83,37,0,2,172
Missouri,Levasy,82,15,41,15,0,0,71
Missouri,Pevely,5784,1413,2202,521,110,187,4433
Missouri,Olympian Village,606,106,245,85,8,17,461
Missouri,Cedar Hill Lakes village,258,69,109,50,2,9,239
Missouri,Ava,2916,519,1033,363,46,187,2148
Missouri,Lake Annette,114,20,40,32,8,2,102
Missouri,Vinita Park,1931,601,680,175,91,73,1620
Missouri,Sappington,7577,1671,3047,941,76,578,6313
Missouri,Strasburg,129,21,44,20,2,8,95
Missouri,Mound City,1114,156,504,132,23,139,954
Missouri,Thayer,2292,437,893,235,75,166,1806
Missouri,Harwood village,87,2,55,3,0,0,60
Missouri,Tuscumbia,183,45,78,28,0,5,156
Missouri,Roscoe village,103,8,69,3,0,3,83
Missouri,Smithville,9541,1533,4112,1166,83,448,7342
Missouri,Randolph village,21,6,6,4,0,5,21
Missouri,Oakwood Park village,284,76,123,24,0,13,236
Missouri,McBaine,9,4,0,2,1,1,8
Missouri,Ironton,1674,384,707,114,23,137,1365
Missouri,Lock Springs village,37,0,26,3,0,2,31
Missouri,Passaic,20,4,11,2,3,0,20
Missouri,Columbia,120248,48616,39934,8966,1132,3292,101940
Missouri,Mountain Grove,4608,794,1362,793,123,528,3600
Missouri,Memphis,1803,304,710,245,38,195,1492
Missouri,Purcell,468,108,165,53,19,17,362
Missouri,Carterville,2134,478,754,270,35,62,1599
Missouri,St. Joseph,76465,20265,25738,10171,1105,4249,61528
Missouri,Flemington village,74,2,36,7,3,12,60
Missouri,Bolivar,10760,3345,2915,1217,292,807,8576
Missouri,Parma,660,151,215,27,31,49,473
Missouri,Marston,328,69,128,30,13,29,269
Missouri,Metz,33,4,14,2,0,6,26
Missouri,Sheldon,427,41,159,51,14,32,297
Missouri,Mooresville village,154,29,44,22,2,10,107
Missouri,Homestead village,124,20,53,15,4,11,103
Missouri,Amoret,178,33,109,5,0,9,156
Missouri,Shell Knob,1246,34,888,111,0,75,1108
Missouri,Wheatland,293,43,45,76,6,70,240
Missouri,Norwood,900,133,325,67,29,47,601
Missouri,Rich Hill,1425,230,650,114,16,90,1100
Missouri,New Bloomfield,544,144,222,54,12,26,458
Missouri,Leasburg village,389,95,123,55,0,16,289
Missouri,Cross Timbers,185,22,32,54,6,21,135
Missouri,Gideon,1202,275,435,166,22,98,996
Missouri,Howardville,279,93,75,19,28,14,229
Missouri,Adrian,1793,328,637,176,84,154,1379
Missouri,Lake Mykee Town village,450,99,206,24,0,18,347
Missouri,Branson,11345,2273,4630,1533,127,806,9369
Missouri,Forest City,250,25,117,45,0,16,203
Missouri,Stotts City,129,16,49,11,5,7,88
Missouri,Monett,8917,1981,3678,611,168,454,6892
Missouri,Glendale,5888,935,3059,318,30,172,4514
Missouri,Creve Coeur,18445,4139,8570,1327,177,1381,15594
Missouri,Country Life Acres village,84,13,53,4,0,2,72
Missouri,Aurora,7435,1481,2938,1064,166,476,6125
Missouri,Holcomb,580,138,189,70,19,59,475
Missouri,Jerico Springs village,224,64,68,30,19,18,199
Missouri,Affton,20187,5505,8202,2275,193,991,17166
Missouri,Waynesville,5262,1192,2074,634,136,153,4189
Missouri,Richland,1895,584,483,226,92,203,1588
Missouri,Saginaw village,410,78,128,61,5,64,336
Missouri,Pilot Grove,650,122,232,82,9,87,532
Missouri,Montrose,328,54,153,40,6,22,275
Missouri,Brownington,124,19,50,18,0,12,99
Missouri,Tallapoosa,134,17,47,6,5,14,89
Missouri,Matthews,726,153,236,104,13,78,584
Missouri,Normandy,4931,2286,1162,660,94,223,4425
Missouri,Olivette,7837,1522,3450,431,91,309,5803
Missouri,Pasadena Park village,480,193,104,57,8,25,387
Missouri,Richmond Heights,8457,2670,3540,680,98,312,7300
Missouri,Riverview village,2872,834,762,410,152,149,2307
Missouri,Webster Groves,23029,4711,10809,1236,213,1284,18253
Missouri,Wheeling,304,38,117,51,8,21,235
Missouri,Greenville,546,79,200,64,13,52,408
Missouri,Old Appleton,65,22,18,12,0,0,52
Missouri,Dalton,3,0,2,0,0,1,3
Missouri,Leslie village,123,28,27,22,3,1,81
Missouri,Villa Ridge,2497,359,1237,395,88,106,2185
Missouri,Cave,4,2,2,0,0,0,4
Missouri,Lilbourn,1165,336,328,111,89,58,922
Missouri,Fredericktown,3990,893,1628,316,73,321,3231
Missouri,North Lilbourn village,8,0,8,0,0,0,8
Missouri,Wildwood,35517,6437,19133,1898,134,803,28405
Missouri,Bagnell,34,9,17,5,0,3,34
Missouri,Middletown,267,60,95,30,4,12,201
Missouri,Licking,2844,883,831,584,108,171,2577
Missouri,High Ridge,4151,756,1911,499,69,226,3461
Missouri,Cedar Hill,1751,460,698,286,0,27,1471
Missouri,Barnhart,6318,1508,2519,638,173,279,5117
Missouri,Freeman,517,119,212,50,2,15,398
Missouri,Cleveland,572,152,253,71,0,39,515
Missouri,Kelso village,568,96,273,37,2,23,431
Missouri,Higbee,541,106,231,48,43,27,455
Missouri,Madison,663,155,219,74,13,44,505
Missouri,Cabool,2337,404,859,282,49,222,1816
Missouri,O'Fallon,86340,17427,38522,6872,675,3283,66779
Missouri,Clifton Hill,85,11,38,8,0,1,58
Missouri,Cottleville,4882,1070,2474,279,0,138,3961
Missouri,New Hampton,297,43,111,47,4,6,211
Missouri,Raytown,29216,8619,9896,3581,458,1575,24129
Missouri,Lone Jack,1280,247,590,97,7,42,983
Missouri,Eldon,4591,904,1707,530,27,376,3544
Missouri,St. Elizabeth village,332,50,185,5,1,35,276
Missouri,Hardin,622,104,271,49,2,14,440
Missouri,Freistatt village,181,40,71,24,3,19,157
Missouri,Marionville,2350,421,719,280,81,209,1710
Missouri,Pierce City,1313,211,481,204,26,69,991
Missouri,Winchester,1482,329,563,192,13,137,1234
Missouri,Verona,481,81,192,37,4,44,358
Missouri,Knox City,241,63,59,33,0,8,163
Missouri,Phillipsburg village,164,11,88,17,6,17,139
Missouri,La Monte,1380,375,489,86,18,49,1017
Missouri,Buckner,3058,554,1269,295,66,168,2352
Missouri,Grandview,25174,7710,7316,2963,444,1165,19598
Missouri,Greenwood,6092,1157,2892,352,43,112,4556
Missouri,De Witt,108,20,51,16,0,6,93
Missouri,Watson village,38,6,14,5,0,9,34
Missouri,Gunn City village,122,28,35,9,9,8,89
Missouri,Edina,1139,292,414,150,7,88,951
Missouri,Macks Creek,425,91,133,78,48,8,358
Missouri,Charmwood,40,3,20,3,2,0,28
Missouri,Rayville,135,14,61,3,0,0,78
Missouri,Montreal,170,66,0,17,38,0,121
Missouri,Centerview,246,50,82,23,4,16,175
Missouri,Annada village,37,12,13,3,2,2,32
Missouri,Irena village,21,7,12,2,0,0,21
Missouri,Centerville,219,82,67,24,8,9,190
Missouri,Burlington Junction,550,75,205,61,36,24,401
Missouri,Conception Junction,181,46,82,11,0,10,149
Missouri,Osgood village,20,0,7,0,0,2,9
Missouri,Village of Four Seasons village,2122,228,1173,208,2,102,1713
Missouri,Atlanta,594,153,152,116,15,30,466
Missouri,South Gifford village,53,16,8,14,0,5,43
Missouri,Jane,445,77,207,29,7,35,355
Missouri,Boonville,8410,2440,2621,1132,268,609,7070
Missouri,Concordia,2697,622,1035,247,17,215,2136
Missouri,Higginsville,4628,1212,1759,233,95,243,3542
Missouri,Mayview,269,66,105,20,7,15,213
Missouri,Waverly,942,207,376,74,3,82,742
Missouri,California,4375,810,1793,454,28,272,3357
Missouri,Ellington,1230,155,465,167,49,99,935
Missouri,Browning,202,41,86,20,3,10,160
Missouri,Greencastle,175,26,72,38,9,10,155
Missouri,Pollock village,40,7,10,2,0,16,35
Missouri,Urbana,336,42,105,67,5,40,259
Missouri,West Plains,12222,2675,4435,1454,200,935,9699
Missouri,Alexandria,103,41,34,13,3,9,100
Missouri,Lake Waukomis,846,93,532,80,13,31,749
Missouri,Lewis and Clark Village,142,38,59,4,0,9,110
Missouri,Tightwad village,48,3,31,12,0,0,46
Missouri,Terre du Lac,2663,357,1359,241,73,185,2215
Missouri,St. George,1666,501,611,139,0,154,1405
Missouri,Quitman,16,2,6,5,0,2,15
Missouri,Bennett Springs,151,53,26,72,0,0,151
Missouri,Biehle,32,0,21,0,0,0,21
Missouri,Big Spring,268,22,14,71,0,11,118
Missouri,Blanchard,17,0,11,0,0,0,11
Missouri,Brewer,324,29,163,34,20,0,246
Missouri,Cherokee Pass,327,85,184,24,6,0,299
Missouri,Dawn,176,34,67,25,4,5,135
Missouri,Chesapeake,38,0,25,0,0,0,25
Missouri,Conception,302,227,51,14,0,0,292
Missouri,Danville,26,8,0,0,0,9,17
Missouri,Defiance,88,0,55,33,0,0,88
Missouri,Doe Run,810,179,278,147,0,149,753
Missouri,Eagle Rock,163,39,97,0,17,0,153
Missouri,Edinburg,137,24,90,11,0,5,130
Missouri,Excello,11,0,0,11,0,0,11
Missouri,Fairdealing,819,170,373,54,15,42,654
Missouri,Frankclay,166,19,85,46,16,0,166
Missouri,Lithium,117,67,50,0,0,0,117
Missouri,Goodman,1441,237,481,195,20,130,1063
Missouri,Eugene,269,52,104,51,0,22,229
Missouri,Butterfield,538,102,250,58,0,9,419
Missouri,Burgess,66,5,25,3,0,7,40
Missouri,Zalma,82,23,32,7,0,6,68
Missouri,Ellsinore,498,89,143,52,2,58,344
Missouri,Bellerive Acres,170,35,105,13,0,13,166
Missouri,Climax Springs,220,72,60,17,27,8,184
Missouri,Calverton Park,1518,613,423,83,6,95,1220
Missouri,Grayhawk,686,148,278,106,14,45,591
Missouri,Golden,410,12,211,74,29,65,391
Missouri,Gilliam,198,34,93,26,3,11,167
Missouri,Fremont,28,11,12,0,0,0,23
Missouri,Velda Village Hills,918,361,162,107,24,130,784
Missouri,Ashley,75,0,14,0,0,61,75
Missouri,Carthage,14690,3127,5619,1251,228,789,11014
Missouri,Wayland,646,130,238,106,7,40,521
Missouri,Hopkins,362,68,182,27,7,21,305
Missouri,Graham,155,18,55,29,0,15,117
Missouri,Cooter,406,83,135,73,6,31,328
Missouri,Glen Allen,192,44,69,15,4,0,132
Missouri,Farmington,18269,4695,6667,2436,467,1086,15351
Missouri,Hale,433,94,157,46,4,24,325
Missouri,Bogard,133,17,60,31,0,10,118
Missouri,Houstonia,134,29,54,22,6,12,123
Missouri,Green Ridge,452,84,201,40,2,23,350
Missouri,Novinger,382,119,132,38,2,41,332
Missouri,Armstrong,281,46,85,32,12,16,191
Missouri,Park Hills,8568,1876,2938,897,187,457,6355
Missouri,Leadington,601,140,219,80,22,36,497
Missouri,Desloge,4896,961,1919,525,86,530,4021
Missouri,Maryville,11771,5977,3435,652,90,378,10532
Missouri,Peculiar,5006,941,2155,510,60,231,3897
Missouri,Belton,23348,4651,9583,2411,506,1179,18330
Missouri,Archie,1327,225,531,123,7,57,943
Missouri,Miner,981,191,427,94,43,99,854
Missouri,Haywood City village,139,32,46,21,2,14,115
Missouri,Chaffee,2920,682,1024,417,63,194,2380
Missouri,Jamesport,548,139,185,53,8,44,429
Missouri,Arcadia,653,73,276,131,6,61,547
Missouri,Bull Creek village,524,77,111,102,20,9,319
Missouri,Holden,2453,375,1108,242,28,126,1879
Missouri,Fountain N' Lakes village,193,49,58,26,2,20,155
Missouri,Gallatin,1730,363,648,189,21,191,1412
Missouri,Slater,2061,419,812,227,45,143,1646
Missouri,Marshall,13001,3655,4167,1310,264,875,10271
Missouri,Blackburn,309,35,165,30,4,14,248
Missouri,Lake Winnebago,1114,86,744,70,5,37,942
Missouri,Callao,337,99,127,22,7,24,279
Missouri,Billings,983,158,340,227,23,65,813
Missouri,Wooldridge village,21,2,9,6,2,1,20
Missouri,Highlandville,1044,196,494,129,11,41,871
Missouri,Fairfax,609,79,317,72,3,48,519
Missouri,Westboro,121,23,55,4,3,10,95
Missouri,St. Martins,1172,222,580,138,4,33,977
Missouri,Taos,1310,214,584,80,9,74,961
Missouri,Eagleville,265,58,81,49,6,26,220
Missouri,Weldon Spring,5545,726,3379,286,0,457,4848
Missouri,Stewartsville,697,105,286,130,3,46,570
Missouri,Grain Valley,13715,2780,5534,1466,265,507,10552
Missouri,McCord Bend village,391,43,116,48,19,28,254
Missouri,Schell City,273,74,104,25,6,11,220
Missouri,Hayti,2714,675,792,269,39,267,2042
Missouri,Cape Girardeau,39323,14222,12111,3952,485,2298,33068
Missouri,Versailles,2760,751,776,399,100,186,2212
Missouri,Ritchey,55,7,27,7,0,12,53
Missouri,Granby,2311,357,1047,173,65,75,1717
Missouri,Purdin,128,35,44,12,2,17,110
Missouri,Westwood village,337,70,175,14,12,15,286
Missouri,Allenville village,138,23,64,19,0,2,108
Missouri,Whitewater,116,23,25,20,3,18,89
Missouri,Jameson,65,8,26,14,1,9,58
Missouri,Urich,629,202,179,97,6,30,514
Missouri,Raymondville,496,116,185,41,11,24,377
Missouri,Clarksburg,218,65,73,37,14,2,191
Missouri,Washburn,491,87,200,23,13,51,374
Missouri,Martinsburg,306,52,147,40,7,20,266
Missouri,Savannah,5124,1205,2140,497,18,363,4223
Missouri,Calhoun,349,61,121,62,6,33,283
Missouri,Clinton,9107,1955,3191,1321,153,710,7330
Missouri,St. Louis,311273,126909,76109,33321,7869,14741,258949
Missouri,Wellington,787,180,263,87,39,55,624
Missouri,La Due village,46,1,24,20,0,0,45
Missouri,Wortham,226,44,116,8,0,17,185
Missouri,Winigan,52,3,13,7,0,8,31
Missouri,West Sullivan,197,42,64,9,4,3,122
Missouri,Foster village,184,13,151,4,0,2,170
Missouri,Parnell,183,37,72,16,2,10,137
Missouri,Amsterdam,220,51,84,31,10,20,196
Missouri,Pascola village,105,24,16,28,0,11,79
Missouri,Fleming,85,14,51,2,1,1,69
Missouri,Orrick,689,133,295,75,6,43,552
Missouri,Coney Island village,77,20,45,8,0,2,75
Missouri,Crane,1453,294,505,144,46,122,1111
Missouri,Milford village,18,0,11,2,0,5,18
Missouri,Cardwell,701,194,204,72,20,90,580
Missouri,Senath,1847,451,654,134,49,104,1392
Missouri,Cobalt village,242,40,97,53,3,27,220
Missouri,Jackson,14826,2717,6215,1809,210,625,11576
Missouri,Pocahontas,56,19,23,5,1,1,49
Missouri,Merwin village,30,12,13,4,0,1,30
Missouri,Sturgeon,820,113,380,91,18,54,656
Missouri,Greentop,583,187,203,66,0,48,504
Missouri,Prathersville village,142,26,64,23,0,11,124
Missouri,Craig,231,19,83,35,1,17,155
Missouri,Fortescue,42,5,4,10,0,0,19
Missouri,Elmo,159,33,66,19,4,12,134
Missouri,Oregon,997,126,457,80,10,90,763
Missouri,Rothville village,73,22,25,2,0,4,53
Missouri,Catron,37,9,13,1,0,12,35
Missouri,Skidmore,221,38,87,25,6,25,181
Missouri,Green City,550,91,196,94,2,38,421
Missouri,Kahoka,2100,405,792,291,28,156,1672
Missouri,Clever,2592,445,1065,265,9,102,1886
Missouri,Nixa,21113,3643,9457,2304,121,885,16410
Missouri,Denver village,34,3,21,0,0,1,25
Missouri,Downing,408,76,168,28,13,22,307
Missouri,Gilman City,413,53,162,53,7,21,296
Missouri,Jacksonville village,122,30,48,22,9,1,110
Missouri,New Melle,442,69,276,19,1,17,382
Missouri,Mexico,11544,2682,3741,1663,231,740,9057
Missouri,Grand Pass village,76,28,39,0,0,4,71
Missouri,Twin Oaks village,342,83,167,47,0,13,310
Missouri,Northwoods,4148,1656,857,608,123,406,3650
Missouri,Moline Acres,2355,908,475,224,34,172,1813
Missouri,Theodosia village,168,23,81,27,3,20,154
Missouri,Pasadena Hills,994,233,391,149,28,48,849
Missouri,Breckenridge Hills,4654,2004,1090,525,15,163,3797
Missouri,Montgomery City,2685,530,970,352,72,169,2093
Missouri,Avondale,502,135,186,63,12,10,406
Missouri,Tindall,82,26,37,0,0,10,73
Missouri,Trimble,660,140,225,95,40,21,521
Missouri,Brimson village,44,6,11,9,5,2,33
Missouri,Agency village,866,169,368,50,0,34,621
Missouri,New Madrid,2945,651,966,464,91,172,2344
Missouri,Truxton village,163,74,23,24,5,6,132
Missouri,Moscow Mills,2829,684,876,290,52,75,1977
Missouri,St. Thomas,249,66,108,13,0,8,195
Missouri,Wardsville village,1731,299,869,93,6,52,1319
Missouri,Lake St. Louis,15646,3015,7681,1539,49,614,12898
Missouri,Houston,2559,598,825,425,42,218,2108
Missouri,Bonne Terre,7110,3124,1933,869,205,238,6369
Missouri,Gibbs village,107,29,43,7,0,2,81
Missouri,Walnut Grove,635,83,270,100,25,34,512
Missouri,Millard village,71,14,23,4,14,4,59
Missouri,River Bend village,7,1,2,4,0,0,7
Missouri,Corning,5,0,4,0,0,1,5
Missouri,Maitland,289,58,95,48,12,11,224
Missouri,Keytesville,390,84,152,58,3,36,333
Missouri,Parkway village,561,128,187,96,7,41,459
Missouri,Elsberry,1958,399,687,240,33,156,1515
Missouri,Kirksville,17483,8608,3996,1400,261,974,15239
Missouri,Palmyra,3607,754,1387,382,36,286,2845
Missouri,Bowling Green,5501,1974,1250,1007,171,297,4699
Missouri,Luray village,87,9,41,11,0,3,64
Missouri,Hartwell,37,0,30,0,0,0,30
Missouri,Harviell,0,0,0,0,0,0,0
Missouri,Hayward,117,12,64,3,0,6,85
Missouri,Hunter,128,0,45,21,0,38,104
Missouri,Irwin,49,0,20,0,0,29,49
Missouri,Kissee Mills,1002,98,451,220,0,100,869
Missouri,LaBarque Creek,1668,336,886,140,22,30,1414
Missouri,Lake Tekakwitha village,220,70,88,28,7,6,199
Missouri,Lake Viking,360,16,260,27,0,20,323
Missouri,La Tour,139,26,61,22,7,7,123
Missouri,Laurie,1024,161,396,171,9,193,930
Missouri,Leisure Lake,123,7,71,5,10,14,107
Missouri,Mine La Motte,332,0,129,49,55,8,241
Missouri,Montier,23,23,0,0,0,0,23
Missouri,Old Jamestown,19439,4895,8660,1698,220,1072,16545
Missouri,Oxly,160,30,56,10,0,41,137
Missouri,Ozora,117,10,104,1,1,1,117
Missouri,Weingarten,74,8,24,17,0,0,49
Missouri,Wasola,140,11,76,22,0,17,126
Missouri,Thomasville,0,0,0,0,0,0,0
Missouri,Sundown,34,0,25,0,0,9,34
Missouri,South Fork,92,0,67,20,5,0,92
Missouri,Shoal Creek Estates village,91,9,54,7,2,2,74
Missouri,Grayridge,143,28,57,5,4,24,118
Missouri,St. Francisville,162,31,85,17,0,7,140
Missouri,Ravanna,92,33,33,2,0,22,90
Missouri,Pontiac,229,0,145,0,0,34,179
Missouri,Pomona,349,41,243,25,0,9,318
Missouri,Plevna,13,0,0,0,0,13,13
Missouri,Phelps City,0,0,0,0,0,0,0
Missouri,Peaceful Village village,43,20,2,6,4,11,43
Missouri,St. Clement,207,59,68,0,8,0,135
Missouri,New Florence,739,146,271,62,28,96,603
Missouri,Wood Heights,646,124,321,60,4,16,525
Missouri,Waco,59,6,29,9,4,4,52
Missouri,Spokane,91,0,70,0,0,0,70
Missouri,Bucklin,383,40,189,71,5,26,331
Missouri,Meadville,466,48,220,64,0,22,354
Missouri,Neosho,12009,2723,4518,1307,233,616,9397
Missouri,Ashburn,0,0,0,0,0,0,0
Missouri,Otterville,395,78,145,40,5,27,295
Missouri,Springfield,166633,55688,53321,19932,2686,9593,141220
Missouri,Leeton,570,75,285,54,13,13,440
Missouri,Clarksville,444,57,208,63,10,42,380
Missouri,Ethel,51,9,26,3,0,3,41
Missouri,New Cambria,140,19,81,25,0,3,128
Missouri,Fulton,12799,4819,3531,1677,326,582,10935
Missouri,Cuba,3340,691,863,513,67,394,2528
Missouri,Bigelow village,8,0,0,4,0,4,8
Missouri,Mendon,223,65,112,9,2,9,197
Missouri,Salisbury,1907,377,781,209,58,114,1539
Missouri,Sumner,113,42,21,14,0,7,84
Missouri,Saddlebrooke village,277,26,200,0,3,3,232
Missouri,Oak Grove Village village,464,96,181,41,11,27,356
Missouri,Huntsdale,8,0,4,4,0,0,8
Missouri,Ginger Blue village,33,2,19,10,0,2,33
Missouri,Three Creeks village,8,0,8,0,0,0,8
Missouri,Worth village,65,10,26,8,2,1,47
Missouri,Windsor Place village,361,56,170,23,6,23,278
Missouri,Wyatt,305,52,120,45,10,16,243
Missouri,Powersville village,39,3,18,7,4,1,33
Missouri,Taneyville village,288,39,135,27,12,10,223
Missouri,Rockaway Beach,891,135,341,188,17,30,711
Missouri,Union,11274,2498,4397,1092,202,555,8744
Missouri,Miramiguoa Park village,94,17,36,13,2,3,71
Missouri,Gerald,1300,198,553,97,44,64,956
Missouri,Bethel village,98,10,63,10,0,8,91
Missouri,Nelson,154,43,59,10,0,13,125
Missouri,Baring,136,53,56,12,1,6,128
Missouri,Farber,322,72,139,40,1,22,274
Missouri,Russellville,751,184,286,98,17,39,624
Missouri,Bethany,3065,669,927,438,116,358,2508
Missouri,Blythedale village,180,39,71,18,1,15,144
Missouri,Willard,5453,770,2666,544,27,225,4232
Missouri,Chilhowee,397,69,144,36,12,28,289
Missouri,Warrensburg,20025,8754,5962,1351,295,682,17044
Missouri,Lancaster,853,150,280,85,18,68,601
Missouri,Curryville,188,25,70,32,3,15,145
Missouri,Queen City,694,86,236,140,3,36,501
Missouri,Hillsboro,3105,963,1021,247,96,144,2471
Missouri,Kimmswick,136,24,73,6,0,8,111
Missouri,Murphy,8163,1939,2843,1112,98,417,6409
Missouri,Parkdale village,186,30,105,7,3,13,158
Missouri,Purdy,1338,408,454,135,10,51,1058
Missouri,Knob Noster,2770,758,997,370,42,74,2241
Missouri,Imperial,4279,835,2114,376,9,210,3544
Missouri,Centertown,319,46,124,49,15,24,258
Missouri,Josephville village,372,59,224,22,1,22,328
Missouri,Portage Des Sioux,376,93,150,38,3,14,298
Missouri,St. Charles,69576,21044,26504,7249,658,3617,59072
Missouri,Wentzville,37485,6859,16915,2202,340,1073,27389
Missouri,Summersville,541,169,144,67,1,54,435
Missouri,Irondale,416,71,124,60,5,40,300
Missouri,Fayette,2694,1188,792,238,0,178,2396
Missouri,Arrow Rock,45,1,19,8,0,8,36
Missouri,Mount Leonard,42,1,32,4,0,2,39
Missouri,Diggins village,270,43,134,20,1,25,223
Missouri,Niangua,608,47,258,84,6,28,423
Missouri,Laddonia,577,156,200,94,0,47,497
Missouri,Vandiver village,75,8,38,5,0,9,60
Missouri,Fisk,413,65,153,38,19,28,303
Missouri,Clarkton,1213,256,388,108,31,80,863
Missouri,Campbell,2165,377,585,462,80,142,1646
Missouri,Richards,181,26,52,26,1,5,110
Missouri,Gerster,26,0,21,2,0,2,25
Missouri,Lowry City,710,111,326,80,9,71,597
Missouri,Trenton,5846,1227,2304,575,92,491,4689
Missouri,Mercer,335,75,111,37,7,39,269
Missouri,Barnett,249,42,106,35,4,14,201
Missouri,Worthington village,201,58,35,24,3,0,120
Missouri,Leonard village,64,10,32,0,0,8,50
Missouri,Shelbina,1530,250,587,170,24,199,1230
Missouri,Anniston,145,19,61,13,7,16,116
Missouri,Charleston,5704,2195,1682,648,131,289,4945
Missouri,Pinhook village,0,0,0,0,0,0,0
Missouri,Tarkio,1509,328,605,190,6,139,1268
Missouri,Caruthersville,5760,1659,1490,774,255,506,4684
Missouri,Holland,177,42,88,7,4,15,156
Missouri,St. Mary,365,113,98,39,13,35,298
Missouri,Bellflower,384,72,120,62,6,45,305
Missouri,High Hill,214,37,87,30,2,16,172
Missouri,Osceola,1025,262,365,161,24,82,894
Missouri,El Dorado Springs,3545,360,1176,654,151,296,2637
Missouri,Mindenmines,301,43,128,38,16,21,246
Missouri,Gower,1554,292,650,188,18,112,1260
Missouri,Holt,395,90,140,47,2,24,303
Missouri,Humansville,1026,196,345,163,21,157,882
Missouri,Cairo village,330,62,152,32,9,12,267
Missouri,Risco,370,84,161,38,2,16,301
Missouri,Winfield,1321,331,448,102,50,49,980
Missouri,Chain of Rocks village,95,23,39,10,0,3,75
Missouri,Gray Summit,2594,567,1059,171,86,138,2021
Missouri,Triplett,16,0,4,9,0,3,16
Missouri,Potosi,2617,558,891,405,44,280,2178
Missouri,Bismarck,1395,296,620,126,19,91,1152
Missouri,Canalou,215,41,75,23,14,10,163
Missouri,Chain-O-Lakes village,112,5,81,9,0,5,100
Missouri,Lincoln,926,183,335,135,27,92,772
Missouri,Carl Junction,7995,1192,3334,744,20,432,5722
Missouri,Bourbon,1946,381,712,339,27,106,1565
Missouri,Brunswick,854,159,264,127,22,117,689
Missouri,New Haven,1952,366,861,166,6,105,1504
Missouri,Grandin,269,56,68,34,9,13,180
Missouri,Granger village,30,6,9,0,0,7,22
Missouri,Fidelity,231,39,105,35,7,10,196
Missouri,Neck City,174,21,87,11,15,6,140
Missouri,Reeds,89,23,46,0,2,6,77
Missouri,Weston,1675,377,644,225,8,119,1373
Missouri,Revere,60,13,17,10,0,1,41
Missouri,Fremont Hills,1130,108,759,47,6,28,948
Missouri,Hermann,2422,387,1124,186,54,205,1956
Missouri,Rock Port,1452,292,686,171,6,96,1251
Missouri,Bloomsdale,772,163,325,80,5,40,613
Missouri,Innsbrook village,700,45,424,69,7,52,597
Missouri,Warrenton,8129,1858,2982,766,119,487,6212
Missouri,Hume,397,82,150,49,3,13,297
Missouri,Kingsville,256,31,121,30,4,16,202
Missouri,Strafford,2035,248,945,269,28,99,1589
Missouri,Republic,16044,2841,6346,1773,240,558,11758
Missouri,North Kansas City,4414,1907,780,931,69,262,3949
Missouri,Missouri City,543,78,297,65,9,25,474
Missouri,Liberty,30928,7315,12161,3457,383,1514,24830
Missouri,Kidder,213,36,93,29,8,14,180
Missouri,Oaks village,141,20,84,7,0,3,114
Missouri,Bland,505,147,157,69,29,36,438
Missouri,Cosby village,189,43,83,5,4,6,141
Missouri,Mansfield,1450,315,487,250,50,102,1204
Missouri,Hartville,578,153,187,83,20,56,499
Missouri,Weatherby Lake,1967,256,1142,155,6,62,1621
Missouri,Camden Point,512,78,252,56,19,8,413
Missouri,Naylor,793,183,261,85,24,51,604
Missouri,Iberia,674,188,203,79,8,64,542
Missouri,Cowgill,206,53,68,25,2,11,159
Missouri,Kansas City,481417,154923,152881,49878,7953,20958,386593
Missouri,St. Peters,56838,11586,25847,5552,511,2629,46125
Missouri,Wardell,234,30,112,34,10,18,204
Missouri,Van Buren,1080,179,302,150,25,95,751
Missouri,Airport Drive village,889,191,408,74,14,35,722
Missouri,Duenweg,1370,325,485,200,42,54,1106
Missouri,Lucerne village,80,14,28,5,0,8,55
Missouri,Unionville,1998,620,508,297,64,173,1662
Missouri,Clarence,917,185,297,100,7,100,689
Missouri,La Russell,121,15,49,2,3,14,83
Missouri,Sweet Springs,1572,344,643,219,19,98,1323
Missouri,Ridgely village,66,12,28,11,2,4,57
Missouri,Camdenton,3977,952,1135,654,28,318,3087
Missouri,Brandsville,99,10,48,20,2,8,88
Missouri,Riverside,3255,1145,966,311,83,119,2624
Missouri,Arbela,31,17,2,4,0,2,25
Missouri,Rutledge,83,3,38,6,1,5,53
Missouri,Huntsville,1527,387,543,166,18,125,1239
Missouri,Edgerton,517,123,197,36,2,22,380
Missouri,Sarcoxie,1343,300,379,282,27,99,1087
Missouri,Duquesne village,1839,516,648,249,5,138,1556
Missouri,Iatan village,48,7,14,21,0,1,43
Missouri,Moberly,13762,4031,4321,1739,183,954,11228
Missouri,Frohna,235,53,125,15,4,8,205
Missouri,Carrollton,3637,565,1468,386,119,290,2828
Missouri,Altenburg,372,58,208,16,0,25,307
Missouri,Leadwood,1382,331,445,161,49,110,1096
Missouri,Rocheport,260,42,98,35,1,17,193
Missouri,Jefferson City,43013,12420,14812,5687,616,1938,35473
Missouri,Odessa,5189,881,2115,827,9,303,4135
Missouri,Deepwater,432,64,144,75,11,33,327
Missouri,Blackwater,198,25,78,28,3,5,139
Missouri,Arcola village,80,6,64,2,1,0,73
Missouri,Frankford,404,42,180,72,6,46,346
Missouri,Hurley,237,45,110,30,0,4,189
Missouri,Elmira village,29,6,8,8,1,2,25
Missouri,Bloomfield,2086,292,772,351,59,187,1661
Missouri,Dudley,218,58,91,31,10,9,199
Missouri,Oak Grove,8008,1572,2948,756,55,381,5712
Missouri,Lake Lotawana,2092,415,1173,130,11,56,1785
Missouri,Unity Village village,92,50,15,26,0,1,92
Missouri,Dexter,7885,1358,2819,1376,175,811,6539
Missouri,Lexington,4558,1003,1505,788,124,453,3873
Missouri,Napoleon,213,26,110,21,0,13,170
Missouri,Jamestown,462,74,177,49,9,22,331
Missouri,Velda City,1367,478,250,144,56,135,1063
Missouri,Mill Spring village,130,41,31,26,2,8,108
Missouri,Ludlow,122,24,66,10,0,6,106
Missouri,Excelsior Estates village,203,47,57,28,8,10,150
Missouri,Osage Beach,4909,1143,2124,481,28,339,4115
Missouri,Vandalia,4178,1263,1294,693,164,270,3684
Missouri,Collins village,178,41,68,25,3,15,152
Missouri,Chillicothe,9136,2079,3166,1323,241,725,7534
Missouri,Reeds Spring,987,155,458,72,17,36,738
Missouri,Kennett,10225,2274,3645,1356,251,676,8202
Missouri,Golden City,671,111,260,105,18,64,558
Missouri,Liberal,644,121,241,84,17,63,526
Missouri,Stockton,1818,278,769,243,69,139,1498
Missouri,Miller,756,79,312,121,8,24,544
Missouri,Holliday village,102,20,27,18,2,23,90
Missouri,Newburg,492,111,174,56,0,69,410
Missouri,Bel-Nor village,1389,450,490,160,34,76,1210
Missouri,Cool Valley,1164,457,299,119,34,62,971
Missouri,Crestwood,11881,2042,5796,1164,112,583,9697
Missouri,Flordell Hills,898,395,136,70,25,28,654
Missouri,Hanley Hills village,1832,758,382,226,31,132,1529
Missouri,Moundville,143,14,69,16,3,11,113
Missouri,Rensselaer village,241,36,167,5,1,5,214
Missouri,Anderson,2254,492,746,281,66,145,1730
Missouri,McKittrick,56,18,15,3,0,7,43
Missouri,Sullivan,6496,1291,2386,909,116,495,5197
Missouri,Lewistown,685,133,295,69,5,42,544
Missouri,Sugar Creek,3309,717,1074,525,89,153,2558
Missouri,La Grange,958,281,403,98,8,48,838
Missouri,Livonia village,95,28,13,2,0,8,51
Missouri,Hunnewell,158,23,62,40,2,10,137
Missouri,Center,477,91,192,63,6,46,398
Missouri,Puxico,931,211,344,95,10,94,754
Missouri,Chamois,438,109,166,66,7,29,377
Missouri,Linn,1654,530,562,148,27,39,1306
Missouri,Doniphan,2236,435,699,364,33,303,1834
Missouri,Hollister,4504,875,1660,643,92,399,3669
Missouri,Gentry village,63,11,32,5,0,1,49
Missouri,King City,962,154,461,86,0,63,764
Missouri,Stanberry,1222,209,561,57,10,106,943
Missouri,Benton,913,182,376,120,7,28,713
Missouri,Vanduser village,194,66,58,38,0,21,183
Missouri,Jonesburg,704,105,314,56,22,81,578
Missouri,Breckenridge,299,46,164,35,0,17,262
Missouri,Ionia,90,4,35,16,4,14,73
Missouri,Princeton,1083,241,277,176,9,142,845
Missouri,Galt,184,46,76,40,0,19,181
Missouri,Halfway village,136,16,50,15,7,11,99
Missouri,Marlborough village,2457,1437,547,247,58,41,2330
Missouri,Aldrich village,66,17,27,8,0,3,55
Missouri,Troy,11771,3249,3814,1121,178,656,9018
Missouri,Silex village,62,51,7,0,0,1,59
Missouri,Hawk Point,809,156,312,77,8,59,612
Missouri,Festus,11970,2588,5003,1428,143,642,9804
Missouri,Garden City,1494,295,527,240,50,100,1212
Missouri,Creighton,329,91,115,43,7,22,278
Missouri,Morehouse,913,207,350,127,17,65,766
Missouri,Rock Hill,4637,1520,1581,452,0,185,3738
Missouri,St. Ann,12853,3901,3509,1639,161,798,10008
Missouri,Lake Ozark,1759,322,881,145,15,104,1467
Missouri,Linneus,282,41,148,18,4,20,231
Missouri,Joplin,50073,12950,17993,6080,731,2910,40664
Missouri,Leawood village,584,62,330,19,10,37,458
Missouri,Redings Mill village,148,26,71,19,1,14,131
Missouri,Stotesbury,17,1,11,2,0,2,16
Missouri,Maplewood,8008,3237,2285,965,72,153,6712
Missouri,Halltown village,165,39,43,23,9,6,120
Missouri,Pine Lawn,3513,1268,477,268,104,198,2315
Missouri,Brumley,95,29,36,0,7,6,78
Missouri,Walker,257,38,120,27,0,21,206
Missouri,Stoutsville village,24,3,5,4,4,6,22
Missouri,Crystal Lake Park,430,65,223,37,2,35,362
Missouri,Eureka,10575,1719,5218,616,190,370,8113
Missouri,Florissant,51744,14426,16728,5420,554,3091,40219
Missouri,Norwood Court,985,396,162,106,38,66,768
Missouri,Oakville,36827,7928,18624,2390,231,1864,31037
Missouri,Shrewsbury,6166,1605,2311,418,54,766,5154
Missouri,Utica village,157,17,117,9,2,10,155
Missouri,Spanish Lake,18048,6181,4558,1670,451,758,13618
Missouri,Lawson,2363,326,1079,238,26,161,1830
Missouri,Merriam Woods village,2001,442,697,242,79,40,1500
Missouri,Rosendale,138,16,58,24,0,3,101
Missouri,Country Club village,2810,524,1286,207,25,99,2141
Missouri,Brookfield,4481,1015,1575,493,101,344,3528
Missouri,Bolckow,159,21,70,28,2,14,135
Missouri,Loma Linda,754,88,491,59,2,33,673
Missouri,Fairview,471,63,174,66,10,35,348
Missouri,Diamond,921,197,368,115,4,66,750
Missouri,Blairstown,122,22,41,25,5,4,97
Missouri,University City,34653,11357,12830,2710,687,1902,29486
Missouri,Sycamore Hills village,673,200,240,95,0,45,580
Missouri,Newtonia,192,36,100,10,0,13,159
Missouri,Richmond,5606,1414,1929,719,45,504,4611
Missouri,Sheridan,200,10,111,29,0,6,156
Missouri,Hartsburg,94,28,28,21,0,9,86
Missouri,Olean,55,7,17,9,4,10,47
Missouri,Deerfield village,42,5,19,6,3,1,34
Missouri,Milo village,79,16,46,9,0,0,71
Missouri,Oronogo,2580,500,1113,172,31,36,1852
Missouri,Bates City,207,32,101,23,0,20,176
Missouri,Dover,81,12,45,1,0,12,70
Missouri,Lake Lafayette,313,93,112,48,2,19,274
Missouri,Farley village,250,48,130,16,0,7,201
Missouri,Ferrelview village,538,185,118,106,23,35,467
Missouri,Houston Lake,379,167,145,26,7,16,361
Missouri,Northmoor,481,117,99,130,17,7,370
Missouri,Parkville,6524,1150,3200,794,50,136,5330
Missouri,Platte City,4905,1126,1792,509,111,183,3721
Missouri,Tracy,282,64,134,8,6,11,223
Missouri,South Gorin,87,17,42,6,7,2,74
Missouri,Bel-Ridge village,2718,1151,391,208,40,95,1885
Missouri,Bragg City,145,28,41,16,4,5,94
Missouri,Harrisburg,329,47,139,17,1,25,229
Missouri,Ashland,3905,707,1520,267,27,362,2883
Missouri,Macon,5379,1064,1950,561,114,459,4148
Missouri,Buffalo,3032,588,938,372,73,285,2256
Missouri,Carytown,257,35,151,7,0,12,205
Missouri,Brooklyn Heights,105,20,43,17,1,5,86
Missouri,Oakwood village,176,13,105,13,0,9,140
Missouri,Avilla,68,8,26,4,0,6,44
Missouri,Salem,4939,1071,1453,594,88,801,4007
Missouri,Rockville,123,21,38,26,0,20,105
Missouri,Lupus,29,9,7,13,0,0,29
Missouri,St. James,4112,857,1696,411,130,299,3393
Missouri,Malta Bend,240,84,61,29,0,14,188
Missouri,Fordland,915,161,349,124,22,41,697
Missouri,Alba,710,182,260,57,9,27,535
Missouri,Winston village,244,63,82,30,7,22,204
Missouri,Platte Woods,414,66,204,49,4,43,366
Missouri,Viburnum,734,94,318,61,18,36,527
Missouri,Arnold,21107,4710,8744,2177,400,1409,17440
Missouri,Laredo,212,30,63,53,15,13,174
Missouri,Brashear,156,33,58,26,0,11,128
Missouri,Newark village,82,21,37,8,0,4,70
Missouri,Hamilton,1771,334,654,245,31,136,1400
Missouri,Bosworth,166,35,73,30,1,10,149
Missouri,Tina village,293,82,163,4,0,8,257
Missouri,Iron Mountain Lake,687,150,274,106,11,45,586
Missouri,Caledonia village,185,52,73,22,1,11,159
Missouri,New Franklin,1105,233,416,137,6,64,856
Missouri,Butler,4164,678,1450,544,125,371,3168
Missouri,Poplar Bluff,17107,4190,5086,2510,522,1199,13507
Missouri,Cainsville,219,36,102,14,4,16,172
Missouri,Pleasant Hope,684,114,285,93,0,20,512
Missouri,Easton,266,50,135,32,2,6,225
Missouri,South Lineville,12,0,10,0,1,0,11
Missouri,Castle Point,2593,991,401,225,37,101,1755
Missouri,Paris,1445,341,482,195,6,137,1161
Missouri,Edgar Springs,194,11,62,37,11,8,129
Missouri,Charlack,1473,586,387,111,55,35,1174
Missouri,Chesterfield,47663,8687,24425,3335,331,2971,39749
Missouri,East Lynne,220,52,56,39,6,16,169
Missouri,Clayton,16448,6893,6023,926,64,554,14460
Missouri,Diehlstadt village,188,36,93,13,2,6,150
Missouri,Forsyth,2536,501,958,360,61,261,2141
Missouri,Marceline,2021,378,739,270,46,104,1537
Missouri,Dennis Acres village,41,12,15,5,1,6,39
Missouri,Stark City,137,26,64,7,1,6,104
Missouri,St. Robert,5767,1058,2672,809,56,88,4683
Missouri,Canton,2616,929,792,192,43,116,2072
Missouri,Gravois Mills,172,50,17,23,5,3,98
Missouri,Stover,1359,277,359,179,19,147,981
Missouri,Syracuse,144,11,57,19,10,8,105
Missouri,Auxvasse,1183,179,486,109,27,65,866
Missouri,Pagedale,3291,1155,594,374,146,150,2419
Missouri,St. John,6432,1954,2011,713,137,378,5193
Missouri,Emma,232,45,114,17,0,20,196
Missouri,Lathrop,2259,442,934,179,57,101,1713
Missouri,Spickard,295,88,80,45,10,11,234
Missouri,Sunrise Beach village,363,60,162,52,13,19,306
Missouri,Sedgewickville village,161,11,79,9,3,2,104
Missouri,Marshfield,7226,1403,2823,673,88,424,5411
Missouri,Rogersville,3644,710,1479,301,39,168,2697
Missouri,Marble Hill,1727,368,622,185,24,116,1315
Missouri,Hayti Heights,612,211,52,13,54,22,352
Missouri,Foristell,639,106,326,43,0,22,497
Missouri,McFall,95,21,35,8,0,8,72
Missouri,Glasgow Village,4981,1920,935,189,150,134,3328
Missouri,Greendale,822,275,261,85,20,29,670
Missouri,Huntleigh,533,149,246,8,0,25,428
Missouri,Darlington village,64,6,23,5,0,16,50
Missouri,Rea,38,1,24,5,0,7,37
Missouri,Miami,92,17,40,10,0,1,68
Missouri,Ewing,383,59,174,58,11,17,319
Missouri,Birch Tree,705,97,249,131,15,73,565
Missouri,Grand Falls Plaza,118,15,54,13,2,9,93
Missouri,Seligman,862,146,274,126,29,40,615
Missouri,Renick village,152,47,61,18,6,3,135
Missouri,Longtown,123,40,52,6,2,4,104
Missouri,Neelyville,354,74,99,51,19,17,260
Missouri,Bernie,1957,248,781,247,26,117,1419
Missouri,Baker village,0,0,0,0,0,0,0
Missouri,Lanagan,411,81,123,68,26,25,323
Missouri,Lockwood,1154,275,404,129,36,136,980
Missouri,Greenfield,1503,255,552,171,53,157,1188
Missouri,Polo,551,144,176,68,24,34,446
Missouri,Braymer,686,128,275,99,8,75,585
Missouri,Windsor,2990,464,1260,265,68,285,2342
Missouri,Novelty village,175,34,84,15,2,6,141
Missouri,Wright City,3593,575,1334,366,80,103,2458
Missouri,Steele,2188,546,742,153,113,118,1672
Missouri,Blodgett village,192,50,56,31,0,0,137
Missouri,Foley,122,34,32,25,5,2,98
Missouri,Whiteside village,60,13,17,12,4,6,52
Missouri,Morrisville,419,80,186,62,4,23,355
Missouri,Kirkwood,27693,4971,12740,2354,232,1563,21860
Missouri,Excelsior Springs,11575,2714,4511,1018,188,717,9148
Missouri,Hornersville,597,111,245,65,4,61,486
Missouri,Coffey,188,42,60,22,6,12,142
Missouri,Pilot Knob,684,186,231,71,19,34,541
Missouri,Ash Grove,1634,327,671,135,7,173,1313
Missouri,St. Clair,4693,839,1792,544,84,377,3636
Missouri,Big Lake village,102,0,88,9,0,5,102
Missouri,Hermitage,769,121,333,59,45,65,623
Missouri,Steelville,1888,408,622,193,59,188,1470
Missouri,Laclede,362,103,143,49,6,23,324
Missouri,Kingdom City village,170,38,92,11,0,7,148
Missouri,Gasconade,329,70,103,31,5,14,223
Missouri,Ozark,19418,3459,7877,1949,413,1043,14741
Missouri,Southwest City,1238,286,411,88,45,42,872
Missouri,Pineville,811,190,328,64,23,57,662
Missouri,Pierpont village,69,9,43,3,0,6,61
Missouri,Lamar Heights,198,33,62,23,9,15,142
Missouri,Plattsburg,2304,522,935,308,48,142,1955
Missouri,Rushville,250,43,110,17,0,19,189
Missouri,Loch Lloyd village,649,74,462,40,3,24,603
Missouri,De Kalb,210,42,97,21,2,13,175
Missouri,Owensville,2580,557,932,366,38,202,2095
Missouri,Tipton,3369,1153,1205,388,42,236,3024
Missouri,Brentwood,8023,2991,2554,897,24,233,6699
Missouri,Aullville village,106,22,53,3,0,3,81
Missouri,Birmingham village,204,49,82,25,6,9,171
Missouri,Benton City village,188,20,72,30,2,8,132
Missouri,Rush Hill village,175,50,67,14,4,8,143
Missouri,Arkoe,44,14,19,8,0,0,41
Missouri,Warson Woods,1915,237,1011,95,19,82,1444
Missouri,Piedmont,2621,432,893,463,97,237,2122
Missouri,Vienna,678,125,209,86,7,104,531
Missouri,Clyde village,72,5,35,2,2,0,44
Missouri,Guilford,56,5,25,7,1,5,43
Missouri,Pickering,119,42,45,15,0,2,104
Missouri,Harris,18,3,9,6,0,0,18
Missouri,Humphreys village,81,20,26,15,5,9,75
Missouri,Milan,2670,712,906,259,50,215,2142
Missouri,Newtown,190,54,57,17,2,27,157
Missouri,Claycomo village,1419,368,478,274,23,157,1300
Missouri,Glenwood village,214,40,79,14,0,20,153
Missouri,Paynesville village,47,5,27,9,0,4,45
Missouri,Grant City,908,131,418,123,13,79,764
Missouri,Bevier,696,166,269,70,7,69,581
Missouri,Elmer,73,7,40,5,0,3,55
Missouri,Holts Summit,3720,594,1619,402,100,313,3028
Missouri,Gladstone,26995,6569,10563,3260,474,1516,22382
Missouri,Battlefield,6104,935,2751,462,74,261,4483
Missouri,Pleasant Hill,8418,1435,3631,737,64,285,6152
Missouri,Oakview village,482,99,202,64,8,14,387
Missouri,Warsaw,2469,493,767,369,20,335,1984
Missouri,St. Paul,2431,463,1465,43,4,82,2057
Missouri,Augusta,266,66,106,29,2,10,213
Missouri,Qulin,554,101,178,74,14,50,417
Missouri,Corder,386,82,173,26,2,21,304
Missouri,Cole Camp,1168,110,551,161,0,151,973
Missouri,Louisiana,3272,924,1166,320,31,247,2688
Missouri,Umber View Heights village,51,1,35,4,0,8,48
Missouri,Bronaugh,207,23,64,45,7,3,142
Missouri,Vista village,64,25,29,2,0,0,56
Missouri,Monroe City,2487,531,845,348,15,194,1933
Missouri,Gainesville,685,99,193,137,15,65,509
Missouri,Lakeside,0,0,0,0,0,0,0
Missouri,Kimberling City,2714,246,1438,422,28,186,2320
Missouri,Norborne,830,135,376,91,20,56,678
Missouri,Wheaton,647,130,279,29,0,54,492
Missouri,Emerald Beach village,276,12,204,30,3,24,273
Missouri,Cassville,3289,681,1224,283,30,362,2580
Missouri,Scotsdale,168,30,92,12,4,7,145
Missouri,Byrnes Mill,2944,552,1443,253,83,110,2441
Missouri,Morley,726,167,271,110,21,67,636
Missouri,De Soto,6390,1198,2266,871,157,563,5055
Missouri,Bakersfield village,244,66,69,20,0,17,172
Missouri,Tarrants village,0,0,0,0,0,0,0
Missouri,Eolia village,489,87,177,67,0,45,376
Missouri,Sparta,1642,276,634,238,38,85,1271
Missouri,Altamont village,173,50,62,14,1,16,143
Missouri,Des Arc village,211,35,84,18,7,11,155
Missouri,Bunker,347,88,114,52,3,48,305
Missouri,Barnard,234,55,119,18,0,6,198
Missouri,Clearmont,169,27,95,17,0,6,145
Missouri,Linn Creek,302,46,104,60,2,26,238
Missouri,Louisburg village,68,9,31,8,0,9,57
Missouri,Hallsville,1579,359,534,192,33,77,1195
Missouri,Glenaire,496,72,232,59,5,45,413
Missouri,Pleasant Valley,3033,814,1150,324,43,165,2496
Missouri,Fair Grove,1624,238,752,136,14,85,1225
Missouri,Kearney,9778,2010,4096,1081,79,349,7615
Missouri,Flint Hill,564,107,339,16,5,10,477
Missouri,Lohman,174,17,91,19,0,6,133
Missouri,Mount Moriah,75,13,18,18,3,5,57
Missouri,Ridgeway,378,65,139,64,1,37,306
Missouri,Weldon Spring Heights,93,14,60,1,0,9,84
Missouri,Dixon,1256,290,417,153,59,75,994
Missouri,Shoal Creek Drive village,463,103,159,59,2,37,360
Missouri,Wentworth village,111,19,62,5,5,3,94
Missouri,Crocker,1152,282,367,123,28,93,893
Missouri,La Belle,688,143,282,79,9,75,588
Missouri,Bunceton,333,88,116,50,4,21,279
Missouri,Dutchtown village,22,9,12,0,0,1,22
Missouri,Wyaconda,190,50,55,41,0,15,161
Missouri,Rives,53,3,16,12,0,3,34
Missouri,Blue Eye,280,81,76,69,5,16,247
Missouri,Stella,161,49,45,15,0,14,123
Missouri,Winona,1395,291,420,251,65,85,1112
Missouri,Prairie Home,264,43,108,35,7,14,207
Missouri,Penermon village,87,32,16,6,2,19,75
Missouri,Wellsville,1157,219,391,154,8,115,887
Missouri,Noel,2424,652,757,172,62,77,1720
Missouri,Advance,1246,202,493,198,37,150,1080
Missouri,Lamar,4329,989,1557,483,89,391,3509
Missouri,Delta,415,117,155,43,3,28,346
Missouri,Everton,359,73,145,54,7,12,291
Missouri,Franklin,58,10,37,3,6,2,58
Missouri,East Prairie,3096,666,1073,418,25,260,2442
Missouri,Malden,4244,1053,1315,480,156,361,3365
Missouri,Junction City village,309,78,80,65,5,25,253
Missouri,Marquand,316,84,121,27,10,28,270
Missouri,Gordonville village,511,95,254,26,5,58,438
Missouri,Oak Ridge,228,57,85,27,4,8,181
Missouri,Indian Point village,477,116,249,54,5,23,447
Missouri,Annapolis,420,147,139,55,24,25,390
Missouri,Arrow Point village,111,2,19,39,9,10,79
Missouri,Perryville,8403,1315,3599,660,239,684,6497
Montana,Olney,225,74,64,20,0,34,192
Montana,Midvale,462,101,144,143,0,43,431
Montana,Maxville,214,0,104,72,0,32,208
Montana,Marysville,67,4,53,0,0,10,67
Montana,Santa Rita,267,121,58,0,0,13,192
Montana,Pioneer Junction,849,53,606,60,0,39,758
Montana,Spokane Creek,344,72,240,9,0,23,344
Montana,South Hills,700,117,341,14,0,7,479
Montana,Silver Gate,25,1,20,0,0,0,21
Montana,Silesia,10,0,0,0,0,10,10
Montana,Shawmut,56,7,46,0,1,1,55
Montana,Sedan,97,3,49,37,0,8,97
Montana,Martinsdale,26,0,8,13,0,5,26
Montana,Sand Coulee,276,49,156,27,10,3,245
Montana,Roy,119,16,75,10,0,7,108
Montana,Rosebud,76,0,49,19,0,0,68
Montana,Roscoe,32,22,10,0,0,0,32
Montana,Rocky Boy West,878,296,190,63,3,36,588
Montana,Roberts,295,59,120,48,2,5,234
Montana,Rader Creek,195,26,112,17,0,20,175
Montana,Pray,751,88,422,95,0,44,649
Montana,Pony,125,19,67,10,0,0,96
Montana,Ponderosa Pines,328,11,146,84,10,9,260
Montana,Piltzville,433,132,236,50,0,5,423
Montana,Marion,930,106,539,85,0,17,747
Montana,Conner,91,10,35,36,0,0,81
Montana,Little Browning,260,84,48,18,0,0,150
Montana,Biddle,48,6,19,10,7,0,42
Montana,Belknap,317,41,147,0,0,71,259
Montana,Bear Dance,193,14,161,9,0,9,193
Montana,Batavia,328,48,114,49,2,30,243
Montana,Babb,160,30,69,35,0,14,148
Montana,Amsterdam,184,28,77,22,4,0,131
Montana,Alzada,24,2,5,13,0,4,24
Montana,Rocky Boy's Agency,475,150,131,26,8,12,327
Montana,Boulder,942,252,359,114,3,64,792
Montana,Belt,538,87,257,68,5,45,462
Montana,Frazer,330,120,48,37,0,12,217
Montana,Absarokee,859,120,419,141,40,36,756
Montana,St. Xavier,97,25,38,11,0,0,74
Montana,Muddy,626,167,199,35,0,11,412
Montana,Busby,715,230,163,52,30,14,489
Montana,Cardwell,96,20,30,2,2,4,58
Montana,Joplin,242,29,153,20,0,7,209
Montana,Springdale,57,1,28,3,0,3,35
Montana,St. Regis,305,77,61,58,5,17,218
Montana,Garrison,52,3,16,14,0,4,37
Montana,Helena Valley Southeast,8067,1770,3078,1042,257,154,6301
Montana,Herron,210,84,69,5,0,5,163
Montana,Inverness,41,11,11,0,0,9,31
Montana,Boyd,34,4,25,0,0,5,34
Montana,Rudyard,126,14,73,28,0,6,121
Montana,Columbia Falls,5225,1049,2381,568,27,330,4355
Montana,Lakeside,2160,359,979,234,50,181,1803
Montana,Reserve,34,6,20,0,0,3,29
Montana,Richey,187,34,96,10,2,17,159
Montana,Fort Belknap Agency,1514,510,331,76,20,56,993
Montana,Lodge Pole,232,82,67,7,0,6,162
Montana,Helena Valley West Central,8277,1196,4195,815,43,242,6491
Montana,Logan,31,7,16,0,0,8,31
Montana,Brady,141,53,55,6,0,8,122
Montana,Bynum,35,4,28,2,0,1,35
Montana,Little Bitterroot Lake,144,16,93,13,0,11,133
Montana,Lindisfarne,255,14,206,0,0,0,220
Montana,Lake Mary Ronan,77,19,55,0,0,3,77
Montana,King Arthur Park,1239,293,570,99,0,0,962
Montana,Kila,321,53,156,51,6,3,269
Montana,Jardine,33,9,24,0,0,0,33
Montana,Indian Springs,63,46,0,0,0,17,63
Montana,Huson,18,0,0,0,18,0,18
Montana,Hinsdale,285,132,104,18,2,9,265
Montana,Helena Flats,999,228,417,113,15,57,830
Montana,Hebgen Lake Estates,88,0,83,0,0,5,88
Montana,Happys Inn,102,26,76,0,0,0,102
Montana,Gibson Flats,219,19,146,12,0,0,177
Montana,Geyser,95,18,44,15,0,12,89
Montana,Gallatin River Ranch,105,0,88,0,0,0,88
Montana,Gallatin Gateway,868,165,442,70,19,23,719
Montana,Forest Hill Village,240,106,29,52,0,0,187
Montana,Camas,79,24,24,0,0,6,54
Montana,Carlton,686,122,392,0,0,90,604
Montana,Charlos Heights,97,0,84,13,0,0,97
Montana,Churchill,984,72,485,50,0,73,680
Montana,Condon,269,71,126,51,0,12,260
Montana,Cooke City,46,3,30,13,0,0,46
Montana,Bridger,49,25,24,0,0,0,49
Montana,Dupuyer,96,25,53,9,0,9,96
Montana,Craig,23,8,4,8,0,3,23
Montana,Crane,179,35,113,0,7,0,155
Montana,East Helena,1808,421,793,161,29,102,1506
Montana,Edgar,103,6,38,11,7,28,90
Montana,Elkhorn,0,0,0,0,0,0,0
Montana,Emigrant,233,82,55,67,0,29,233
Montana,Corwin Springs,98,21,47,9,0,8,85
Montana,Springhill,175,18,114,9,0,0,141
Montana,Saddle Butte,55,5,40,0,7,0,52
Montana,Stryker,38,9,17,8,0,0,34
Montana,Gardiner,971,316,391,67,28,52,854
Montana,Hungry Horse,575,89,233,78,0,48,448
Montana,Coram,439,112,195,71,0,19,397
Montana,Stevensville,2163,494,618,361,39,133,1645
Montana,Hamilton,4628,1099,1805,629,77,457,4067
Montana,Hays,996,340,198,55,26,56,675
Montana,Heart Butte,571,237,112,30,5,20,404
Montana,Helena,31212,9022,11021,4341,186,1600,26170
Montana,White Sulphur Springs,939,147,357,153,3,96,756
Montana,Wilsall,322,5,198,25,0,18,246
Montana,Lewistown Heights,559,151,225,52,0,11,439
Montana,West Yellowstone,1016,359,374,161,4,18,916
Montana,Four Corners,4336,684,1974,342,23,87,3110
Montana,Big Sky,3098,1181,1219,173,0,18,2591
Montana,Hingham,100,12,40,25,2,6,85
Montana,Beaver Creek,384,106,183,54,0,6,349
Montana,Twin Bridges,305,34,130,50,23,14,251
Montana,Winnett,165,21,60,27,5,11,124
Montana,De Borgia,70,0,62,8,0,0,70
Montana,Woods Bay,800,172,490,57,0,12,731
Montana,Jefferson City,521,87,176,106,15,14,398
Montana,Ennis,925,326,251,167,23,67,834
Montana,Jordan,473,133,226,51,0,9,419
Montana,Baker,1727,236,769,161,15,137,1318
Montana,Melstone,101,19,31,14,2,18,84
Montana,Evergreen,7907,1387,3571,758,135,500,6351
Montana,Sunburst,276,49,149,20,0,26,244
Montana,Fort Shaw,125,0,108,0,0,0,108
Montana,Worden,668,97,264,98,11,52,522
Montana,Shepherd,595,77,306,17,14,0,414
Montana,Reed Point,277,59,108,60,0,10,237
Montana,Fort Smith,107,13,60,5,0,18,96
Montana,Montana City,2796,528,1565,110,5,111,2319
Montana,Anaconda-Deer Lodge,9100,2370,3823,1086,104,643,8026
Montana,Basin,237,41,105,35,1,15,197
Montana,Billings,109431,26214,42469,12633,1092,5631,88039
Montana,Park City,746,125,380,100,0,25,630
Montana,Pryor,557,156,177,19,13,28,393
Montana,Lodge Grass,419,127,112,26,6,12,283
Montana,Chinook,944,186,374,135,23,114,832
Montana,West Glendive,1803,242,1052,82,3,83,1462
Montana,Sidney,6475,1487,2372,839,83,304,5085
Montana,Manhattan,1506,236,759,108,3,71,1177
Montana,Bozeman,45121,20387,14013,3643,250,1120,39413
Montana,Lockwood,7479,1760,2787,627,190,340,5704
Montana,Helena Valley Northeast,3201,297,1650,417,0,278,2642
Montana,Starr School,292,43,120,59,0,19,241
Montana,Cut Bank,3007,657,848,415,28,139,2087
Montana,Huntley,471,19,298,0,0,37,354
Montana,Savage,283,65,125,11,0,32,233
Montana,South Glastonbury,351,96,190,18,0,0,304
Montana,Zortman,30,10,0,12,0,8,30
Montana,Yaak,282,14,161,55,1,8,239
Montana,Wineglass,411,80,290,10,0,0,380
Montana,Whitewater,124,28,35,0,0,14,77
Montana,White Haven,490,104,174,80,0,51,409
Montana,Wheatland,398,9,266,11,0,9,295
Montana,Laurel,6849,1221,3132,616,48,458,5475
Montana,West Kootenai,64,15,31,0,0,18,64
Montana,Weeksville,72,9,32,12,0,19,72
Montana,Turner,84,27,40,8,0,3,78
Montana,Turah,394,52,205,8,0,16,281
Montana,The Silos,682,127,336,73,15,0,551
Montana,Sylvanite,70,3,46,3,0,9,61
Montana,Sweet Grass,55,8,36,0,0,3,47
Montana,Trego,554,128,277,49,0,55,509
Montana,Swan Lake,171,39,112,8,0,5,164
Montana,Sula,93,8,11,51,0,4,74
Montana,West Glacier,159,29,88,12,0,6,135
Montana,Gildford,158,29,80,12,0,13,134
Montana,Eureka,1405,249,562,252,13,110,1186
Montana,Troy,687,84,345,107,13,108,657
Montana,Colstrip,2446,322,1227,104,20,43,1716
Montana,Broadus,509,135,224,35,19,36,449
Montana,Lima,147,15,73,25,6,16,135
Montana,Libby,2663,597,970,398,38,244,2247
Montana,Havre,9762,2532,3029,1084,143,622,7410
Montana,Ovando,73,15,54,0,0,0,69
Montana,Kings Point,113,20,31,62,0,0,113
Montana,Kicking Horse,74,7,53,0,0,0,60
Montana,Hysham,293,36,166,18,3,23,246
Montana,Toston,79,16,44,0,0,19,79
Montana,Riverbend,358,155,110,31,0,62,358
Montana,Old Agency,88,23,18,12,7,3,63
Montana,Malta,2090,401,849,173,0,295,1718
Montana,Camp Three,177,29,94,5,0,3,131
Montana,Malmstrom AFB,4116,657,2128,54,11,16,2866
Montana,Black Eagle,1027,322,362,93,0,109,886
Montana,Brockton,224,105,12,26,0,9,152
Montana,Fox Lake,79,18,33,12,0,10,73
Montana,Wisdom,96,18,44,18,0,8,88
Montana,Joliet,475,126,161,72,9,32,400
Montana,Miles City,8576,1881,3273,1026,164,653,6997
Montana,Stockett,224,20,102,23,0,12,157
Montana,Rollins,218,53,91,31,0,9,184
Montana,Plains,893,210,332,77,37,100,756
Montana,Polson,4843,1123,1539,772,67,339,3840
Montana,Arlee,603,160,217,87,0,38,502
Montana,Carter,72,4,44,9,0,5,62
Montana,Winston,245,96,84,39,0,0,219
Montana,Musselshell,57,4,41,0,0,9,54
Montana,Circle,505,57,284,18,0,65,424
Montana,Fort Benton,1462,414,604,69,14,142,1243
Montana,Big Timber,1739,344,650,210,27,120,1351
Montana,Rocky Point,97,0,48,32,0,17,97
Montana,Fallon,68,10,25,5,0,15,55
Montana,Elliston,230,15,151,44,2,4,216
Montana,Highwood,197,37,77,34,0,11,159
Montana,East Glacier Park Village,520,157,164,56,3,30,410
Montana,Ulm,632,99,353,41,0,32,525
Montana,Somers,1088,216,603,44,24,62,949
Montana,Augusta,294,36,152,16,7,28,239
Montana,Fairview,978,231,353,99,18,66,767
Montana,St. Pierre,327,114,88,2,0,9,213
Montana,Charlo,320,86,106,41,16,18,267
Montana,Avon,152,59,68,3,0,5,135
Montana,Pablo,2655,643,620,222,54,64,1603
Montana,St. Ignatius,746,230,207,74,19,68,598
Montana,Lolo,3780,522,1847,306,0,97,2772
Montana,Willow Creek,247,37,111,31,6,15,200
Montana,Belgrade,8345,2245,3231,673,18,218,6385
Montana,Victor,753,112,288,34,0,100,534
Montana,West Havre,217,38,123,22,0,0,183
Montana,Dayton,75,9,63,0,0,3,75
Montana,Big Arm,242,30,195,0,0,0,225
Montana,Bridger,745,102,336,127,10,63,638
Montana,Harlowton,1076,277,388,132,8,99,904
Montana,Trout Creek,150,24,91,24,0,11,150
Montana,Orchard Homes,5859,1647,2442,499,118,138,4844
Montana,Evaro,416,109,148,87,14,5,363
Montana,Bonner-West Riverside,1726,616,584,145,24,51,1420
Montana,Opheim,89,23,49,6,0,6,84
Montana,Fairfield,654,118,266,89,0,47,520
Montana,Ronan,1985,536,553,305,26,149,1569
Montana,Deer Lodge,2976,536,1432,258,49,235,2510
Montana,Turtle Lake,325,0,132,0,0,0,132
Montana,Paradise,189,46,58,37,0,19,160
Montana,Livingston,7478,1573,2981,1057,68,417,6096
Montana,Radersburg,112,7,72,0,0,33,112
Montana,Hobson,198,19,111,29,0,7,166
Montana,Alder,92,5,62,7,0,0,74
Montana,Wolf Point,2799,866,680,348,33,173,2100
Montana,Froid,206,41,106,19,0,8,174
Montana,Wye,664,147,258,44,2,0,451
Montana,East Missoula,2132,726,761,205,44,54,1790
Montana,Azure,310,51,80,24,6,16,177
Montana,Plevna,226,11,112,4,9,8,144
Montana,Superior,690,169,237,81,11,109,607
Montana,Clinton,875,216,326,139,0,36,717
Montana,Frenchtown,2330,211,1270,82,0,142,1705
Montana,Lewistown,5895,1140,2288,845,197,460,4930
Montana,Lincoln,898,141,408,120,4,51,724
Montana,Drummond,304,33,97,72,10,23,235
Montana,Big Sandy,527,137,211,53,4,37,442
Montana,Box Elder,69,23,31,4,0,5,63
Montana,Bearcreek,187,15,101,23,9,5,153
Montana,Belfry,259,73,83,36,3,23,218
Montana,Sheridan,879,150,410,108,0,61,729
Montana,Kevin,126,24,56,17,1,8,106
Montana,Cascade,653,83,330,62,11,56,542
Montana,Sun Prairie,1515,187,655,123,12,70,1047
Montana,Walkerville,737,144,317,81,5,47,594
Montana,Dutton,296,67,138,30,7,23,265
Montana,Sun River,88,26,12,14,0,22,74
Montana,Westby,139,19,71,12,4,12,118
Montana,Wyola,194,61,38,36,7,16,158
Montana,Sangrey,373,143,55,32,4,21,255
Montana,Harrison,144,8,42,33,0,5,88
Montana,Jette,174,0,141,33,0,0,174
Montana,Finley Point,471,109,234,44,16,68,471
Montana,North Browning,2720,855,561,230,12,140,1798
Montana,Crow Agency,1928,527,480,125,57,99,1288
Montana,Harlem,857,246,300,34,31,58,669
Montana,Clancy,1986,337,993,217,12,78,1637
Montana,Antelope,94,0,40,0,0,12,52
Montana,Dodson,123,18,30,8,0,14,70
Montana,Loma,82,0,82,0,0,0,82
Montana,Butte-Silver Bow (balance),34077,8791,12885,4044,310,2288,28318
Montana,Roundup,1817,386,678,235,11,184,1494
Montana,Havre North,670,232,215,68,38,34,587
Montana,Whitefish,7309,1624,2980,996,114,393,6107
Montana,Ryegate,195,4,103,21,0,16,144
Montana,South Browning,1522,392,276,149,5,89,911
Montana,Noxon,252,78,147,14,0,0,239
Montana,Heron,133,18,70,23,0,14,125
Montana,Fortine,321,94,116,60,3,0,273
Montana,Boneau,356,169,97,15,0,9,290
Montana,Vaughn,730,183,306,77,9,43,618
Montana,Great Falls,58990,13998,23019,6904,678,3382,47981
Montana,Terry,782,80,366,65,0,74,585
Montana,Chester,1073,144,525,124,23,76,892
Montana,Clyde Park,206,36,104,28,0,12,180
Montana,Glendive,5232,1096,2147,531,122,408,4304
Montana,Florence,581,43,309,83,0,14,449
Montana,Corvallis,1143,283,460,137,0,23,903
Montana,Valier,617,147,191,61,13,68,480
Montana,Helena West Side,1320,264,651,172,15,66,1168
Montana,Grass Range,126,15,59,22,0,12,108
Montana,Shelby,3160,783,1098,448,74,181,2584
Montana,Forsyth,1673,290,826,191,0,147,1454
Montana,Ashland,982,249,220,83,5,79,636
Montana,Poplar,896,352,202,110,3,42,709
Montana,Rexford,109,0,86,0,2,4,92
Montana,Scobey,1162,181,535,106,0,150,972
Montana,Flaxville,34,7,17,6,0,0,30
Montana,Seeley Lake,1256,218,728,138,7,46,1137
Montana,Fromberg,398,51,201,56,4,36,348
Montana,Ballantine,165,8,38,21,30,42,139
Montana,Red Lodge,2277,608,758,393,24,187,1970
Montana,Kerr,84,23,48,0,0,13,84
Montana,Wibaux,556,106,255,55,0,46,462
Montana,Niarada,11,3,8,0,0,0,11
Montana,Hot Springs,506,102,157,126,5,72,462
Montana,Saco,239,53,115,19,0,18,205
Montana,Townsend,2069,339,898,269,36,145,1687
Montana,Judith Gap,89,2,62,9,0,7,80
Montana,Thompson Falls,1231,264,479,138,14,51,946
Montana,Lonepine,162,14,100,13,0,5,132
Montana,Klein,75,0,41,21,0,0,62
Montana,Philipsburg,630,142,163,157,0,74,536
Montana,Simms,354,19,210,12,0,12,253
Montana,Dixon,202,32,78,28,5,20,163
Montana,Neihart,40,8,22,2,0,4,36
Montana,Parker School,522,193,120,16,30,13,372
Montana,Geraldine,202,35,100,29,3,18,185
Montana,Helena Valley Northwest,4163,712,2006,297,0,107,3122
Montana,Winifred,118,20,74,8,0,3,105
Montana,Culbertson,753,84,337,62,2,57,542
Montana,Dillon,4244,1683,1498,380,13,154,3728
Montana,Missoula,72125,26741,23668,7551,911,2445,61316
Montana,Kremlin,79,17,38,4,0,18,77
Montana,Bainville,294,68,95,21,15,10,209
Montana,Ravalli,38,0,25,13,0,0,38
Montana,Elmo,177,26,63,35,0,0,124
Montana,Moore,183,18,89,31,0,9,147
Montana,Alberton,542,65,186,99,16,37,403
Montana,Denton,241,35,138,17,4,8,202
Montana,Whitehall,881,197,325,246,0,48,816
Montana,Ekalaka,373,60,168,55,3,51,337
Montana,Bigfork,4626,806,2473,342,33,309,3963
Montana,Lame Deer,2156,684,502,190,34,70,1480
Montana,Greycliff,96,16,52,2,2,9,81
Montana,Virginia City,204,29,105,31,5,18,188
Montana,Stanford,330,76,137,61,4,13,291
Montana,Birney,62,36,20,0,0,6,62
Montana,Broadview,134,28,64,12,0,16,120
Montana,Nashua,315,34,164,40,1,31,270
Montana,Glasgow,3348,806,1490,202,3,230,2731
Montana,Fort Peck,218,61,115,4,0,11,191
Montana,Conrad,2531,503,939,231,64,241,1978
Montana,Browning,848,276,261,70,3,77,687
Montana,Lavina,212,36,100,29,12,9,186
Montana,Power,186,29,93,22,0,13,157
Montana,Plentywood,1858,396,868,168,18,99,1549
Montana,Darby,762,155,256,177,9,52,649
Montana,Pinesdale,955,309,232,37,2,19,599
Montana,Three Forks,1922,359,848,255,0,125,1587
Montana,Hardin,3842,980,1227,235,66,132,2640
Montana,Columbus,2324,369,953,274,34,123,1753
Montana,Ismay,0,0,0,0,0,0,0
Montana,Choteau,1866,361,848,158,0,193,1560
Montana,Kalispell,22621,5411,8108,3100,347,1057,18023
Montana,Martin City,391,83,189,85,0,34,391
Montana,Medicine Lake,284,64,114,25,0,26,229
Montana,Outlook,87,2,44,7,0,0,53
Montana,St. Marie,489,31,219,130,0,19,399
Montana,Custer,124,28,36,17,1,16,98
Moore County metropolitan government; Tennessee,Lynchburg,6322,1077,3314,409,82,402,5284
Nebraska,Wilber,1790,321,793,154,12,131,1411
Nebraska,Fairbury,3711,733,1206,535,67,390,2931
Nebraska,Pickrell village,227,16,131,21,0,10,178
Nebraska,Belgrade village,125,12,67,11,0,18,108
Nebraska,Reynolds village,82,20,42,4,0,8,74
Nebraska,Craig village,166,27,90,12,7,10,146
Nebraska,Comstock village,131,25,53,24,0,6,108
Nebraska,Oconto village,139,34,50,30,0,8,122
Nebraska,Sargent,548,66,276,34,14,62,452
Nebraska,Venango village,192,22,103,21,0,8,154
Nebraska,Syracuse,2110,285,975,152,28,234,1674
Nebraska,Octavia village,139,21,60,31,2,1,115
Nebraska,Kilgore village,74,6,34,4,0,4,48
Nebraska,Hildreth village,449,72,213,45,0,30,360
Nebraska,Lindsay village,287,52,165,19,0,19,255
Nebraska,Lebanon village,73,12,34,6,0,5,57
Nebraska,Verdel village,28,10,11,0,0,4,25
Nebraska,Cook village,387,87,162,39,1,21,310
Nebraska,Giltner village,315,64,166,25,0,12,267
Nebraska,Winslow village,91,28,35,11,0,2,76
Nebraska,Homer village,485,102,218,61,3,28,412
Nebraska,Fremont,26426,5555,10748,2811,378,1481,20973
Nebraska,Howells village,702,158,332,38,1,51,580
Nebraska,Waverly,3804,648,1576,289,8,119,2640
Nebraska,Raymond village,187,41,104,19,0,3,167
Nebraska,Hallam village,244,24,125,13,2,9,173
Nebraska,Taylor village,140,40,67,18,0,9,134
Nebraska,Amherst village,158,31,71,17,4,12,135
Nebraska,Harrison village,301,58,115,22,0,36,231
Nebraska,Central City,2893,531,1221,376,22,197,2347
Nebraska,Utica village,924,136,424,73,2,71,706
Nebraska,Seward,7151,1992,3075,368,87,356,5878
Nebraska,De Witt village,581,101,250,67,0,35,453
Nebraska,Heartwell village,72,16,38,2,0,0,56
Nebraska,Allen village,348,68,122,68,14,16,288
Nebraska,Hemingford village,867,108,436,58,7,49,658
Nebraska,Preston village,36,2,28,0,0,0,30
Nebraska,Ponca,1009,219,458,80,5,77,839
Nebraska,Mason City village,198,44,80,19,0,12,155
Nebraska,Callaway village,746,68,341,74,4,31,518
Nebraska,Decatur village,364,46,172,60,3,53,334
Nebraska,Elwood village,754,171,372,39,0,64,646
Nebraska,Weeping Water,964,196,477,98,17,54,842
Nebraska,Gurley village,221,18,101,30,4,15,168
Nebraska,Bruno village,113,13,55,6,2,3,79
Nebraska,Bee village,233,46,81,55,0,8,190
Nebraska,Cortland village,502,63,252,31,2,14,362
Nebraska,Adams village,517,89,207,52,0,56,404
Nebraska,Maywood village,348,35,198,18,5,17,273
Nebraska,Polk village,326,50,151,38,0,29,268
Nebraska,Culbertson village,562,119,264,64,2,19,468
Nebraska,Holstein village,274,64,121,37,1,13,236
Nebraska,Rulo village,121,44,36,29,0,10,119
Nebraska,Filley village,123,23,55,20,0,7,105
Nebraska,Kennard village,383,59,167,34,5,27,292
Nebraska,Chapman village,247,43,99,23,26,15,206
Nebraska,Gandy village,52,0,29,2,0,6,37
Nebraska,Brewster village,9,0,8,0,0,1,9
Nebraska,Rogers village,110,8,67,8,0,0,83
Nebraska,Page village,210,46,111,10,0,8,175
Nebraska,Geneva,1997,378,887,239,29,138,1671
Nebraska,Brunswick village,191,29,100,18,0,11,158
Nebraska,Unadilla village,277,36,148,18,0,24,226
Nebraska,Palmyra village,596,111,215,80,12,26,444
Nebraska,Cody village,195,41,103,16,2,6,168
Nebraska,Nebraska City,7263,1631,2748,713,78,604,5774
Nebraska,Douglas village,161,35,73,7,2,12,129
Nebraska,Grant,1342,173,646,106,10,111,1046
Nebraska,Plattsmouth,6448,1440,2306,715,128,472,5061
Nebraska,Alvo village,138,7,60,18,0,7,92
Nebraska,Goehner village,120,8,76,7,0,5,96
Nebraska,Garland village,248,57,116,15,0,10,198
Nebraska,Genoa,1075,242,455,127,13,70,907
Nebraska,Richland village,101,27,37,7,0,5,76
Nebraska,Loomis village,412,84,198,39,1,16,338
Nebraska,Lawrence village,391,78,212,16,5,23,334
Nebraska,Ord,2284,440,1112,141,15,170,1878
Nebraska,Rushville,978,312,295,69,0,115,791
Nebraska,Berwyn village,86,14,56,8,0,0,78
Nebraska,Lyons,838,153,404,67,2,91,717
Nebraska,Springfield,1344,225,625,177,5,72,1104
Nebraska,Dixon village,110,27,43,6,9,14,99
Nebraska,Papillion,20466,4413,9365,1539,175,751,16243
Nebraska,La Vista,17077,4142,6700,2032,126,570,13570
Nebraska,Crookston village,70,25,15,12,3,1,56
Nebraska,Union village,132,22,80,6,0,10,118
Nebraska,Elmwood village,686,133,312,69,0,32,546
Nebraska,Fullerton,1459,295,567,88,25,147,1122
Nebraska,Wymore,1438,263,613,142,31,105,1154
Nebraska,Juniata village,711,141,355,49,13,33,591
Nebraska,Hastings,24922,6312,9658,2453,111,1458,19992
Nebraska,Funk village,253,39,127,22,0,12,200
Nebraska,Salem village,123,17,60,12,0,1,90
Nebraska,Nehawka village,216,21,99,21,0,16,157
Nebraska,Axtell village,731,91,371,51,0,33,546
Nebraska,Wilcox village,426,93,187,40,5,18,343
Nebraska,Herman village,296,46,131,29,3,18,227
Nebraska,Upland village,186,35,81,18,0,12,146
Nebraska,Spencer village,377,40,220,19,0,34,313
Nebraska,Bristow village,86,11,45,10,0,1,67
Nebraska,Dunbar village,152,25,71,30,1,8,135
Nebraska,Gretna,5037,933,2136,392,68,203,3732
Nebraska,Jansen village,140,5,73,19,0,9,106
Nebraska,South Bend village,106,24,50,18,0,6,98
Nebraska,Murray village,512,79,253,56,1,22,411
Nebraska,Avoca village,265,90,94,10,11,6,211
Nebraska,Maskell village,92,14,45,9,0,5,73
Nebraska,Primrose village,77,23,41,6,0,1,71
Nebraska,Elyria village,71,14,41,4,0,3,62
Nebraska,Battle Creek,1339,258,652,78,2,77,1067
Nebraska,Henderson,991,114,504,33,22,59,732
Nebraska,Benedict village,256,34,135,24,2,21,216
Nebraska,Ragan village,41,9,18,6,0,6,39
Nebraska,Deshler,711,101,353,48,15,38,555
Nebraska,Humboldt,876,164,407,115,14,71,771
Nebraska,Fairfield,421,89,176,31,7,33,336
Nebraska,Long Pine,246,24,136,29,0,32,221
Nebraska,Winnetoon village,63,13,36,3,0,3,55
Nebraska,Mead village,628,148,242,54,0,34,478
Nebraska,Ithaca village,148,25,73,11,0,8,117
Nebraska,Ashton village,245,45,108,13,0,14,180
Nebraska,Niobrara village,317,75,140,44,1,27,287
Nebraska,Bazile Mills village,32,12,17,0,0,0,29
Nebraska,Saronville village,72,7,32,4,0,3,46
Nebraska,St. Edward,718,146,301,69,2,85,603
Nebraska,Petersburg village,385,50,201,27,0,25,303
Nebraska,Cedar Bluffs village,601,111,239,74,0,27,451
Nebraska,Pleasant Dale village,254,41,120,14,0,10,185
Nebraska,Milford,2327,638,929,132,53,108,1860
Nebraska,Crete,7050,2191,2359,382,36,336,5304
Nebraska,Liberty village,71,12,23,8,0,7,50
Nebraska,Curtis,848,282,313,48,8,56,707
Nebraska,Beaver Crossing village,367,68,170,44,1,8,291
Nebraska,Mullen village,391,66,197,52,0,43,358
Nebraska,Naponee village,99,22,58,8,0,6,94
Nebraska,Cozad,3832,619,1854,363,29,275,3140
Nebraska,Farnam village,250,51,128,15,1,12,207
Nebraska,Gothenburg,3482,598,1483,302,8,190,2581
Nebraska,Sumner village,244,38,111,9,2,17,177
Nebraska,Thurston village,129,24,69,10,0,6,109
Nebraska,Nemaha village,118,25,44,17,7,7,100
Nebraska,Overton village,561,105,243,49,4,19,420
Nebraska,Big Springs village,515,87,237,34,4,46,408
Nebraska,South Sioux City,12994,2517,5730,774,141,571,9733
Nebraska,Hubbard village,208,72,55,13,4,13,157
Nebraska,Schuyler,6301,1361,2479,270,69,179,4358
Nebraska,Cowles village,13,3,6,2,0,1,12
Nebraska,Coleridge village,554,72,259,43,2,50,426
Nebraska,Ohiowa village,157,23,103,2,0,0,128
Nebraska,Winside village,488,130,212,39,1,20,402
Nebraska,Mitchell,1827,416,647,222,63,129,1477
Nebraska,Burton village,0,0,0,0,0,0,0
Nebraska,Walthill village,796,273,161,80,10,21,545
Nebraska,Pender village,1164,233,572,64,9,91,969
Nebraska,Macy,954,340,151,56,4,39,590
Nebraska,Hendley village,12,4,3,1,0,4,12
Nebraska,Arapahoe,1206,201,533,75,3,86,898
Nebraska,Exeter village,610,123,304,35,5,39,506
Nebraska,North Platte,24011,5267,9865,2447,293,1376,19248
Nebraska,Lynch village,232,42,94,19,0,41,196
Nebraska,Gilead village,27,0,13,14,0,0,27
Nebraska,Bennet village,1049,108,478,78,8,28,700
Nebraska,Dix village,325,47,140,41,26,25,279
Nebraska,Stamford village,154,23,53,16,0,7,99
Nebraska,Orleans village,437,60,213,68,0,32,373
Nebraska,Alma,1378,205,709,165,5,94,1178
Nebraska,Sidney,6732,1297,2866,679,109,465,5416
Nebraska,Ong village,54,8,31,7,2,3,51
Nebraska,Huntley village,25,6,6,1,0,8,21
Nebraska,Atlanta village,90,6,61,5,0,6,78
Nebraska,Nelson,517,73,243,85,8,20,429
Nebraska,Verdon village,199,41,115,11,0,8,175
Nebraska,Stella village,203,12,131,18,2,11,174
Nebraska,McCook,7580,1663,3189,659,79,469,6059
Nebraska,Peru,898,608,173,14,9,22,826
Nebraska,Winnebago village,746,279,99,95,6,27,506
Nebraska,Valley,2703,425,1380,233,5,194,2237
Nebraska,Sutherland village,1561,200,722,189,22,86,1219
Nebraska,Crawford,1116,200,466,138,8,78,890
Nebraska,Dodge village,558,74,228,40,6,98,446
Nebraska,Hooper,789,83,371,120,0,69,643
Nebraska,Snyder village,358,60,169,22,0,23,274
Nebraska,Arlington village,1534,179,798,77,10,35,1099
Nebraska,Bruning village,287,40,151,16,0,30,237
Nebraska,Washington village,92,13,41,14,1,5,74
Nebraska,Newman Grove,722,131,333,60,1,57,582
Nebraska,Stockville village,10,0,8,2,0,0,10
Nebraska,Eustis village,514,81,245,37,3,26,392
Nebraska,York,7859,1585,3471,575,76,558,6265
Nebraska,Elba village,346,66,148,50,1,14,279
Nebraska,Newport village,87,10,47,7,2,7,73
Nebraska,Cotesfield village,37,5,18,8,0,2,33
Nebraska,Oxford village,723,110,389,82,0,33,614
Nebraska,Clay Center,794,159,381,44,18,41,643
Nebraska,Colon village,101,23,58,11,0,4,96
Nebraska,Loup City,997,168,441,134,5,152,900
Nebraska,Hazard village,58,3,29,11,0,10,53
Nebraska,Wausa village,646,124,351,25,1,40,541
Nebraska,Phillips village,317,34,175,39,2,8,258
Nebraska,Spalding village,479,137,206,24,3,31,401
Nebraska,Stratton village,410,91,162,56,0,34,343
Nebraska,Neligh,1548,259,657,117,15,166,1214
Nebraska,Bradshaw village,321,47,141,31,1,17,237
Nebraska,Lodgepole village,354,46,147,42,4,31,270
Nebraska,Malcolm village,422,70,185,29,7,15,306
Nebraska,Davey village,169,37,85,9,1,11,143
Nebraska,Beemer village,628,71,330,34,0,97,532
Nebraska,Eagle village,988,197,406,118,5,19,745
Nebraska,Alliance,8313,1820,3368,734,48,557,6527
Nebraska,Concord village,122,24,71,5,2,6,108
Nebraska,Broken Bow,3522,773,1417,293,87,241,2811
Nebraska,Anselmo village,164,23,109,7,2,6,147
Nebraska,Gibbon,2072,279,994,115,25,64,1477
Nebraska,McCool Junction village,405,91,205,24,2,4,326
Nebraska,Gresham village,244,70,93,20,6,16,205
Nebraska,Dannebrog village,336,45,149,34,17,18,263
Nebraska,Trenton village,550,131,184,76,6,53,450
Nebraska,Potter village,346,47,155,38,19,16,275
Nebraska,Howard City village,178,30,77,29,2,22,160
Nebraska,Randolph,914,128,443,38,18,103,730
Nebraska,Gross village,0,0,0,0,0,0,0
Nebraska,Panama village,261,86,103,26,4,2,221
Nebraska,Doniphan village,1020,168,466,58,18,31,741
Nebraska,Red Cloud,1118,185,471,106,29,104,895
Nebraska,Alda village,758,168,308,80,0,15,571
Nebraska,Crofton,879,122,420,80,8,41,671
Nebraska,Sterling village,493,69,234,49,7,41,400
Nebraska,Stockham village,45,16,17,4,0,6,43
Nebraska,Hampton village,460,60,277,11,0,19,367
Nebraska,Center village,85,26,34,5,0,8,73
Nebraska,Chappell,911,151,381,108,12,94,746
Nebraska,Staplehurst village,278,59,104,27,7,13,210
Nebraska,Tobias village,123,8,64,6,3,15,96
Nebraska,North Loup village,288,35,156,46,8,19,264
Nebraska,Beatrice,12307,2726,4977,1369,104,1067,10243
Nebraska,Wolbach village,236,24,102,21,1,29,177
Nebraska,Bloomfield,974,175,462,66,1,133,837
Nebraska,Aurora,4481,632,2240,380,35,257,3544
Nebraska,Chadron,5654,2084,1974,502,35,258,4853
Nebraska,Leigh village,372,70,172,40,0,51,333
Nebraska,Minatare,988,196,390,111,0,69,766
Nebraska,McGrew village,69,12,35,5,0,1,53
Nebraska,Cairo village,980,207,365,96,0,41,709
Nebraska,Carleton village,98,0,84,1,0,0,85
Nebraska,Norfolk,24446,6142,9653,1862,221,1374,19252
Nebraska,Talmage village,228,61,92,32,10,10,205
Nebraska,Lorton village,27,1,18,1,0,0,20
Nebraska,Franklin,1041,175,536,48,16,96,871
Nebraska,Bloomington village,137,15,56,18,2,10,101
Nebraska,Belden village,117,14,68,5,0,6,93
Nebraska,Naper village,104,10,73,12,0,3,98
Nebraska,Butte village,330,41,195,14,3,38,291
Nebraska,Fort Calhoun,893,214,409,46,0,50,719
Nebraska,Blair,7684,1584,3172,837,117,425,6135
Nebraska,Foster village,68,14,23,2,0,0,39
Nebraska,Riverton village,49,5,13,14,4,11,47
Nebraska,Bartlett village,112,30,53,20,2,4,109
Nebraska,Tilden,1136,197,511,81,0,73,862
Nebraska,Madison,2301,565,936,141,25,98,1765
Nebraska,Bertrand village,774,142,387,47,2,49,627
Nebraska,Shelton village,1201,290,507,92,16,42,947
Nebraska,Ravenna,1512,307,679,121,6,89,1202
Nebraska,Thayer village,64,6,39,2,0,1,48
Nebraska,Palisade village,365,54,155,55,2,48,314
Nebraska,Republican City village,145,8,79,27,0,12,126
Nebraska,Arcadia village,316,68,140,4,12,22,246
Nebraska,Edgar,369,43,148,80,2,43,316
Nebraska,Halsey village,67,19,31,4,0,8,62
Nebraska,Monroe village,436,57,212,28,6,10,313
Nebraska,Burr village,32,4,20,6,0,0,30
Nebraska,Daykin village,221,20,97,5,0,24,146
Nebraska,Manley village,133,23,83,12,2,2,122
Nebraska,Greenwood village,546,90,257,69,9,27,452
Nebraska,Chalco,11456,2534,4915,995,130,238,8812
Nebraska,Tecumseh,1794,361,690,206,11,166,1434
Nebraska,Hordville village,110,12,54,19,0,7,92
Nebraska,Chambers village,316,39,160,31,2,19,251
Nebraska,Duncan village,491,106,219,48,0,24,397
Nebraska,Blue Hill,1028,211,439,91,2,86,829
Nebraska,Morrill village,830,109,399,94,13,46,661
Nebraska,Melbeta village,128,53,48,8,0,6,115
Nebraska,Brule village,398,68,196,38,2,38,342
Nebraska,Belvidere village,38,1,22,6,0,2,31
Nebraska,Nora village,8,2,3,1,0,2,8
Nebraska,Hardy village,186,21,76,16,0,13,126
Nebraska,Falls City,4176,660,1604,650,65,345,3324
Nebraska,Bassett,659,155,327,36,0,94,612
Nebraska,Sholes village,33,1,25,0,0,0,26
Nebraska,Ogallala,4561,811,1985,457,53,363,3669
Nebraska,Barneston village,110,30,41,20,2,5,98
Nebraska,Stapleton village,307,65,144,20,4,25,258
Nebraska,Emerson village,915,166,395,71,7,61,700
Nebraska,Table Rock village,335,71,125,37,7,39,279
Nebraska,Gering,8312,1777,3253,751,107,546,6434
Nebraska,Lisco,45,0,40,0,0,5,45
Nebraska,Terrytown,1160,267,423,145,15,47,897
Nebraska,Louisville,1199,189,491,110,5,83,878
Nebraska,Bridgeport,1700,344,697,142,44,93,1320
Nebraska,Belmar,86,0,76,0,0,10,86
Nebraska,Archer,42,0,36,0,0,0,36
Nebraska,Aten,24,5,19,0,0,0,24
Nebraska,Berea,16,0,11,0,5,0,16
Nebraska,Bow Valley,91,9,30,25,0,7,71
Nebraska,Brownlee,4,0,4,0,0,0,4
Nebraska,Champion,40,0,24,9,0,7,40
Nebraska,Ames,69,19,50,0,0,0,69
Nebraska,Enders,8,0,0,0,0,8,8
Nebraska,Hamlet village,65,4,25,7,7,17,60
Nebraska,Clatonia village,389,45,158,40,4,14,261
Nebraska,Superior,1929,393,754,239,28,197,1611
Nebraska,Benkelman,1015,182,363,132,3,109,789
Nebraska,Haigler village,228,25,104,28,0,16,173
Nebraska,Firth village,453,71,187,43,2,24,327
Nebraska,Rising City village,359,80,177,40,4,18,319
Nebraska,Moorefield village,15,4,11,0,0,0,15
Nebraska,Du Bois village,95,6,60,13,0,11,90
Nebraska,Odell village,328,33,168,27,3,12,243
Nebraska,Cushing village,46,9,13,7,4,5,38
Nebraska,Farwell village,124,20,68,6,0,9,103
Nebraska,Osceola,941,138,375,91,11,86,701
Nebraska,Waco village,300,36,154,37,11,17,255
Nebraska,Kimball,2762,504,1020,425,52,175,2176
Nebraska,Dunning village,109,28,43,4,3,10,88
Nebraska,Dalton village,313,41,106,53,0,31,231
Nebraska,Fontanelle,22,0,22,0,0,0,22
Nebraska,Glenwood,457,48,236,28,0,0,312
Nebraska,Holmesville,15,5,10,0,0,0,15
Nebraska,Sarben,105,12,63,0,0,0,75
Nebraska,Sunol,78,3,51,0,0,11,65
Nebraska,Tamora,75,12,26,9,0,0,47
Nebraska,Tryon,98,6,55,11,0,18,90
Nebraska,Venice,72,46,17,9,0,0,72
Nebraska,Walton,184,25,126,8,0,0,159
Nebraska,St. Libory,194,28,96,11,0,21,156
Nebraska,Wann,54,10,35,0,0,0,45
Nebraska,White Clay,0,0,0,0,0,0,0
Nebraska,Willow Island,7,0,7,0,0,0,7
Nebraska,Woodland Hills,170,23,112,21,0,0,156
Nebraska,Woodland Park,1653,340,727,130,26,54,1277
Nebraska,Yankee Hill,338,48,174,0,0,20,242
Nebraska,Seneca,53,6,30,2,0,8,46
Nebraska,Westerville,0,0,0,0,0,0,0
Nebraska,Roscoe,85,46,11,0,0,0,57
Nebraska,Richfield,159,10,58,7,0,0,75
Nebraska,Raeville,0,0,0,0,0,0,0
Nebraska,Inavale,65,0,58,7,0,0,65
Nebraska,Keystone,46,9,33,0,4,0,46
Nebraska,King Lake,132,34,31,38,0,29,132
Nebraska,Lakeview,358,65,260,0,0,0,325
Nebraska,La Platte,135,34,48,28,0,0,110
Nebraska,Lemoyne,92,21,63,8,0,0,92
Nebraska,Lindy,23,0,22,1,0,0,23
Nebraska,Lorenzo,20,7,13,0,0,0,20
Nebraska,Loretto,50,39,0,11,0,0,50
Nebraska,Martin,20,0,20,0,0,0,20
Nebraska,Max,130,19,58,6,4,6,93
Nebraska,Odessa,91,7,59,15,0,0,81
Nebraska,Overland,101,0,85,16,0,0,101
Nebraska,Parks,12,0,0,4,0,8,12
Nebraska,Poole,51,5,35,0,0,0,40
Nebraska,Ruskin village,97,12,66,6,0,1,85
Nebraska,Inland,7,0,0,0,0,7,7
Nebraska,Gordon,1726,315,624,230,29,143,1341
Nebraska,Norman village,39,17,14,4,0,1,36
Nebraska,McLean village,22,3,11,3,0,5,22
Nebraska,Osmond,872,132,372,110,2,54,670
Nebraska,Pierce,1910,293,939,106,0,111,1449
Nebraska,Plainview,1350,247,586,116,20,109,1078
Nebraska,Byron village,95,4,56,6,0,6,72
Nebraska,Hebron,1694,361,814,122,7,164,1468
Nebraska,Hadar village,231,45,128,16,0,7,196
Nebraska,Minden,2890,508,1148,345,9,255,2265
Nebraska,Bennington,1839,335,835,150,12,122,1454
Nebraska,Ralston,7314,1898,2764,903,103,405,6073
Nebraska,Brady village,382,65,196,27,10,7,305
Nebraska,Maxwell village,245,43,117,26,3,9,198
Nebraska,Wood River,1444,333,600,152,11,81,1177
Nebraska,Springview village,242,43,124,14,0,19,200
Nebraska,Lexington,10067,2529,3736,712,191,396,7564
Nebraska,Burchard village,46,9,23,4,3,4,43
Nebraska,Roseland village,220,31,110,8,2,12,163
Nebraska,Prague village,366,97,132,34,12,19,294
Nebraska,Paxton village,525,92,292,21,1,25,431
Nebraska,Wauneta village,713,125,307,54,0,68,554
Nebraska,Prosser village,60,4,33,11,0,5,53
Nebraska,Kenesaw village,1132,228,516,85,8,66,903
Nebraska,Memphis village,86,26,37,11,0,0,74
Nebraska,Yutan,962,220,462,105,6,28,821
Nebraska,Valparaiso village,660,125,311,56,3,42,537
Nebraska,Deweese village,61,14,19,12,0,5,50
Nebraska,Leshara village,101,23,27,12,5,12,79
Nebraska,Albion,1501,247,710,99,10,171,1237
Nebraska,Arnold village,750,89,356,61,32,37,575
Nebraska,Newcastle village,309,57,124,49,0,28,258
Nebraska,Marquette village,254,48,119,24,1,6,198
Nebraska,Santee village,393,116,85,20,5,12,238
Nebraska,Glenvil village,306,64,133,25,0,20,242
Nebraska,Lewiston village,66,16,21,7,0,6,50
Nebraska,Henry village,81,19,35,10,2,4,70
Nebraska,Denton village,245,64,88,38,0,9,199
Nebraska,Dwight village,189,31,98,26,3,3,161
Nebraska,Garrison village,51,11,21,2,0,1,35
Nebraska,Linwood village,117,28,28,25,5,4,90
Nebraska,Palmer village,538,111,213,79,6,28,437
Nebraska,Silver Creek village,453,95,159,44,5,28,331
Nebraska,Cedar Rapids village,471,62,246,45,2,16,371
Nebraska,Brainard village,384,110,168,22,13,17,330
Nebraska,Oakland,1506,239,719,139,29,63,1189
Nebraska,Lamar village,9,0,9,0,0,0,9
Nebraska,Ansley village,470,72,214,60,13,22,381
Nebraska,Merna village,364,48,184,32,5,28,297
Nebraska,Martinsburg village,81,20,31,6,0,10,67
Nebraska,Ainsworth,1722,328,723,143,18,183,1395
Nebraska,Johnstown village,64,13,31,1,7,4,56
Nebraska,Imperial,1857,437,848,111,10,122,1528
Nebraska,Bellwood village,351,70,143,31,3,31,278
Nebraska,Abie village,82,12,54,1,0,4,71
Nebraska,Lincoln,280849,88588,102399,23637,2498,9918,227040
Nebraska,Hickman,2146,346,980,110,18,60,1514
Nebraska,Sprague village,110,13,51,10,0,13,87
Nebraska,Inman village,111,21,61,17,0,4,103
Nebraska,Clarkson,669,71,334,59,0,114,578
Nebraska,Whitney village,97,22,40,10,0,5,77
Nebraska,Waterbury village,65,11,31,9,2,1,54
Nebraska,North Bend,1324,213,546,132,10,82,983
Nebraska,Omaha,465112,132855,168259,41998,6064,18504,367680
Nebraska,Hay Springs village,602,129,280,57,0,90,556
Nebraska,Ulysses village,237,58,134,17,0,12,221
Nebraska,Clarks village,360,70,146,37,13,22,288
Nebraska,Merriman village,143,18,64,13,2,11,108
Nebraska,Kearney,33273,10352,12242,2589,311,1572,27066
Nebraska,Miller village,184,43,53,19,0,28,143
Nebraska,Bushnell village,184,34,99,26,2,11,172
Nebraska,Clinton village,35,3,27,0,0,1,31
Nebraska,Cedar Creek village,442,50,257,53,3,22,385
Nebraska,Stromsburg,1136,245,539,92,13,79,968
Nebraska,Diller village,265,50,128,34,0,14,226
Nebraska,Stanton,1642,300,630,141,19,145,1235
Nebraska,Waterloo village,931,154,345,126,8,46,679
Nebraska,Strang village,28,5,14,1,0,1,21
Nebraska,Fairmont village,656,134,276,68,7,62,547
Nebraska,Hayes Center village,323,52,187,2,4,28,273
Nebraska,Guide Rock village,209,48,77,24,0,13,162
Nebraska,Wood Lake village,54,6,41,2,0,2,51
Nebraska,Elk Creek village,121,32,41,16,2,12,103
Nebraska,Verdigre village,557,99,223,57,0,100,479
Nebraska,Friend,1133,253,502,92,14,58,919
Nebraska,West Point,3327,675,1473,311,8,201,2668
Nebraska,Bladen village,181,38,79,10,0,12,139
Nebraska,Jackson village,151,32,81,18,0,3,134
Nebraska,Burwell,1239,286,518,115,27,118,1064
Nebraska,Pawnee City,1062,140,454,177,3,72,846
Nebraska,Endicott village,151,27,79,16,0,8,130
Nebraska,Anoka village,14,5,9,0,0,0,14
Nebraska,Creston village,218,41,90,6,4,14,155
Nebraska,Lyman village,388,104,118,33,23,17,295
Nebraska,Grafton village,134,33,60,11,2,7,113
Nebraska,Surprise village,81,34,28,8,0,4,74
Nebraska,Hyannis village,199,17,137,21,0,13,188
Nebraska,Hershey village,555,65,289,45,2,35,436
Nebraska,Stuart village,725,141,341,40,0,43,565
Nebraska,Lushton village,22,4,9,6,0,3,22
Nebraska,Steinauer village,65,13,27,8,0,6,54
Nebraska,Grand Island,51187,11802,19177,4671,778,2629,39057
Nebraska,Julian village,53,4,18,18,0,7,47
Nebraska,Ericson village,169,18,75,3,11,19,126
Nebraska,Trumbull village,264,38,134,10,0,6,188
Nebraska,Litchfield village,293,57,153,39,2,12,263
Nebraska,Wahoo,4487,777,1793,469,70,314,3423
Nebraska,Meadow Grove village,306,44,157,31,1,18,251
Nebraska,Barada village,12,0,8,4,0,0,12
Nebraska,Scottsbluff,14805,3512,4920,1690,345,987,11454
Nebraska,Magnet village,52,3,35,7,0,3,48
Nebraska,Morse Bluff village,130,34,65,4,1,6,110
Nebraska,Dakota City,1919,533,778,126,15,51,1503
Nebraska,Murdock village,189,17,114,26,3,8,168
Nebraska,Blue Springs,259,80,106,19,0,23,228
Nebraska,Nickerson village,317,49,120,40,1,16,226
Nebraska,St. Paul,2451,321,1065,243,13,256,1898
Nebraska,Sutton,1606,215,756,98,13,128,1210
Nebraska,Greeley Center village,380,75,164,28,2,62,331
Nebraska,Weston village,255,46,127,26,0,23,222
Nebraska,Ashland,2447,482,947,253,17,207,1906
Nebraska,Rockville village,141,42,36,18,7,0,103
Nebraska,Creighton,1194,157,602,82,0,123,964
Nebraska,Crab Orchard village,58,3,26,12,0,8,49
Nebraska,Uehling village,255,33,133,23,4,8,201
Nebraska,Scribner,847,153,361,59,11,91,675
Nebraska,Ceresco village,1054,186,500,86,24,21,817
Nebraska,Scotia village,313,33,169,18,1,23,244
Nebraska,Alexandria village,153,27,90,10,2,15,144
Nebraska,Smithfield village,40,3,24,4,0,3,34
Nebraska,Inglewood village,420,59,192,34,0,12,297
Nebraska,Roca village,209,45,95,22,0,2,164
Nebraska,Elsie village,117,18,66,11,0,11,106
Nebraska,Western village,293,86,122,23,2,26,259
Nebraska,Wisner,1258,246,522,73,13,99,953
Nebraska,Shelby village,748,138,343,43,12,53,589
Nebraska,Virginia village,64,10,29,5,0,2,46
Nebraska,Offutt AFB,5074,955,2237,266,49,24,3531
Nebraska,Cordova village,103,21,40,4,3,10,78
Nebraska,David City,2831,435,1266,246,52,267,2266
Nebraska,Tekamah,1824,326,864,122,11,154,1477
Nebraska,Dorchester village,679,157,287,77,0,24,545
Nebraska,Bancroft village,481,89,237,25,5,34,390
Nebraska,Fordyce village,131,27,63,8,2,8,108
Nebraska,Otoe village,250,36,108,18,0,23,185
Nebraska,Oak village,42,16,12,6,0,5,39
Nebraska,Shickley village,257,34,119,31,0,32,216
Nebraska,Swanton village,67,8,44,3,0,1,56
Nebraska,O'Neill,3631,539,1764,219,9,369,2900
Nebraska,Pilger village,333,45,207,22,0,15,289
Nebraska,Hoskins village,255,43,157,11,0,8,219
Nebraska,Wakefield,1533,239,697,109,13,88,1146
Nebraska,Milligan village,305,35,140,27,7,28,237
Nebraska,Emmet village,41,8,27,4,0,2,41
Nebraska,Ewing village,454,63,206,29,6,25,329
Nebraska,Wellfleet village,54,3,23,8,1,2,37
Nebraska,Elm Creek village,1160,207,499,119,6,33,864
Nebraska,Riverdale village,281,51,122,12,0,9,194
Nebraska,Eddyville village,95,12,55,9,0,4,80
Nebraska,Auburn,3322,627,1581,231,19,182,2640
Nebraska,Brownville village,99,12,49,19,4,9,93
Nebraska,Arthur village,118,23,38,17,2,18,98
Nebraska,Carroll village,209,22,112,22,1,9,166
Nebraska,Pleasanton village,338,66,139,31,0,22,258
Nebraska,Ayr village,85,20,42,3,2,4,71
Nebraska,Hubbell village,80,9,34,13,2,6,64
Nebraska,Davenport village,358,40,177,15,4,25,261
Nebraska,Harbine village,76,2,53,1,0,0,56
Nebraska,Plymouth village,436,71,213,31,0,42,357
Nebraska,Steele City village,68,9,29,10,0,4,52
Nebraska,Bellevue,53225,12825,21924,4779,510,2113,42151
Nebraska,Atkinson,1418,190,653,95,3,115,1056
Nebraska,Madrid village,198,19,103,27,0,14,163
Nebraska,Obert village,20,4,11,1,0,1,17
Nebraska,Wynot village,198,38,91,19,0,17,165
Nebraska,Campbell village,332,36,183,19,3,49,290
Nebraska,Valentine,2777,672,970,265,0,232,2139
Nebraska,Humphrey,960,179,463,32,10,53,737
Nebraska,Platte Center village,398,85,138,55,1,21,300
Nebraska,Shubert village,186,25,86,29,0,10,150
Nebraska,Holdrege,5476,1018,2693,481,17,240,4449
Nebraska,Chester village,268,32,139,12,4,18,205
Nebraska,Wayne,5558,2448,1959,208,19,225,4859
Nebraska,Beaver City,495,97,184,86,0,54,421
Nebraska,St. Helena village,70,16,32,10,0,6,64
Nebraska,Harvard,1176,278,449,114,22,72,935
Nebraska,Brock village,116,9,42,12,21,17,101
Nebraska,Broadwater village,154,40,67,16,0,15,138
Nebraska,Wilsonville village,59,8,29,7,2,10,56
Nebraska,Cambridge,1281,182,651,124,18,105,1080
Nebraska,Malmo village,285,79,116,5,0,19,219
Nebraska,Danbury village,76,5,41,13,0,6,65
Nebraska,Bartley village,342,81,171,31,2,8,293
Nebraska,Cornlea village,22,4,13,0,0,1,18
Nebraska,Laurel,1047,193,464,87,8,79,831
Nebraska,Hartington,1611,283,714,93,9,201,1300
Nebraska,Monowi village,0,0,0,0,0,0,0
Nebraska,Nenzel village,31,0,28,0,0,3,31
Nebraska,Dawson village,166,39,81,12,4,13,149
Nebraska,Indianola,603,127,295,60,6,28,516
Nebraska,Tarnov village,38,3,13,3,0,1,20
Nebraska,Johnson village,320,22,171,18,0,40,251
Nebraska,Thedford village,179,37,103,9,0,13,162
Nebraska,Bayard,1013,230,320,162,10,86,808
Nebraska,Rosalie village,185,48,56,12,4,13,133
Nebraska,Harrisburg,66,14,45,0,4,3,66
Nebraska,Holbrook village,259,32,130,32,0,12,206
Nebraska,Edison village,204,41,96,7,1,7,152
Nebraska,Oshkosh,858,101,405,72,6,87,671
Nebraska,Boys Town village,900,557,28,0,0,2,587
Nebraska,Wallace village,262,46,133,19,4,17,219
Nebraska,Lewellen village,198,28,93,34,1,16,172
Nebraska,Elgin,723,81,322,56,8,99,566
Nebraska,Oakdale village,353,81,144,48,0,32,305
Nebraska,Orchard village,494,72,264,46,0,20,402
Nebraska,Royal village,105,20,56,11,0,2,89
Nebraska,Columbus,22992,4948,9829,1675,172,1423,18047
Nebraska,Clearwater village,366,63,179,16,1,21,280
Nevada,Oasis,34,0,34,0,0,0,34
Nevada,Mina,105,33,0,48,0,24,105
Nevada,Orovada,49,0,49,0,0,0,49
Nevada,Osino,661,34,410,0,0,23,467
Nevada,Nelson,42,0,20,10,0,0,30
Nevada,Mount Wilson,0,0,0,0,0,0,0
Nevada,Montello,50,0,20,0,0,30,50
Nevada,Mogul,2005,467,1041,155,0,63,1726
Nevada,Logan Creek,53,0,20,24,0,9,53
Nevada,Kingston,104,0,104,0,0,0,104
Nevada,Lamoille,241,0,185,0,0,0,185
Nevada,Lund,91,11,45,0,0,11,67
Nevada,Lakeridge,281,90,151,20,8,12,281
Nevada,Jackpot,1551,268,379,219,121,58,1045
Nevada,Incline Village,8491,1639,4723,874,27,268,7531
Nevada,Imlay,129,0,64,13,0,0,77
Nevada,Humboldt River Ranch,203,0,203,0,0,0,203
Nevada,Hiko,76,11,65,0,0,0,76
Nevada,Grass Valley,719,71,330,212,12,14,639
Nevada,Goldfield,359,45,104,59,13,45,266
Nevada,Panaca,947,242,513,71,0,34,860
Nevada,Golconda,112,10,18,44,40,0,112
Nevada,Glenbrook,209,49,141,0,0,0,190
Nevada,Gerlach,107,0,67,9,0,31,107
Nevada,Lemmon Valley,5469,1443,2316,726,53,158,4696
Nevada,Golden Valley,1393,160,860,70,10,60,1160
Nevada,Valmy,108,10,66,0,11,0,87
Nevada,Pioche,1189,473,347,244,48,64,1176
Nevada,Summerlin South,27506,4884,12870,3380,249,1365,22748
Nevada,Whitney,43072,12782,13737,4910,1046,1761,34236
Nevada,Genoa,645,92,366,82,7,44,591
Nevada,Spring Valley,199722,60354,69185,24435,3676,8068,165718
Nevada,Indian Springs,831,110,308,119,36,67,640
Nevada,Winnemucca,7798,1710,3054,842,94,283,5983
Nevada,Indian Hills,6054,963,2889,659,71,345,4927
Nevada,Caliente,1135,345,348,151,20,104,968
Nevada,Hawthorne,2613,651,1225,194,84,203,2357
Nevada,Owyhee,1177,441,187,186,13,50,877
Nevada,Tonopah,2211,585,318,683,168,176,1930
Nevada,Unionville,0,0,0,0,0,0,0
Nevada,Silver City,131,31,66,8,0,8,113
Nevada,Walker Lake,413,52,227,33,13,23,348
Nevada,Zephyr Cove,461,108,285,37,0,31,461
Nevada,Washoe Valley,2651,407,1370,499,52,157,2485
Nevada,Virginia City,800,224,213,240,5,29,711
Nevada,Verdi,1368,262,685,139,0,86,1172
Nevada,Ursine,26,0,13,13,0,0,26
Nevada,Topaz Ranch Estates,1545,245,729,231,16,133,1354
Nevada,Topaz Lake,198,21,109,39,8,21,198
Nevada,Stagecoach,1961,318,848,291,96,90,1643
Nevada,Skyland,204,54,119,31,0,0,204
Nevada,Silver Peak,115,17,9,53,17,19,115
Nevada,Ruth,142,0,110,22,0,10,142
Nevada,Ruhenstroth,1280,120,746,132,16,92,1106
Nevada,Round Hill Village,777,146,436,111,21,10,724
Nevada,Rachel,96,0,64,32,0,0,96
Nevada,Preston,17,0,0,17,0,0,17
Nevada,Paradise Valley,51,1,29,21,0,0,51
Nevada,Gabbs,155,13,68,66,0,8,155
Nevada,Cold Springs,9168,1690,4414,758,52,212,7126
Nevada,Fish Springs,629,78,361,30,1,17,487
Nevada,Laughlin,7502,1675,2733,1674,169,890,7141
Nevada,Mesquite,17904,2606,9136,1907,240,1485,15374
Nevada,Carlin,2023,338,903,400,41,71,1753
Nevada,Spring Creek,13805,2171,6957,958,223,232,10541
Nevada,Wells,1150,176,525,68,27,79,875
Nevada,Pahrump,36174,6163,16157,5835,454,2914,31523
Nevada,Spanish Springs,16241,2788,8407,1009,85,653,12942
Nevada,Blue Diamond,339,91,89,91,0,27,298
Nevada,Nellis AFB,3342,843,1268,115,64,12,2302
Nevada,McGill,1180,129,559,90,0,80,858
Nevada,Wadsworth,768,268,204,100,33,26,631
Nevada,West Wendover,4320,820,1766,293,31,157,3067
Nevada,Winchester,28331,9477,8182,3988,874,1277,23798
Nevada,Sutcliffe,196,50,47,38,6,24,165
Nevada,Moapa Valley,6843,1022,3158,625,32,278,5115
Nevada,Ely,4063,800,1530,672,8,183,3193
Nevada,Cal-Nev-Ari,119,36,20,17,0,46,119
Nevada,Sun Valley,20683,4625,7456,2497,320,847,15745
Nevada,Reno,242633,70765,82473,30802,4314,9894,198248
Nevada,Schurz,1075,374,231,133,12,51,801
Nevada,Smith Valley,1463,111,914,149,49,106,1329
Nevada,Sunrise Manor,192934,59399,58785,19041,4252,7479,148956
Nevada,Elko,20247,5237,7266,2276,371,633,15783
Nevada,Las Vegas,626637,175681,214588,71050,11966,26878,500163
Nevada,Fallon Station,628,10,401,0,0,0,411
Nevada,Silver Springs,4514,986,1953,685,26,383,4033
Nevada,Nixon,280,130,46,28,8,19,231
Nevada,Henderson,291346,66725,122189,34778,3839,13715,241246
Nevada,Fort McDermitt,336,156,64,34,6,31,291
Nevada,Goodsprings,110,110,0,0,0,0,110
Nevada,Gardnerville,6148,1327,2422,993,10,355,5107
Nevada,Eureka,480,49,232,113,21,34,449
Nevada,Empire,145,59,31,29,0,0,119
Nevada,East Valley,1487,217,863,184,0,66,1330
Nevada,Dyer,290,28,138,44,0,27,237
Nevada,Dry Valley,30,0,30,0,0,0,30
Nevada,Double Spring,262,66,103,6,0,49,224
Nevada,Denio,15,0,0,0,0,15,15
Nevada,Crystal Bay,129,0,121,8,0,0,129
Nevada,Crescent Valley,442,17,284,44,0,38,383
Nevada,Carter Springs,516,95,225,70,4,35,429
Nevada,Bennett Springs,160,0,122,0,38,0,160
Nevada,Beaverdam,29,0,13,0,0,16,29
Nevada,Baker,64,24,40,0,0,0,64
Nevada,Austin,161,19,75,67,0,0,161
Nevada,Alamo,1199,110,709,0,0,56,875
Nevada,Fernley,19573,4151,8538,2152,252,789,15882
Nevada,Enterprise,164314,44158,61826,15144,1881,5111,128120
Nevada,Sandy Valley,1831,303,679,220,148,98,1448
Nevada,Gardnerville Ranchos,11274,2645,4981,1261,113,671,9671
Nevada,Moapa Town,731,195,305,28,0,48,576
Nevada,Searchlight,268,35,90,62,0,73,260
Nevada,Johnson Lane,6065,534,3723,602,66,383,5308
Nevada,North Las Vegas,236986,64795,80021,22668,4630,7978,180092
Nevada,Sparks,98524,22804,40753,10300,1584,3973,79414
Nevada,Bunkerville,1122,297,516,46,0,86,945
Nevada,Mount Charleston,401,96,214,72,0,14,396
Nevada,Beatty,881,247,315,104,13,52,731
Nevada,Boulder City,15680,3074,6851,2058,231,1166,13380
Nevada,Minden,3239,372,1767,403,33,192,2767
Nevada,Paradise,233689,77732,73210,28178,5453,9669,194242
Nevada,Lovelock,1806,336,608,270,68,109,1391
Nevada,Battle Mountain,3317,820,1251,255,52,274,2652
Nevada,Dayton,9508,2252,3823,1182,71,514,7842
Nevada,Yerington,3103,864,703,525,24,337,2453
Nevada,Fallon,8330,1902,2916,1342,163,376,6699
Nevada,Kingsbury,2122,501,1054,254,0,81,1890
Nevada,Stateline,969,348,311,154,12,0,825
Nevada,McDermitt,213,0,143,0,0,0,143
Nevada,Carson,54467,12765,20712,7494,931,3322,45224
New Hampshire,East Merrimack,4148,1264,1248,537,38,338,3425
New Hampshire,Somersworth,11883,2927,4952,1473,68,449,9869
New Hampshire,South Hooksett,5811,1931,2615,357,34,129,5066
New Hampshire,Manchester,111657,35834,37281,12669,1748,5433,92965
New Hampshire,Goffstown,3000,698,1213,492,15,162,2580
New Hampshire,Wilton,886,369,223,200,0,54,846
New Hampshire,Keene,23165,8883,7122,2545,307,1388,20245
New Hampshire,Berlin,10382,3324,3596,1463,143,702,9228
New Hampshire,Derry,22381,6089,8933,2439,336,937,18734
New Hampshire,Durham,11101,8770,1323,213,0,152,10458
New Hampshire,Alton,168,120,48,0,0,0,168
New Hampshire,Bennington,351,113,155,22,0,4,294
New Hampshire,Ashland,1353,363,592,96,27,55,1133
New Hampshire,Bartlett,104,42,20,2,0,40,104
New Hampshire,Belmont,1814,576,778,203,0,46,1603
New Hampshire,Greenville,983,186,453,143,9,33,824
New Hampshire,Bethlehem,923,227,431,131,0,39,828
New Hampshire,Blodgett Landing,105,39,66,0,0,0,105
New Hampshire,Bradford,340,69,169,24,0,8,270
New Hampshire,Canaan,299,49,107,76,17,22,271
New Hampshire,Center Ossipee,368,67,91,129,5,39,331
New Hampshire,Amherst,709,143,380,15,0,19,557
New Hampshire,Dover,31316,9233,11946,3256,272,1474,26181
New Hampshire,Meredith,1632,330,461,79,14,148,1032
New Hampshire,Enfield,1666,325,747,183,19,108,1382
New Hampshire,Littleton,4604,965,1643,777,93,312,3790
New Hampshire,Jaffrey,2614,907,753,574,29,99,2362
New Hampshire,Conway,3838,553,1629,453,53,158,2846
New Hampshire,Wolfeboro,2870,388,1614,371,53,222,2648
New Hampshire,Exeter,9070,2144,3563,1470,68,527,7772
New Hampshire,West Swanzey,1150,205,525,68,0,64,862
New Hampshire,Winchester,2199,575,568,300,45,130,1618
New Hampshire,Rochester,30661,7387,12762,3443,437,1430,25459
New Hampshire,Hillsborough,1735,179,824,260,0,116,1379
New Hampshire,Pittsfield,1586,463,420,301,20,75,1279
New Hampshire,Antrim,1232,260,511,216,12,73,1072
New Hampshire,Hinsdale,1524,411,494,209,41,55,1210
New Hampshire,Marlborough,1112,322,390,215,43,29,999
New Hampshire,Hanover,8591,5239,2054,197,0,415,7905
New Hampshire,Plymouth,3163,1837,772,136,17,97,2859
New Hampshire,Laconia,16342,4208,6249,2179,229,1250,14115
New Hampshire,Suncook,5111,1222,2183,500,10,294,4209
New Hampshire,Gorham,1460,183,844,170,15,78,1290
New Hampshire,Center Sandwich,129,22,60,9,0,10,101
New Hampshire,Newport,5019,1273,1705,987,16,245,4226
New Hampshire,Bristol,1916,694,465,273,0,131,1563
New Hampshire,North Conway,2284,846,640,541,17,56,2100
New Hampshire,Colebrook,1064,232,433,182,16,50,913
New Hampshire,Farmington,4451,979,1651,607,26,290,3553
New Hampshire,Lisbon,850,202,332,127,17,27,705
New Hampshire,Franklin,8586,2180,3105,1314,90,506,7195
New Hampshire,Charlestown,1029,138,488,151,0,13,790
New Hampshire,Nashua,88606,22923,35851,9909,1305,4293,74281
New Hampshire,Henniker,1798,1124,392,159,0,37,1712
New Hampshire,Newmarket,5536,2039,1931,622,103,95,4790
New Hampshire,Hampton,9235,1824,4684,1071,64,371,8014
New Hampshire,Claremont,13016,3471,4470,1552,396,971,10860
New Hampshire,Suissevale,316,76,168,16,0,0,260
New Hampshire,Groveton,1204,237,517,104,12,99,969
New Hampshire,Milford,9168,1889,3715,979,207,744,7534
New Hampshire,Pinardville,5390,1567,2122,765,17,245,4716
New Hampshire,Contoocook,1702,361,908,77,0,74,1420
New Hampshire,Concord,43040,11883,16276,5399,478,2343,36379
New Hampshire,Portsmouth,21778,7443,8017,2264,206,989,18919
New Hampshire,North Haverhill,1043,242,523,84,7,124,980
New Hampshire,West Stewartstown,329,112,58,76,0,47,293
New Hampshire,Warner,517,144,201,39,8,53,445
New Hampshire,Londonderry,11465,2604,5342,1073,68,416,9503
New Hampshire,Walpole,519,107,260,60,0,81,508
New Hampshire,Union,216,76,88,52,0,0,216
New Hampshire,Hudson,7591,1986,3072,826,40,460,6384
New Hampshire,Peterborough,2846,575,1417,312,0,311,2615
New Hampshire,Lancaster,1814,457,617,367,15,123,1579
New Hampshire,Whitefield,1010,245,322,197,16,56,836
New Hampshire,Hampton Beach,2603,628,1147,465,33,89,2362
New Hampshire,Hancock,242,35,144,50,0,13,242
New Hampshire,Lincoln,865,296,276,100,16,54,742
New Hampshire,Loudon,769,101,397,158,12,32,700
New Hampshire,Melvin Village,215,37,129,0,0,49,215
New Hampshire,Milton,530,152,237,45,22,19,475
New Hampshire,Milton Mills,301,72,158,0,0,38,268
New Hampshire,Mountain Lakes,522,121,331,23,0,9,484
New Hampshire,Newfields,327,41,199,19,0,2,261
New Hampshire,New Hampton,324,105,128,31,0,0,264
New Hampshire,New London,1400,1012,141,88,0,95,1336
New Hampshire,North Walpole,680,157,310,78,0,13,558
New Hampshire,North Woodstock,350,114,148,55,6,27,350
New Hampshire,Plainfield,219,24,121,44,0,4,193
New Hampshire,Sanbornville,581,44,443,33,0,15,535
New Hampshire,Seabrook Beach,841,151,446,157,0,56,810
New Hampshire,Hooksett,5082,1426,2272,466,15,236,4415
New Hampshire,Woodsville,903,349,171,85,0,44,649
New Hampshire,Lebanon,13619,4072,5623,1100,97,656,11548
New Hampshire,Raymond,2994,739,1239,198,41,145,2362
New Hampshire,Epping,1907,370,850,197,40,162,1619
New Hampshire,Troy,990,305,381,88,5,81,860
New Hampshire,Tilton Northfield,3156,749,1087,572,20,246,2674
New Jersey,Brookdale,9539,2186,4359,469,112,504,7630
New Jersey,East Franklin,7170,2457,2179,456,291,237,5620
New Jersey,Westwood borough,11145,2546,4677,785,152,771,8931
New Jersey,Tenafly borough,14687,2552,7253,542,59,511,10917
New Jersey,Ramsey borough,14963,2848,7940,824,33,481,12126
New Jersey,Mountainside borough,6820,1362,3453,219,26,637,5697
New Jersey,Andover borough,594,166,262,60,2,45,535
New Jersey,Tinton Falls borough,17731,4552,7186,1539,151,1950,15378
New Jersey,Oakhurst,3451,623,1943,167,0,169,2902
New Jersey,Long Branch,30611,9617,10493,2658,540,1278,24586
New Jersey,Keansburg borough,9788,3046,3130,1004,249,470,7899
New Jersey,Buttzville,102,0,102,0,0,0,102
New Jersey,Byram Center,28,9,19,0,0,0,28
New Jersey,Clyde,243,68,159,0,0,0,227
New Jersey,Columbia,261,38,125,20,21,38,242
New Jersey,Delaware,149,41,64,14,0,13,132
New Jersey,Delaware Park,413,143,181,46,27,16,413
New Jersey,Prince,30728,10909,12640,1765,134,719,26167
New Jersey,Highland Lakes,4840,1048,2383,369,93,152,4045
New Jersey,Whitesboro,2528,545,727,171,51,165,1659
New Jersey,Leisure Village West,3260,325,1440,569,33,893,3260
New Jersey,Mercerville,12574,3542,5083,890,233,1011,10759
New Jersey,Martinsville,11541,2276,6129,570,34,645,9654
New Jersey,Marksboro,146,36,36,8,0,9,89
New Jersey,Lopatcong Overlook,761,113,350,109,0,16,588
New Jersey,Kingston Estates,6346,1993,2060,501,114,435,5103
New Jersey,Kenvil,3179,693,1361,255,70,230,2609
New Jersey,Juliustown,344,56,182,6,5,22,271
New Jersey,Johnsonburg,58,4,26,0,0,0,30
New Jersey,Hutchinson,116,11,83,0,0,0,94
New Jersey,Hope,144,34,70,0,0,19,123
New Jersey,Harmony,457,91,246,21,0,56,414
New Jersey,Harlingen,230,37,121,17,0,0,175
New Jersey,Hancocks Bridge,248,46,129,6,10,7,198
New Jersey,Hamilton Square,12542,3033,6132,664,91,637,10557
New Jersey,Middlebush,2738,532,1296,93,62,221,2204
New Jersey,Hainesburg,42,10,11,7,7,7,42
New Jersey,Griggstown,747,117,397,45,22,32,613
New Jersey,Greenwich,2538,499,1167,132,34,37,1869
New Jersey,Green Knoll,6720,1541,3042,411,39,629,5662
New Jersey,Great Meadows,42,10,32,0,0,0,42
New Jersey,Cape May Court House,4787,959,2297,394,54,410,4114
New Jersey,Millville,27950,8157,9239,2652,707,1554,22309
New Jersey,Franklin Park,14612,3800,6211,1172,183,546,11912
New Jersey,Franklin Center,4615,830,2880,272,36,327,4345
New Jersey,Finderne,5976,1445,2222,635,98,407,4807
New Jersey,Elwood,1217,408,356,110,81,40,995
New Jersey,Ellisburg,4048,867,1702,439,58,388,3454
New Jersey,Finesville,240,0,150,0,0,0,150
New Jersey,East Rocky Hill,343,66,163,36,19,59,343
New Jersey,East Millstone,513,90,274,55,0,12,431
New Jersey,Groveville,2234,508,933,228,2,124,1795
New Jersey,Mountain Lake,510,158,168,76,23,46,471
New Jersey,Mount Hermon,116,14,52,12,0,10,88
New Jersey,New Village,421,110,205,8,0,29,352
New Jersey,Florence,4423,1150,1651,389,115,376,3681
New Jersey,Yardville,7148,2215,3084,491,36,473,6299
New Jersey,Weston,2725,298,1864,106,16,216,2500
New Jersey,Voorhees,1692,683,469,71,21,107,1351
New Jersey,Vienna,1296,419,597,56,0,37,1109
New Jersey,Vernon Center,1538,474,388,303,54,138,1357
New Jersey,Upper Pohatcong,1568,258,814,152,23,68,1315
New Jersey,Upper Montclair,11744,2019,5834,664,92,210,8819
New Jersey,Ten Mile Run,1518,313,880,42,20,16,1271
New Jersey,Upper Stewartsville,148,12,109,20,0,0,141
New Jersey,Succasunna,8681,1617,4781,549,54,305,7306
New Jersey,Stewartsville,514,196,132,30,17,41,416
New Jersey,Smithville,7835,1998,3441,750,129,528,6846
New Jersey,Skillman,359,87,149,33,0,21,290
New Jersey,Six Mile Run,2663,679,1188,105,101,62,2135
New Jersey,Singac,4447,1031,1789,652,36,254,3762
New Jersey,Silver Lake CDP (Warren County),300,86,113,13,11,33,256
New Jersey,Panther Valley,3623,665,1841,431,37,169,3143
New Jersey,Pedricktown,362,99,140,40,15,14,308
New Jersey,Pine Lake Park,8811,2144,3899,571,17,299,6930
New Jersey,Pleasant Plains,379,106,208,0,0,0,314
New Jersey,Port Colden,132,102,30,0,0,0,132
New Jersey,Port Murray,33,0,33,0,0,0,33
New Jersey,West New York,52477,16688,18125,4316,1636,2331,43096
New Jersey,Quinton,617,199,212,78,0,45,534
New Jersey,Robbinsville,2720,560,1328,134,12,116,2150
New Jersey,Robertsville,11840,2916,5707,439,25,323,9410
New Jersey,Roebling,3817,1105,1462,311,36,174,3088
New Jersey,Ross Corner,62,0,62,0,0,0,62
New Jersey,Short Hills,13134,1728,7175,236,28,411,9578
New Jersey,Silver Lake CDP (Essex County),3998,1431,1090,364,149,209,3243
New Jersey,Richwood,3427,618,1704,147,50,110,2629
New Jersey,Clearbrook Park,2810,140,1633,228,68,741,2810
New Jersey,Guttenberg,11436,3875,3579,1205,532,614,9805
New Jersey,River Edge borough,11530,2743,5765,466,54,351,9379
New Jersey,East Orange,64400,27800,12998,5169,2568,3051,51586
New Jersey,McGuire AFB,5246,821,2500,69,24,0,3414
New Jersey,Roseland borough,5849,946,3264,395,24,274,4903
New Jersey,Seabrook Farms,1996,993,394,126,0,49,1562
New Jersey,Kenilworth borough,8160,1925,3700,593,95,383,6696
New Jersey,Plainfield,50508,20513,12649,3254,1072,2133,39621
New Jersey,Elizabeth,128153,46069,36116,9248,3783,4232,99448
New Jersey,Totowa borough,10828,3002,4716,647,37,753,9155
New Jersey,Prospect Park borough,5861,2039,1784,292,88,206,4409
New Jersey,West Wildwood borough,376,79,172,30,17,41,339
New Jersey,Rio Grande,3078,503,1469,197,28,134,2331
New Jersey,Ocean Acres,16803,3749,7734,1032,140,735,13390
New Jersey,Erma,1953,460,923,98,32,163,1676
New Jersey,Cape May Point borough,188,53,91,13,0,31,188
New Jersey,Pomona,7362,1691,3383,506,118,495,6193
New Jersey,Woodstown borough,3473,937,1267,377,67,209,2857
New Jersey,North Cape May,3060,635,1451,330,72,167,2655
New Jersey,Wharton borough,6521,1978,2286,656,14,262,5196
New Jersey,Long Valley,1773,359,894,76,14,97,1440
New Jersey,Butler borough,7701,2091,3280,628,98,343,6440
New Jersey,Budd Lake,10414,2571,4305,722,97,247,7942
New Jersey,Moorestown-Lenola,13800,2899,6516,950,51,823,11239
New Jersey,Salem,4811,1578,996,352,217,289,3432
New Jersey,West Cape May borough,1103,282,459,116,14,60,931
New Jersey,Ocean City,11202,2367,5131,888,240,1010,9636
New Jersey,Rockaway borough,6404,1716,2677,554,7,310,5264
New Jersey,North Caldwell borough,6621,928,3528,371,106,342,5275
New Jersey,Essex Fells borough,2205,372,1186,82,4,105,1749
New Jersey,Rahway,29370,8969,10827,2240,721,1456,24213
New Jersey,Sussex borough,1854,657,596,178,83,110,1624
New Jersey,Wildwood,5073,1153,2147,649,104,292,4345
New Jersey,Phillipsburg,14415,4293,4880,1351,337,830,11691
New Jersey,Society Hill,3671,1298,1564,124,32,88,3106
New Jersey,Dover,18091,5368,6614,1230,617,710,14539
New Jersey,Broadway,235,46,151,21,0,17,235
New Jersey,Bridgeville,57,35,22,0,0,0,57
New Jersey,Brainards,194,37,89,8,0,5,139
New Jersey,Bradley Gardens,14417,3092,6956,711,113,611,11483
New Jersey,Blawenburg,185,45,88,9,0,8,150
New Jersey,Blairstown,370,235,77,19,0,0,331
New Jersey,Blackwells Mills,842,233,491,0,0,0,724
New Jersey,Belleplain,468,127,215,30,3,21,396
New Jersey,Belle Mead,195,47,88,10,0,0,145
New Jersey,Beattystown,4451,1211,1627,468,89,223,3618
New Jersey,Barclay,4330,841,2340,192,0,130,3503
New Jersey,Asbury,221,49,51,68,0,40,208
New Jersey,Anderson,402,38,231,14,0,32,315
New Jersey,Allamuchy,56,28,0,7,0,0,35
New Jersey,Zarephath,23,0,15,0,0,8,23
New Jersey,Woodland Park borough,12489,3641,5077,935,121,562,10336
New Jersey,Lake Como borough,1671,571,651,93,10,87,1412
New Jersey,Browns Mills,10719,3042,3674,1033,311,450,8510
New Jersey,Audubon borough,8660,2633,3364,868,141,443,7449
New Jersey,Swedesboro borough,2585,608,1134,134,46,121,2043
New Jersey,Woodbury,9929,3241,3076,706,242,628,7893
New Jersey,Ashland,8292,1991,3919,513,69,461,6953
New Jersey,Audubon Park borough,912,294,279,150,31,95,849
New Jersey,Newton,7895,2771,2588,835,221,575,6990
New Jersey,Blackwood,4702,1285,1729,362,137,275,3788
New Jersey,Hamburg borough,3152,692,1383,320,13,153,2561
New Jersey,Hopatcong borough,14362,3202,6773,1100,188,710,11973
New Jersey,Newark,280463,117061,64398,18952,9523,11715,221649
New Jersey,Country Lake Estates,4166,1151,1822,346,29,175,3523
New Jersey,Fieldsboro borough,906,339,266,78,0,55,738
New Jersey,Caldwell borough,7971,2587,2812,918,104,409,6830
New Jersey,Westfield,30086,5387,14409,1422,212,1352,22782
New Jersey,Brookfield,808,16,374,125,0,293,808
New Jersey,Lake Mohawk,9208,2132,4420,642,80,456,7730
New Jersey,Yorketown,6565,1352,3359,220,61,250,5242
New Jersey,Woodbury Heights borough,2993,700,1244,355,22,135,2456
New Jersey,Navesink,1426,221,752,119,0,46,1138
New Jersey,Burleigh,398,124,215,15,15,26,395
New Jersey,Atlantic City,38372,14367,8917,3385,1571,2042,30282
New Jersey,Ridgefield Park village,12934,3720,5402,1039,167,413,10741
New Jersey,Runnemede borough,8328,2428,2689,811,170,589,6687
New Jersey,Union City,68362,23471,21492,5351,2328,2631,55273
New Jersey,Ridgewood village,25269,4873,11989,1170,84,1010,19126
New Jersey,Edgewater borough,12184,2806,5822,894,42,505,10069
New Jersey,Dayton,7340,1739,3567,254,22,263,5845
New Jersey,Barrington borough,6741,1910,2498,790,74,323,5595
New Jersey,Avalon borough,1409,197,929,82,3,126,1337
New Jersey,Netcong borough,3209,1184,1102,324,124,136,2870
New Jersey,New Brunswick,56084,29454,10698,2478,1100,1097,44827
New Jersey,Greentree,11453,2471,6010,370,160,444,9455
New Jersey,Middlesex borough,13659,3202,6078,1055,121,648,11104
New Jersey,North Arlington borough,15724,3852,7058,1195,184,990,13279
New Jersey,Maywood borough,9654,2578,4253,720,100,538,8189
New Jersey,Englewood Cliffs borough,5356,773,3019,171,41,279,4283
New Jersey,Allendale borough,6762,1132,3327,321,92,311,5183
New Jersey,Pine Valley borough,4,0,4,0,0,0,4
New Jersey,Pine Hill borough,10443,3814,3111,1094,231,397,8647
New Jersey,Lawnside borough,2897,925,935,289,76,228,2453
New Jersey,Berlin borough,7547,2325,2669,694,68,603,6359
New Jersey,Wenonah borough,2225,549,1061,98,5,75,1788
New Jersey,Newfield borough,1572,366,680,148,14,84,1292
New Jersey,National Park borough,2983,863,1142,271,42,134,2452
New Jersey,Metuchen borough,13858,2674,6571,1033,28,633,10939
New Jersey,Highland Park borough,13992,4280,5568,915,242,547,11552
New Jersey,East Newark borough,2665,1034,801,266,67,44,2212
New Jersey,Teterboro borough,107,31,34,8,0,9,82
New Jersey,Dumont borough,17694,4535,7554,1219,107,1380,14795
New Jersey,Norwood borough,5819,1187,2721,493,40,421,4862
New Jersey,Lindenwold borough,17354,5699,4823,1659,639,999,13819
New Jersey,Beachwood borough,11210,3222,4379,803,170,434,9008
New Jersey,Paterson,145800,55142,38733,9070,4589,5433,112967
New Jersey,Lawrenceville,3546,962,1683,331,15,178,3169
New Jersey,Penns Grove borough,4847,1840,1346,369,111,168,3834
New Jersey,Alloway,1410,348,650,7,34,110,1149
New Jersey,North Wildwood,3849,715,1932,389,52,471,3559
New Jersey,Diamond Beach,211,18,183,10,0,0,211
New Jersey,Morris Plains borough,5625,1343,2667,282,48,399,4739
New Jersey,Mendham borough,4945,786,2769,185,14,221,3975
New Jersey,Madison borough,16042,4260,6713,960,168,717,12818
New Jersey,Cape May,3491,1032,1618,171,0,270,3091
New Jersey,Crandon Lakes,1228,391,414,192,0,59,1056
New Jersey,Morristown,18769,7848,6526,1399,198,774,16745
New Jersey,Ramblewood,5765,1313,2685,479,60,267,4804
New Jersey,Presidential Lakes Estates,1836,343,803,37,135,95,1413
New Jersey,Linden,42033,13548,14829,3399,846,2177,34799
New Jersey,Fanwood borough,7602,1448,3728,283,0,417,5876
New Jersey,Somerdale borough,5407,1688,2039,585,83,354,4749
New Jersey,Woodlynne borough,2915,998,780,146,67,54,2045
New Jersey,Bergenfield borough,27372,7206,11631,1792,310,1432,22371
New Jersey,Carlstadt borough,6191,1902,2844,377,39,151,5313
New Jersey,Cliffside Park borough,24883,6796,10428,2805,375,1312,21716
New Jersey,Trenton,83734,34285,19084,5676,3097,3271,65413
New Jersey,Branchville borough,896,257,310,99,29,43,738
New Jersey,Leonardo,2674,680,1219,218,8,117,2242
New Jersey,Atlantic Highlands borough,4289,1318,1837,252,83,218,3708
New Jersey,Fairview,3835,1007,1894,184,9,138,3232
New Jersey,Monmouth Beach borough,3221,613,1626,280,42,166,2727
New Jersey,Neptune City borough,4702,1570,1412,569,98,259,3908
New Jersey,Ramtown,6076,1438,3045,302,9,131,4925
New Jersey,Vernon Valley,1567,438,721,101,6,82,1348
New Jersey,Asbury Park,15674,6382,3649,1608,348,663,12650
New Jersey,Bloomingdale borough,8105,2079,3395,675,63,514,6726
New Jersey,Hasbrouck Heights borough,12091,3307,5421,549,209,689,10175
New Jersey,Highlands borough,4818,1594,1847,667,108,229,4445
New Jersey,North Haledon borough,8446,1122,4853,515,69,593,7152
New Jersey,Cedar Glen Lakes,1543,161,667,260,28,427,1543
New Jersey,Hawthorne borough,18802,5106,7796,1381,239,950,15472
New Jersey,Clifton,85169,25178,33876,5776,1626,4373,70829
New Jersey,Twin Rivers,7067,1980,2963,437,75,197,5652
New Jersey,Princeton Junction,2550,323,1645,70,0,76,2114
New Jersey,Hightstown borough,5413,1391,1964,738,126,208,4427
New Jersey,Old Bridge,23607,5808,11635,817,132,1175,19567
New Jersey,Passaic,70131,24359,19219,3226,1974,2126,50904
New Jersey,Perth Amboy,51832,17179,16173,3418,1343,1994,40107
New Jersey,Buena borough,4422,1061,1609,460,62,303,3495
New Jersey,Island Heights borough,1457,334,643,150,7,116,1250
New Jersey,Dover Beaches South,1281,326,637,131,25,116,1235
New Jersey,Holiday Heights,1878,153,1086,77,0,562,1878
New Jersey,Mystic Island,8717,1816,3983,826,105,701,7431
New Jersey,Tuckerton borough,3380,693,1493,343,17,258,2804
New Jersey,Pompton Lakes borough,11049,3074,4606,1048,78,556,9362
New Jersey,Holiday City-Berkeley,12360,1658,6254,1662,128,2618,12320
New Jersey,Plainsboro Center,2752,457,1401,144,14,45,2061
New Jersey,Barnegat Light borough,421,47,277,24,0,71,419
New Jersey,Dover Beaches North,1713,299,870,220,16,209,1614
New Jersey,White Horse,8512,2497,3677,615,111,506,7406
New Jersey,Allenhurst borough,502,127,268,38,2,14,449
New Jersey,Kendall Park,9346,1911,4656,389,50,425,7431
New Jersey,Watchung borough,6034,1574,2638,448,24,319,5003
New Jersey,Rocky Hill borough,598,114,320,32,0,21,487
New Jersey,Millstone borough,500,107,202,35,8,18,370
New Jersey,Lambertville,3820,1254,1539,582,101,125,3601
New Jersey,High Bridge borough,3527,842,1539,345,24,127,2877
New Jersey,Linwood,6826,1323,3185,554,55,486,5603
New Jersey,Absecon,8289,2058,3452,916,89,398,6913
New Jersey,Woodbridge,19190,4442,8600,1408,274,859,15583
New Jersey,Spotswood borough,8293,1651,4128,506,119,532,6936
New Jersey,South River borough,16091,4632,6554,761,154,843,12944
New Jersey,Hampton borough,1219,236,583,112,34,60,1025
New Jersey,Spring Lake Heights borough,4595,1206,1980,585,15,335,4121
New Jersey,Shark River Hills,3609,861,1746,298,25,149,3079
New Jersey,Manasquan borough,5800,1271,2940,407,66,330,5014
New Jersey,Loch Arbour village,178,62,74,11,2,10,159
New Jersey,Wanaque borough,11689,2783,5050,1092,41,732,9698
New Jersey,Haledon borough,8338,2929,2899,548,169,301,6846
New Jersey,Mantoloking borough,337,36,236,15,1,24,312
New Jersey,North Middletown,3230,1068,1073,301,23,141,2606
New Jersey,North Beach Haven,2061,342,1247,189,17,254,2049
New Jersey,Brooklawn borough,2023,700,611,252,32,111,1706
New Jersey,Lavallette borough,2161,332,1338,161,16,199,2046
New Jersey,Leisure Village,4355,1130,1005,666,70,1207,4078
New Jersey,Waretown,1933,529,763,316,22,61,1691
New Jersey,Kinnelon borough,10132,2201,4957,546,93,342,8139
New Jersey,Mount Arlington borough,5507,1232,2471,553,138,353,4747
New Jersey,Whittingham,2662,278,1791,141,16,372,2598
New Jersey,Margate City,6076,1202,3206,651,21,473,5553
New Jersey,Florham Park borough,11672,3662,5049,707,157,518,10093
New Jersey,Cedar Glen West,1284,243,375,278,34,313,1243
New Jersey,Lincoln Park borough,10339,2953,4223,972,76,538,8762
New Jersey,Wildwood Crest borough,3131,583,1707,278,17,280,2865
New Jersey,Carneys Point,7151,1871,2624,824,150,586,6055
New Jersey,Allentown borough,1903,497,850,171,19,78,1615
New Jersey,Glen Gardner borough,1590,428,601,249,25,64,1367
New Jersey,Peapack and Gladstone borough,2566,582,1039,235,55,94,2005
New Jersey,South Bound Brook borough,4550,1347,1755,297,59,181,3639
New Jersey,Belford,1908,559,823,78,28,71,1559
New Jersey,Eatontown borough,12237,3118,4753,1571,240,587,10269
New Jersey,Victory Gardens borough,1578,447,525,138,50,40,1200
New Jersey,South Toms River borough,3748,1386,1018,245,53,106,2808
New Jersey,Ocean Gate borough,1733,522,581,221,8,135,1467
New Jersey,Barnegat,2657,659,1262,226,20,61,2228
New Jersey,Chesilhurst borough,1499,513,365,339,25,102,1344
New Jersey,Echelon,11586,3475,4533,890,93,525,9516
New Jersey,Morganville,5041,1006,2556,263,0,162,3987
New Jersey,Egg Harbor City,4153,1134,1247,550,87,147,3165
New Jersey,Estell Manor,1752,480,846,103,22,56,1507
New Jersey,Folsom borough,1768,424,791,136,31,104,1486
New Jersey,Longport borough,828,122,453,66,14,102,757
New Jersey,Port Republic,1178,315,582,58,0,84,1039
New Jersey,Ventnor City,10232,2726,3735,1339,178,803,8781
New Jersey,Frenchtown borough,1297,364,442,196,27,44,1073
New Jersey,Bound Brook borough,10328,3295,3484,970,162,349,8260
New Jersey,Manville borough,10283,2895,3570,1007,217,610,8299
New Jersey,Belmar borough,5647,2124,1987,588,143,201,5043
New Jersey,Bradley Beach borough,4223,1722,1346,389,55,248,3760
New Jersey,Cliffwood Beach,3015,771,1366,274,31,65,2507
New Jersey,Fair Haven borough,5943,1009,2909,269,50,104,4341
New Jersey,Lakewood,55532,11425,17142,923,315,879,30684
New Jersey,Little Silver borough,5864,881,3264,203,15,160,4523
New Jersey,Pine Beach borough,2251,494,1055,153,14,182,1898
New Jersey,Pine Ridge at Crestwood,2255,424,841,428,22,540,2255
New Jersey,Deal borough,513,109,237,53,6,60,465
New Jersey,White House Station,2210,574,1005,246,0,193,2018
New Jersey,Milford borough,1295,380,555,163,0,64,1162
New Jersey,Lebanon borough,1945,528,760,272,32,63,1655
New Jersey,Califon borough,1194,231,595,62,12,27,927
New Jersey,Somers Point,10460,3263,3579,1142,207,522,8713
New Jersey,West Long Branch borough,7917,2593,3206,424,30,313,6566
New Jersey,West Belmar,2379,837,776,328,12,172,2125
New Jersey,Strathmore,7742,1682,3982,357,24,274,6319
New Jersey,Shrewsbury borough,4088,671,2136,143,63,294,3307
New Jersey,Sea Bright borough,1378,433,529,186,39,50,1237
New Jersey,Bernardsville borough,7698,1344,4211,362,31,142,6090
New Jersey,Leisuretowne,3349,320,1823,518,16,642,3319
New Jersey,Mullica Hill,3851,879,1781,227,66,208,3161
New Jersey,Paulsboro borough,5937,2204,1979,488,49,597,5317
New Jersey,Westville borough,4185,1170,1292,474,109,293,3338
New Jersey,Gibbsboro borough,2223,573,977,150,17,145,1862
New Jersey,Haddon Heights borough,7491,1588,3566,484,55,455,6148
New Jersey,Oceanport borough,5724,1071,2917,411,20,315,4734
New Jersey,Oaklyn borough,3954,1117,1594,467,52,139,3369
New Jersey,Mountain Lakes borough,4274,859,2122,167,46,80,3274
New Jersey,Pemberton Heights,2593,987,774,280,39,125,2205
New Jersey,Far Hills borough,860,186,437,97,2,7,729
New Jersey,North Plainfield borough,21640,7538,7755,1344,397,608,17642
New Jersey,Brielle borough,4709,836,2505,234,33,227,3835
New Jersey,Hackettstown,9501,2995,3601,740,69,448,7853
New Jersey,Olivet,1466,286,796,38,6,111,1237
New Jersey,Riverton borough,2704,689,1221,194,20,104,2228
New Jersey,Pemberton borough,1416,310,622,122,43,70,1167
New Jersey,Lake Telemark,1107,290,466,89,8,68,921
New Jersey,Chester borough,1593,361,687,144,9,103,1304
New Jersey,Palmyra borough,7223,2120,2802,764,158,235,6079
New Jersey,Bordentown,3840,1475,1040,517,45,283,3360
New Jersey,Summit,21921,4239,10589,1077,145,927,16977
New Jersey,Oxford,1168,377,344,128,31,141,1021
New Jersey,Chatham borough,8881,1437,4470,258,45,288,6498
New Jersey,Pennington borough,2527,436,1250,95,72,202,2055
New Jersey,Roselle Park borough,13568,3709,5535,810,140,755,10949
New Jersey,New Providence borough,12808,2260,6093,699,120,616,9788
New Jersey,Ogdensburg borough,2314,617,1026,180,0,114,1937
New Jersey,Red Bank borough,12120,4402,3620,1137,250,470,9879
New Jersey,Lincroft,6348,1093,3579,237,0,171,5080
New Jersey,Farmingdale borough,1398,419,438,192,30,45,1124
New Jersey,East Freehold,4749,1007,2638,257,17,116,4035
New Jersey,Brass Castle,1657,523,707,0,70,111,1411
New Jersey,Villas,8783,2200,3651,1056,130,461,7498
New Jersey,Seaside Park borough,1654,511,758,104,10,131,1514
New Jersey,Point Pleasant Beach borough,4545,1109,2148,454,41,231,3983
New Jersey,Garwood borough,4334,1188,1737,417,25,246,3613
New Jersey,Mays Landing,2408,737,867,181,85,117,1987
New Jersey,Interlaken borough,758,139,426,55,2,58,680
New Jersey,Williamstown,14962,3599,6537,1133,197,761,12227
New Jersey,Mount Ephraim borough,4607,1551,1709,319,75,247,3901
New Jersey,Hopewell borough,1940,376,860,169,17,83,1505
New Jersey,Roselle borough,21582,8516,6596,1344,289,1112,17857
New Jersey,Marlton,9990,2569,4528,782,141,504,8524
New Jersey,Sewaren,2318,712,890,243,30,111,1986
New Jersey,Kingston,1254,361,652,52,0,76,1141
New Jersey,Union Beach borough,5549,1589,2154,483,82,263,4571
New Jersey,Franklin borough,4807,1127,1943,454,127,278,3929
New Jersey,Madison Park,6941,1767,2846,626,64,400,5703
New Jersey,Holiday City South,4329,783,2025,433,33,847,4121
New Jersey,Leisure Village East,3747,436,1637,519,56,1067,3715
New Jersey,Pleasantville,20374,7393,5085,1810,996,977,16261
New Jersey,South Amboy,8694,2394,3546,674,51,496,7161
New Jersey,Hammonton,14284,4131,4956,1352,220,972,11631
New Jersey,Northfield,8344,1969,3647,664,69,430,6779
New Jersey,Rossmoor,2918,385,1355,558,26,594,2918
New Jersey,Freehold borough,11855,3649,4150,784,89,556,9228
New Jersey,Spring Lake borough,2945,709,1383,265,16,186,2559
New Jersey,Beckett,4983,1083,2063,545,48,75,3814
New Jersey,Fort Dix,7753,3583,2242,587,316,26,6754
New Jersey,Medford Lakes borough,4031,865,2006,299,44,139,3353
New Jersey,Boonton,8302,2174,3400,767,79,294,6714
New Jersey,Stanhope borough,3377,734,1462,391,20,94,2701
New Jersey,Glen Ridge borough,7573,1293,4032,136,50,114,5625
New Jersey,Beverly,2348,598,826,306,86,80,1896
New Jersey,Burlington,9814,2766,3255,941,227,778,7967
New Jersey,Allenwood,881,239,334,55,0,107,735
New Jersey,Clinton,2676,563,1210,284,21,90,2168
New Jersey,Flemington borough,4624,1252,1687,441,73,286,3739
New Jersey,Somerset,24527,6677,10764,1588,236,1332,20597
New Jersey,Sayreville borough,44285,11550,19136,2965,611,2212,36474
New Jersey,Port Reading,4139,1019,1643,167,63,344,3236
New Jersey,Heathcote,6189,1489,3031,319,77,161,5077
New Jersey,Laurence Harbor,6904,2343,2709,501,34,254,5841
New Jersey,Collings Lakes,1601,415,723,140,0,39,1317
New Jersey,Clementon borough,4911,1771,1294,496,152,173,3886
New Jersey,Elmwood Park borough,20112,5897,8283,1122,311,901,16514
New Jersey,Hackensack,44381,14656,14599,5105,1153,2047,37560
New Jersey,Wrightstown borough,659,237,200,78,10,20,545
New Jersey,Keyport borough,7070,1863,2714,610,102,505,5794
New Jersey,Stone Harbor borough,955,183,567,70,3,94,917
New Jersey,Alpha borough,2100,440,932,209,44,158,1783
New Jersey,Iselin,18274,3541,9330,968,264,1221,15324
New Jersey,Dunellen borough,7284,2090,2305,558,188,577,5718
New Jersey,Glassboro borough,19580,8707,5840,1255,245,602,16649
New Jersey,Carteret borough,23682,6544,9532,1475,318,1118,18987
New Jersey,Brownville,2629,478,1084,390,16,179,2147
New Jersey,Jersey City,261746,90700,91250,17130,5892,9627,214599
New Jersey,Fairton,988,292,356,86,18,63,815
New Jersey,Bayonne,65300,19127,24836,4231,1188,3255,52637
New Jersey,Saddle River borough,3212,598,1678,184,33,322,2815
New Jersey,Gibbstown,3735,846,1719,223,34,299,3121
New Jersey,Victory Lakes,1888,462,942,129,55,94,1682
New Jersey,Cherry Hill Mall,13752,3632,5913,847,273,814,11479
New Jersey,Collingswood borough,13912,3953,5248,1339,364,675,11579
New Jersey,Laurel Springs borough,1907,526,783,160,27,105,1601
New Jersey,Woodcliff Lake borough,5816,1125,3212,255,0,221,4813
New Jersey,Pitman borough,8830,2566,3533,671,67,524,7361
New Jersey,Bellmawr borough,11415,3249,4315,1003,132,771,9470
New Jersey,Glendora,4416,1274,1710,315,112,375,3786
New Jersey,Vineland,60357,17774,20636,5685,1305,2778,48178
New Jersey,Port Norris,872,283,173,198,23,104,781
New Jersey,Cranbury,2144,451,1071,123,22,109,1776
New Jersey,Kearny,41567,12493,15709,3143,961,1790,34096
New Jersey,Hoboken,53211,24362,17766,2545,399,1366,46438
New Jersey,Upper Saddle River borough,8242,1848,3834,444,11,259,6396
New Jersey,Ridgefield borough,11248,2905,5164,839,175,487,9570
New Jersey,Montvale borough,8438,1990,3797,382,178,446,6793
New Jersey,Lodi borough,24498,7847,9370,1895,422,1044,20578
New Jersey,Hillsdale borough,10395,2155,5105,557,92,549,8458
New Jersey,Emerson borough,7611,1585,3770,327,72,580,6334
New Jersey,Demarest borough,4959,839,2643,102,26,295,3905
New Jersey,Cresskill borough,8730,1538,4468,408,19,459,6892
New Jersey,Merchantville borough,3726,998,1339,366,58,248,3009
New Jersey,Haddonfield borough,11369,1766,5782,612,64,516,8740
New Jersey,Magnolia borough,4289,1576,1341,389,145,170,3621
New Jersey,Stratford borough,6967,2089,2903,446,108,236,5782
New Jersey,Closter borough,8585,1878,4562,299,23,238,7000
New Jersey,Strathmere,242,63,106,0,0,52,221
New Jersey,Silver Ridge,1044,225,484,103,8,224,1044
New Jersey,Ship Bottom borough,967,145,573,120,10,62,910
New Jersey,Leisure Knoll,2386,136,1372,282,31,565,2386
New Jersey,Belvidere,2601,621,972,306,41,67,2007
New Jersey,Washington borough,6478,1850,2476,753,101,230,5410
New Jersey,Ringwood borough,12276,2674,6024,654,30,489,9871
New Jersey,Crestwood Village,8164,756,3509,1355,117,2403,8140
New Jersey,Manahawkin,2140,452,929,203,65,141,1790
New Jersey,Seaside Heights borough,2891,1237,716,348,45,28,2374
New Jersey,Toms River,88712,21067,38149,7251,945,5733,73145
New Jersey,Vista Center,2202,299,1479,117,0,110,2005
New Jersey,Bay Head borough,996,113,595,89,4,59,860
New Jersey,Beach Haven borough,1091,209,644,73,6,90,1022
New Jersey,Beach Haven West,3860,948,2149,307,36,193,3633
New Jersey,Forked River,4701,1092,2246,341,1,245,3925
New Jersey,New Egypt,2407,567,1080,189,19,156,2011
New Jersey,Clayton borough,8545,2518,3223,884,293,350,7268
New Jersey,Point Pleasant borough,18523,4640,8389,1520,247,673,15469
New Jersey,Leonia borough,9111,1964,4444,421,192,564,7585
New Jersey,Riverdale borough,4226,1000,1780,489,28,228,3525
New Jersey,White Meadow Lake,9383,1893,4866,551,101,234,7645
New Jersey,Sea Isle City,1955,254,1208,168,21,178,1829
New Jersey,Woodbine borough,2490,1110,568,182,65,117,2042
New Jersey,Elmer borough,1445,380,516,127,36,70,1129
New Jersey,Pennsville,11311,2518,4554,1272,215,707,9266
New Jersey,Rutherford borough,18427,4557,8683,1210,106,728,15284
New Jersey,Bogota borough,8362,2606,3214,659,186,354,7019
New Jersey,Springdale,13547,2540,7280,689,42,758,11309
New Jersey,Golden Triangle,4602,1386,1837,270,139,370,4002
New Jersey,Moonachie borough,2739,502,1266,199,86,120,2173
New Jersey,Old Tappan borough,5923,1146,3160,169,39,311,4825
New Jersey,Ho-Ho-Kus borough,4101,459,2301,122,28,135,3045
New Jersey,Haworth borough,3418,646,1818,137,26,169,2796
New Jersey,Glen Rock borough,11826,1790,6217,295,34,452,8788
New Jersey,Surf City borough,1292,243,735,100,11,108,1197
New Jersey,Oak Valley,3357,974,1313,233,62,214,2796
New Jersey,Shiloh borough,374,94,173,26,1,18,312
New Jersey,Rosenhayn,1360,377,448,174,87,35,1121
New Jersey,Alpine borough,1513,298,842,20,11,57,1228
New Jersey,East Rutherford borough,9466,2567,4246,533,132,551,8029
New Jersey,Englewood,28332,7851,11783,1862,606,1186,23288
New Jersey,Oakland borough,13009,2658,6590,717,86,440,10491
New Jersey,Harvey Cedars borough,451,42,309,21,5,45,422
New Jersey,Garfield,31578,9463,11445,2683,667,1320,25578
New Jersey,New Milford borough,16578,4137,7566,899,214,988,13804
New Jersey,Roosevelt borough,806,138,406,45,7,33,629
New Jersey,Palisades Park borough,20554,5692,9610,1199,349,922,17772
New Jersey,Bridgeton,24841,10147,4831,1679,673,813,18143
New Jersey,Princeton Meadows,13438,3161,6285,687,180,180,10493
New Jersey,Fair Lawn borough,33081,7051,16423,1639,206,1690,27009
New Jersey,Fort Lee borough,36990,8093,17995,2708,494,2470,31760
New Jersey,Franklin Lakes borough,10883,2192,5835,569,52,362,9010
New Jersey,Avenel,18831,6463,7136,1181,185,850,15815
New Jersey,Corbin City,457,100,206,47,15,13,381
New Jersey,Rockleigh borough,558,125,169,41,20,146,501
New Jersey,Secaucus,19390,4970,8947,1252,208,1106,16483
New Jersey,Colonia,17734,4371,8515,948,123,967,14924
New Jersey,South Plainfield borough,23906,5662,11434,1213,155,1177,19641
New Jersey,Annandale,1485,354,695,170,0,20,1239
New Jersey,Bloomsbury borough,721,192,322,85,7,31,637
New Jersey,Stockton borough,655,175,216,90,23,30,534
New Jersey,Raritan borough,7797,1917,3556,618,66,416,6573
New Jersey,Somerville borough,12121,3688,4644,884,121,501,9838
New Jersey,Avon-by-the-Sea borough,1761,395,821,100,43,199,1558
New Jersey,Englishtown borough,2078,461,913,144,26,156,1700
New Jersey,Tavistock borough,3,0,3,0,0,0,3
New Jersey,Hi-Nella borough,959,351,294,89,19,35,788
New Jersey,Fairview borough,14269,4733,4828,1500,344,706,12111
New Jersey,Camden,74608,32478,12195,4766,2420,3062,54921
New Jersey,Turnersville,3596,826,1687,168,35,93,2809
New Jersey,Laurel Lake,3503,878,927,519,132,184,2640
New Jersey,Cedarville,955,296,288,55,24,28,691
New Jersey,Paramus borough,26613,6270,12821,1168,189,2174,22622
New Jersey,Oradell borough,8134,1508,4251,348,92,287,6486
New Jersey,Northvale borough,4854,1112,2370,157,0,304,3943
New Jersey,Midland Park borough,7263,1428,3650,395,62,237,5772
New Jersey,Gloucester City,11246,3787,3131,779,222,725,8644
New Jersey,Harrington Park borough,4761,736,2575,165,0,221,3697
New Jersey,Brigantine,8966,2200,4324,879,69,589,8061
New Jersey,Monmouth Junction,3302,555,1836,36,0,47,2474
New Jersey,Milltown borough,6993,1722,3334,258,29,427,5770
New Jersey,Jamesburg borough,5947,1339,2763,384,2,88,4576
New Jersey,Helmetta borough,2283,581,964,240,36,95,1916
New Jersey,Little Ferry borough,10827,3232,4725,679,152,588,9376
New Jersey,Concordia,3377,187,1808,495,0,866,3356
New Jersey,Fords,14948,3805,6772,769,115,712,12173
New Jersey,Matawan borough,8826,2150,3749,591,71,568,7129
New Jersey,Ocean Grove,3133,1025,1191,427,82,342,3067
New Jersey,Port Monmouth,3225,809,1453,183,38,172,2655
New Jersey,Rumson borough,6805,1200,3287,291,2,193,4973
New Jersey,Sea Girt borough,1732,251,1066,73,0,130,1520
New Jersey,Lakehurst borough,2683,746,972,233,30,128,2109
New Jersey,West Freehold,13759,3268,6281,815,96,715,11175
New Jersey,Park Ridge borough,8804,1983,4281,650,59,410,7383
New Jersey,Waldwick borough,9948,1872,5146,452,20,432,7922
New Jersey,Wallington borough,11580,2840,5479,951,94,613,9977
New Jersey,Wood-Ridge borough,8511,2340,3798,546,152,345,7181
New Jersey,Harrison,16180,4902,6238,1007,397,559,13103
New Jersey,Wanamassa,4628,1089,2406,261,18,112,3886
New Mexico,Arrey,23,0,0,23,0,0,23
New Mexico,Arenas Valley,1647,317,740,83,0,152,1292
New Mexico,Aragon,64,0,64,0,0,0,64
New Mexico,Apache Creek,144,0,78,16,0,50,144
New Mexico,Anzac Village,72,7,46,0,0,5,58
New Mexico,Adelino,907,76,411,297,0,123,907
New Mexico,Animas,160,5,111,12,3,0,131
New Mexico,Alamillo,192,68,62,55,0,7,192
New Mexico,Abiquiu,246,51,176,0,0,0,227
New Mexico,Abeytas,177,123,20,0,0,6,149
New Mexico,Ruidoso Downs,2597,626,725,240,165,183,1939
New Mexico,Anton Chico,189,41,142,0,0,6,189
New Mexico,Peralta,3577,802,1613,386,0,370,3171
New Mexico,Salem,650,119,276,16,0,0,411
New Mexico,Ute Park,219,0,183,36,0,0,219
New Mexico,Mountainair,974,290,320,174,19,41,844
New Mexico,San Ysidro village,193,64,21,48,10,30,173
New Mexico,Portales,11974,4201,3594,719,169,655,9338
New Mexico,Floyd village,111,26,40,5,0,10,81
New Mexico,Lovington,11575,2496,4300,955,366,459,8576
New Mexico,Arroyo Hondo,174,9,101,35,0,8,153
New Mexico,Artesia,12202,2730,4608,1187,100,457,9082
New Mexico,Rincon,413,130,88,0,0,0,218
New Mexico,Flora Vista,1799,126,1086,248,65,96,1621
New Mexico,Mesquite,414,22,232,39,0,0,293
New Mexico,Tijeras village,655,160,291,66,0,27,544
New Mexico,Carnuel,1724,353,852,150,15,132,1502
New Mexico,Albuquerque,559202,167750,188498,64054,7108,25493,452903
New Mexico,Pueblo,0,0,0,0,0,0,0
New Mexico,Española,10090,3267,2623,1018,123,679,7710
New Mexico,Anthony,9368,2816,3040,356,230,340,6782
New Mexico,Gallina,175,56,81,26,0,0,163
New Mexico,Rio Communities,4587,1062,2019,358,127,312,3878
New Mexico,Springer,811,209,335,106,0,95,745
New Mexico,Cuartelez,124,46,52,26,0,0,124
New Mexico,Pojoaque,2018,633,650,208,27,65,1583
New Mexico,Isleta Village Proper,389,196,73,51,0,22,342
New Mexico,Corona village,103,14,58,17,0,12,101
New Mexico,Santa Teresa,5696,1626,2228,262,12,123,4251
New Mexico,Vado,2579,817,853,112,27,122,1931
New Mexico,Estancia,1643,533,588,178,18,123,1440
New Mexico,Jemez Springs village,205,56,99,45,0,2,202
New Mexico,La Jara,257,0,120,58,0,9,187
New Mexico,Grenville village,17,2,13,0,0,2,17
New Mexico,Los Chaves,5890,1072,2614,648,37,241,4612
New Mexico,Tatum,772,129,293,100,12,54,588
New Mexico,Dora village,134,32,63,2,1,12,110
New Mexico,Willard village,202,51,69,14,11,9,154
New Mexico,Santa Ana Pueblo,602,270,149,37,11,41,508
New Mexico,Zia Pueblo,934,384,191,23,10,42,650
New Mexico,Torreon CDP (Torrance County),231,68,94,36,0,33,231
New Mexico,Vadito,295,92,95,24,4,32,247
New Mexico,Shiprock,8966,3626,2196,498,126,344,6790
New Mexico,Naschitti,328,125,90,27,5,37,284
New Mexico,Farmington,45582,12449,16020,3904,546,1836,34755
New Mexico,Los Ranchos de Albuquerque village,6131,1312,2547,805,17,453,5134
New Mexico,Kirtland,884,318,354,10,0,67,749
New Mexico,Youngsville,42,0,33,9,0,0,42
New Mexico,Los Alamos,12373,2393,6253,1001,26,402,10075
New Mexico,Wagon Mound village,266,98,60,35,2,58,253
New Mexico,Cañada de los Alamos,416,155,138,20,0,25,338
New Mexico,Doña Ana,851,40,560,87,0,111,798
New Mexico,Napi Headquarters,744,263,236,18,5,15,537
New Mexico,Peña Blanca,605,209,151,51,16,11,438
New Mexico,Peñasco,663,205,194,91,20,32,542
New Mexico,Cannon AFB,2523,624,1043,29,10,8,1714
New Mexico,Young Place,214,0,74,27,28,0,129
New Mexico,Winston,64,0,50,14,0,0,64
New Mexico,Windmill,85,8,39,2,0,20,69
New Mexico,White Signal,272,50,173,6,0,9,238
New Mexico,Whites City,173,70,69,34,0,0,173
New Mexico,West Hammond,2787,592,1106,420,52,76,2246
New Mexico,Weed,0,0,0,0,0,0,0
New Mexico,Watrous,124,62,17,0,0,12,91
New Mexico,Villanueva,362,198,96,0,0,0,294
New Mexico,Ventura,403,51,275,0,0,77,403
New Mexico,Velarde,119,119,0,0,0,0,119
New Mexico,Waterflow,1769,494,702,84,20,45,1345
New Mexico,Veguita,80,0,72,8,0,0,80
New Mexico,Virden village,152,16,77,12,0,8,113
New Mexico,Tyrone,551,113,181,97,4,36,431
New Mexico,Dexter,1091,299,359,63,39,85,845
New Mexico,Rio Lucio,474,182,139,39,4,40,404
New Mexico,Tularosa village,2931,842,1121,451,52,271,2737
New Mexico,Church Rock,909,322,197,87,7,55,668
New Mexico,Tohatchi,825,306,202,39,6,40,593
New Mexico,Las Vegas,13341,5780,2649,1936,194,791,11350
New Mexico,Mosquero village,71,2,32,9,0,1,44
New Mexico,Williamsburg village,448,106,129,89,0,52,376
New Mexico,Lordsburg,2539,595,880,269,70,228,2042
New Mexico,Logan village,848,309,328,92,0,34,763
New Mexico,Tucumcari,4958,1332,1140,665,209,410,3756
New Mexico,Tse Bonito,176,94,0,0,0,82,176
New Mexico,Dulce,2663,947,439,390,44,96,1916
New Mexico,Questa village,2019,566,749,129,16,153,1613
New Mexico,Valencia,1826,415,890,188,38,165,1696
New Mexico,Elephant Butte,1366,86,783,300,25,97,1291
New Mexico,Picuris Pueblo,115,26,48,24,0,6,104
New Mexico,Taos Ski Valley village,95,21,44,0,0,0,65
New Mexico,Hurley,1439,241,583,147,4,118,1093
New Mexico,Nageezi,261,79,57,8,3,15,162
New Mexico,Chamisal,336,111,121,54,0,16,302
New Mexico,Silver City,9783,2907,2980,1430,159,424,7900
New Mexico,Arroyo Seco,973,235,324,157,0,62,778
New Mexico,Kingston,0,0,0,0,0,0,0
New Mexico,Blanco,85,35,50,0,0,0,85
New Mexico,Madrone,682,179,211,82,11,46,529
New Mexico,Lyden,138,0,138,0,0,0,138
New Mexico,McCartys Village,72,25,7,10,11,0,53
New Mexico,McIntosh,1089,256,487,130,46,58,977
New Mexico,Malaga,148,25,56,35,0,32,148
New Mexico,Manzano Springs,229,22,88,0,0,0,110
New Mexico,Mayhill,59,8,49,2,0,0,59
New Mexico,Luna,43,0,35,8,0,0,43
New Mexico,Middle Frisco,21,0,21,0,0,0,21
New Mexico,Mimbres,536,65,237,63,37,134,536
New Mexico,Monterey Park,1493,560,300,101,0,34,995
New Mexico,Monument,96,0,65,0,0,0,65
New Mexico,Moquino,43,0,43,0,0,0,43
New Mexico,Mora,907,493,287,0,0,9,789
New Mexico,Morningside,857,237,189,85,0,0,511
New Mexico,Mountain View,135,0,58,77,0,0,135
New Mexico,Midway,841,207,292,139,11,35,684
New Mexico,Lumberton,186,72,0,15,0,0,87
New Mexico,Luis Lopez,191,107,0,0,0,51,158
New Mexico,Lower Frisco,0,0,0,0,0,0,0
New Mexico,Gallup,22105,6558,6387,1519,391,936,15791
New Mexico,Lamy,180,55,23,44,22,0,144
New Mexico,La Mesa,571,176,234,20,25,59,514
New Mexico,La Mesilla,2384,654,853,367,35,134,2043
New Mexico,La Plata,515,93,290,28,0,16,427
New Mexico,Las Maravillas,1668,419,715,136,16,34,1320
New Mexico,Las Nutrias,82,0,2,40,0,0,42
New Mexico,Las Palomas,306,0,196,0,0,27,223
New Mexico,La Union,869,289,444,40,12,26,811
New Mexico,La Villita,1166,363,458,120,0,42,983
New Mexico,Lee Acres,6084,1651,2170,486,183,224,4714
New Mexico,Lemitar,459,178,161,12,0,16,367
New Mexico,Livingston Wheeler,851,110,385,47,18,79,639
New Mexico,Llano del Medio,156,76,0,6,46,28,156
New Mexico,Loco Hills,22,0,22,0,0,0,22
New Mexico,Los Luceros,483,207,134,47,0,0,388
New Mexico,Los Ojos,52,26,0,26,0,0,52
New Mexico,Nadine,328,61,182,26,0,0,269
New Mexico,Nambe,1814,510,660,213,26,83,1492
New Mexico,Nara Visa,47,0,18,0,7,22,47
New Mexico,Navajo Dam,329,89,170,70,0,0,329
New Mexico,Alamo,742,438,148,9,2,38,635
New Mexico,Socorro,8554,3770,1866,745,176,435,6992
New Mexico,Bloomfield,7996,1297,3160,816,56,266,5595
New Mexico,Raton,6145,1554,1947,902,58,634,5095
New Mexico,Grants,9063,2325,3008,1156,266,511,7266
New Mexico,Paguate,420,143,121,47,10,49,370
New Mexico,Chaparral,14793,3707,5441,937,417,414,10916
New Mexico,Skyline-Ganipa,1208,449,254,110,21,63,897
New Mexico,Agua Fria,2959,1175,982,260,39,158,2614
New Mexico,Cedar Crest,709,162,337,46,57,49,651
New Mexico,Laguna,1151,370,324,89,29,55,867
New Mexico,Las Cruces,101742,32249,34034,9756,1293,4280,81612
New Mexico,Hope village,104,30,28,11,2,0,71
New Mexico,Causey village,80,15,40,10,5,4,74
New Mexico,Bernalillo,9315,2659,3659,1035,142,499,7994
New Mexico,Rio Rancho,94765,21529,38970,10247,802,3881,75429
New Mexico,Belen,7106,2259,1766,1115,189,365,5694
New Mexico,Tesuque,837,165,338,190,17,89,799
New Mexico,Crownpoint,2500,1131,562,130,27,132,1982
New Mexico,San Ildefonso Pueblo,742,334,196,50,6,34,620
New Mexico,Jaconita,426,71,202,68,6,27,374
New Mexico,Newkirk,0,0,0,0,0,0,0
New Mexico,Nogal,133,55,24,39,2,13,133
New Mexico,North Hobbs,6068,1214,2968,378,4,238,4802
New Mexico,North Hurley,134,33,67,34,0,0,134
New Mexico,North Light Plant,348,91,139,36,8,23,297
New Mexico,North San Ysidro,0,0,0,0,0,0,0
New Mexico,Oasis,63,14,10,30,0,0,54
New Mexico,Ohkay Owingeh,1356,643,288,96,0,98,1125
New Mexico,Organ,200,126,0,20,46,8,200
New Mexico,Orogrande,91,0,68,5,0,0,73
New Mexico,Pajarito Mesa,289,86,96,53,0,0,235
New Mexico,Paradise Hills,5079,884,1880,676,174,238,3852
New Mexico,Pastura,8,8,0,0,0,0,8
New Mexico,Peak Place,412,121,103,40,8,7,279
New Mexico,Roy village,184,50,72,28,3,26,179
New Mexico,Vaughn,151,44,75,5,0,27,151
New Mexico,Chimayo,2459,1019,911,188,0,58,2176
New Mexico,Los Cerrillos,260,91,119,32,0,18,260
New Mexico,Atoka,1019,195,420,119,56,53,843
New Mexico,Black Rock,1684,533,444,43,20,71,1111
New Mexico,Hagerman,914,272,351,70,7,15,715
New Mexico,Cliff,184,18,108,30,0,6,162
New Mexico,Cobre,24,24,0,0,0,0,24
New Mexico,Cochiti Lake,522,109,258,87,3,21,478
New Mexico,Conchas Dam,16,0,0,16,0,0,16
New Mexico,Cordova,759,263,170,147,0,65,645
New Mexico,Costilla,92,39,0,0,0,53,92
New Mexico,Cotton City,288,35,151,7,13,17,223
New Mexico,City of the Sun,47,0,0,47,0,0,47
New Mexico,Coyote,87,0,61,11,0,15,87
New Mexico,Cubero,266,58,139,0,0,0,197
New Mexico,Cuyamungue Grant,188,10,103,19,2,5,139
New Mexico,Datil,14,0,14,0,0,0,14
New Mexico,Dixon,794,52,441,91,0,6,590
New Mexico,Duran,11,0,4,2,0,0,6
New Mexico,East Pecos,583,335,125,28,0,0,488
New Mexico,Edith Endave,432,95,173,61,10,9,348
New Mexico,Cruzville,182,91,91,0,0,0,182
New Mexico,Chili,789,202,364,42,0,22,630
New Mexico,Chical,111,48,29,11,0,6,94
New Mexico,Chamizal,76,10,0,66,0,0,76
New Mexico,Bent,56,56,0,0,0,0,56
New Mexico,Berino,1610,382,502,159,48,116,1207
New Mexico,Bibo,150,76,0,0,8,26,110
New Mexico,Bluewater Acres,205,48,97,43,0,0,188
New Mexico,Bluewater Village,277,117,56,0,0,104,277
New Mexico,Brazos,92,0,92,0,0,0,92
New Mexico,Buckhorn,170,18,76,15,0,61,170
New Mexico,Caballo,58,0,0,58,0,0,58
New Mexico,Canjilon,363,107,201,0,0,11,319
New Mexico,Cañon,303,0,122,57,0,0,179
New Mexico,Cañones,37,0,17,3,17,0,37
New Mexico,Canova,83,0,0,44,0,39,83
New Mexico,Capulin,54,10,32,0,0,0,42
New Mexico,Cedar Hill,772,118,392,46,32,71,659
New Mexico,Cedro,322,54,194,30,0,0,278
New Mexico,Chamberino,666,150,259,53,22,37,521
New Mexico,Chamita,1042,397,280,120,3,70,870
New Mexico,El Cerro,2507,464,1132,355,0,96,2047
New Mexico,El Cerro Mission,4734,1227,2002,338,52,109,3728
New Mexico,El Duende,454,103,170,50,0,3,326
New Mexico,El Rito,1110,488,162,240,0,17,907
New Mexico,Jacona,377,85,173,43,1,28,330
New Mexico,Keeler Farm,1804,462,555,221,48,157,1443
New Mexico,Twin Forks,200,31,115,38,0,7,191
New Mexico,La Cueva,142,10,83,49,0,0,142
New Mexico,La Hacienda,487,218,168,0,0,16,402
New Mexico,La Huerta,1497,234,757,88,23,58,1160
New Mexico,La Joya,12,8,0,4,0,0,12
New Mexico,Lake Roberts,37,0,25,0,0,0,25
New Mexico,Lake Roberts Heights,51,0,26,25,0,0,51
New Mexico,Lake Valley,92,69,7,8,0,1,85
New Mexico,La Madera,22,0,0,22,0,0,22
New Mexico,Alamogordo,31230,7627,11674,3885,350,1906,25442
New Mexico,Holloman AFB,3955,753,1656,107,6,0,2522
New Mexico,Mescalero,1361,592,292,162,18,49,1113
New Mexico,Chama village,995,431,250,66,3,67,817
New Mexico,Meadow Lake,4253,1340,1389,268,133,135,3265
New Mexico,Taos Pueblo,1518,654,462,150,17,64,1347
New Mexico,Indian Hills,1105,152,432,222,21,84,911
New Mexico,Roswell,48186,12341,16568,5107,852,2728,37596
New Mexico,Hot Springs Landing,67,0,67,0,0,0,67
New Mexico,Hillsboro,121,0,52,20,14,19,105
New Mexico,Ensenada,28,0,0,0,0,28,28
New Mexico,Escondida,31,0,31,0,0,0,31
New Mexico,Escudilla Bonita,75,0,57,18,0,0,75
New Mexico,Fairacres,1309,455,488,54,126,30,1153
New Mexico,Faywood,44,19,16,0,0,9,44
New Mexico,Fence Lake,93,53,0,10,0,23,86
New Mexico,Garfield,0,0,0,0,0,0,0
New Mexico,Gila,344,33,197,8,0,0,238
New Mexico,Glen Acres,171,22,105,0,0,18,145
New Mexico,Glenwood,38,0,29,0,0,9,38
New Mexico,Golden,21,0,14,0,0,0,14
New Mexico,Hernandez,652,201,226,36,11,30,504
New Mexico,Hachita,34,0,27,0,0,7,34
New Mexico,Hanover,211,13,112,10,0,0,135
New Mexico,Happy Valley,752,218,176,151,24,23,592
New Mexico,Highland Meadows,534,196,204,13,4,29,446
New Mexico,High Rolls,767,161,293,95,10,40,599
New Mexico,Homestead,33,0,33,0,0,0,33
New Mexico,Truchas,229,37,29,52,66,11,195
New Mexico,Hatch village,1489,352,628,91,13,33,1117
New Mexico,Tome,2172,494,768,148,80,254,1744
New Mexico,Chilili,63,0,28,35,0,0,63
New Mexico,Texico,1229,350,417,60,5,29,861
New Mexico,Melrose village,595,68,302,68,4,39,481
New Mexico,Grady village,134,16,71,17,0,3,107
New Mexico,Magdalena village,599,158,173,63,0,42,436
New Mexico,Santa Fe,83847,24623,28640,12392,1065,3810,70530
New Mexico,La Puebla,1005,127,618,35,0,14,794
New Mexico,Pueblitos,370,61,127,44,14,91,337
New Mexico,Pueblito,167,93,32,2,0,20,147
New Mexico,Ponderosa Pine,1057,259,560,140,0,35,994
New Mexico,Polvadera,225,67,101,8,0,49,225
New Mexico,Pleasanton,193,9,117,42,0,6,174
New Mexico,Playas,44,44,0,0,0,0,44
New Mexico,Placitas CDP (Sandoval County),4441,551,2799,573,27,276,4226
New Mexico,Placitas CDP (Doña Ana County),591,188,125,24,27,37,401
New Mexico,Pinos Altos,365,121,62,91,0,8,282
New Mexico,Pinon,0,0,0,0,0,0,0
New Mexico,Ranchos de Taos,2460,676,721,255,127,310,2089
New Mexico,Santa Rosa,3426,1247,750,518,90,241,2846
New Mexico,Mesita,857,290,234,97,19,43,683
New Mexico,North Acomita Village,192,32,76,25,5,18,156
New Mexico,Mesilla,2138,665,793,196,21,129,1804
New Mexico,Hobbs,38052,9772,13170,2950,602,1485,27979
New Mexico,Crystal,357,127,80,24,2,36,269
New Mexico,Elida,209,58,71,12,5,21,167
New Mexico,Santo Domingo Pueblo,2379,1343,327,40,8,83,1801
New Mexico,Clayton,3104,993,884,452,108,174,2611
New Mexico,Chupadero,248,56,120,33,0,0,209
New Mexico,Eldorado at Santa Fe,5999,632,3719,870,42,307,5570
New Mexico,Pecan Park,0,0,0,0,0,0,0
New Mexico,Pie Town,93,0,37,22,6,0,65
New Mexico,Ponderosa,288,124,91,32,0,14,261
New Mexico,Sheep Springs,268,109,75,10,14,7,215
New Mexico,Cedar Grove,603,65,354,27,18,83,547
New Mexico,Cuyamungue,476,87,229,33,4,24,377
New Mexico,Edgewood,6067,1020,3004,484,49,283,4840
New Mexico,El Rancho,1088,262,424,125,16,59,886
New Mexico,Madrid,201,54,32,79,8,7,180
New Mexico,Puerto de Luna,57,0,57,0,0,0,57
New Mexico,Pulpotio Bareas,283,168,0,53,0,22,243
New Mexico,Quemado,69,0,69,0,0,0,69
New Mexico,Loving village,1212,315,518,98,11,58,1000
New Mexico,Rancho Grande,52,0,52,0,0,0,52
New Mexico,Rivers,0,0,0,0,0,0,0
New Mexico,Rodeo,68,7,56,5,0,0,68
New Mexico,Rodey,359,57,125,0,35,0,217
New Mexico,Rosedale,313,54,33,174,0,52,313
New Mexico,Rowe,150,0,26,93,17,0,136
New Mexico,Sacramento,118,24,65,4,0,0,93
New Mexico,Ribera,307,120,104,50,6,0,280
New Mexico,Casa Colorada,69,0,29,16,0,4,49
New Mexico,Carlsbad,28838,6527,10569,3515,480,1458,22549
New Mexico,Paraje,831,328,151,137,20,87,723
New Mexico,El Valle de Arroyo Seco,1721,433,585,183,0,0,1201
New Mexico,Reserve village,669,164,266,49,32,50,561
New Mexico,Sanostee,434,185,96,16,3,36,336
New Mexico,North Valley,12242,3812,4498,1360,152,922,10744
New Mexico,Fort Sumner village,1228,429,283,98,55,153,1018
New Mexico,Lake Sumner,154,32,80,5,0,8,125
New Mexico,Seama,336,101,126,42,9,11,289
New Mexico,Maxwell village,259,36,110,24,4,9,183
New Mexico,Pinehill,62,29,6,10,3,4,52
New Mexico,University Park,3121,2626,266,66,10,10,2978
New Mexico,Sunland Park,16602,3970,6020,775,572,618,11955
New Mexico,Clovis,39239,10803,13115,4413,540,1664,30535
New Mexico,Angel Fire village,732,141,414,83,5,12,655
New Mexico,Encinal,203,79,57,36,0,9,181
New Mexico,Milan village,3636,1029,1362,384,11,191,2977
New Mexico,San Acacia,83,0,20,63,0,0,83
New Mexico,Thoreau,1666,579,321,143,40,102,1185
New Mexico,Zuni Pueblo,7590,2661,1801,464,402,582,5910
New Mexico,San Felipe Pueblo,2194,979,393,97,18,99,1586
New Mexico,Regina,57,0,25,14,0,8,47
New Mexico,Pueblo of Sandia Village,377,107,101,50,2,20,280
New Mexico,Jemez Pueblo,2031,836,467,81,14,107,1505
New Mexico,Cuba village,756,171,267,70,18,46,572
New Mexico,Eunice,3059,634,1044,334,17,151,2180
New Mexico,Carrizozo,947,258,243,169,32,78,780
New Mexico,Twin Lakes,1008,478,224,63,0,42,807
New Mexico,Ramah,359,51,164,52,3,7,277
New Mexico,San Jon village,235,53,98,8,0,13,172
New Mexico,Timberon,301,24,157,48,0,72,301
New Mexico,Columbus village,1165,254,467,134,32,92,979
New Mexico,Bayard,2419,669,717,163,21,233,1803
New Mexico,Truth or Consequences,5968,1555,1613,1245,74,644,5131
New Mexico,Corrales village,8544,1339,4515,1224,51,345,7474
New Mexico,Algodones,826,220,361,68,0,48,697
New Mexico,Encino village,54,10,14,25,0,5,54
New Mexico,Red River,418,167,119,25,11,31,353
New Mexico,Taos,6021,1981,1540,1246,103,268,5138
New Mexico,Santa Clara village,1783,447,494,211,21,246,1419
New Mexico,Lake Arthur,380,118,110,36,18,21,303
New Mexico,Boles Acres,1899,314,988,245,39,31,1617
New Mexico,House village,33,4,18,8,0,0,30
New Mexico,Torreon CDP (Sandoval County),215,104,38,14,0,22,178
New Mexico,Cundiyo,35,6,17,12,0,0,35
New Mexico,South Valley,41011,12050,14144,4230,859,2422,33705
New Mexico,Aztec,6567,1589,2174,757,121,413,5054
New Mexico,Beclabito,303,98,104,23,8,17,250
New Mexico,Newcomb,368,119,135,26,3,12,295
New Mexico,Cochiti,471,189,123,16,12,11,351
New Mexico,Upper Fruitland,1672,675,499,83,12,76,1345
New Mexico,Glorieta,543,152,251,66,0,8,477
New Mexico,Manzano,0,0,0,0,0,0,0
New Mexico,Tajique,263,56,51,19,0,0,126
New Mexico,Des Moines village,98,5,48,6,3,0,62
New Mexico,Radium Springs,1731,453,891,119,0,26,1489
New Mexico,Capitan village,1441,384,490,185,5,124,1188
New Mexico,Sombrillo,232,57,154,5,5,3,224
New Mexico,Eagle Nest village,263,50,131,47,5,2,235
New Mexico,La Cienega,3526,944,1384,364,63,93,2848
New Mexico,Rock Springs,410,139,121,5,6,11,282
New Mexico,Cimarron village,983,191,395,123,0,81,790
New Mexico,Yah-ta-hey,648,269,155,54,0,28,506
New Mexico,Acomita Lake,517,202,164,33,0,5,404
New Mexico,Jal,2032,399,806,189,35,139,1568
New Mexico,Brimhall Nizhoni,383,178,105,16,6,23,328
New Mexico,Moriarty,2223,447,750,251,23,145,1616
New Mexico,Rio en Medio,205,124,51,0,0,7,182
New Mexico,Nenahnezad,671,201,220,25,8,26,480
New Mexico,White Sands,1137,264,518,44,0,18,844
New Mexico,Trout Valley,0,0,0,0,0,0,0
New Mexico,Santa Cruz,261,86,67,37,3,9,202
New Mexico,White Rock,5809,1044,3036,441,0,185,4706
New Mexico,Folsom village,29,11,10,6,0,2,29
New Mexico,Bosque Farms village,3827,679,1784,254,20,332,3069
New Mexico,Jarales,2060,488,759,302,10,112,1671
New Mexico,Cloudcroft village,606,127,275,85,3,68,558
New Mexico,Nakaibito,352,172,70,20,6,26,294
New Mexico,Santa Clara Pueblo,789,300,167,88,7,47,609
New Mexico,Galisteo,275,42,89,54,0,43,228
New Mexico,Deming,14292,3399,4383,1615,473,788,10658
New Mexico,Navajo,1498,546,249,62,11,29,897
New Mexico,Alcalde,198,52,51,15,2,15,135
New Mexico,Pecos village,1594,583,441,234,23,62,1343
New Mexico,Ojo Amarillo,643,251,137,37,8,26,459
New Mexico,Ruidoso village,7757,1359,3720,1043,0,647,6769
New Mexico,Los Lunas village,15428,3283,6136,1810,64,615,11908
New Mexico,La Luz,1472,240,523,359,71,89,1282
New Mexico,San Antonio,11,0,0,0,0,11,11
New Mexico,Pueblo Pintado,404,148,87,31,9,6,281
New Mexico,Sena,151,96,0,55,0,0,151
New Mexico,San Fidel,439,50,167,57,0,0,274
New Mexico,San Jose CDP (Rio Arriba County),632,201,216,40,2,58,517
New Mexico,San Jose CDP (San Miguel County),217,0,183,0,0,0,183
New Mexico,San Lorenzo,148,0,113,8,0,27,148
New Mexico,San Luis,204,45,32,70,0,7,154
New Mexico,San Mateo,341,46,203,0,0,27,276
New Mexico,San Miguel,1054,282,365,127,36,98,908
New Mexico,San Pablo,1046,323,434,62,0,19,838
New Mexico,San Pedro,93,0,46,26,7,14,93
New Mexico,San Rafael,1251,419,359,42,70,103,993
New Mexico,San Ysidro,2091,449,1109,61,21,47,1687
New Mexico,Sausal,1944,332,501,412,21,74,1340
New Mexico,Seboyeta,157,76,43,0,0,38,157
New Mexico,Sedillo,911,65,607,101,0,49,822
New Mexico,San Antonito CDP (Socorro County),11,11,0,0,0,0,11
New Mexico,Soham,80,0,0,80,0,0,80
New Mexico,South Acomita Village,47,24,11,6,0,6,47
New Mexico,Spencerville,1746,564,554,217,13,78,1426
New Mexico,Sunshine,203,25,56,30,23,29,163
New Mexico,Talpa,636,159,243,103,0,92,597
New Mexico,Tecolote,205,17,97,0,0,57,171
New Mexico,Tecolotito,233,63,72,0,0,0,135
New Mexico,Tesuque Pueblo,260,100,63,19,11,17,210
New Mexico,Tierra Amarilla,653,330,173,90,0,17,610
New Mexico,San Cristobal,259,50,88,121,0,0,259
New Mexico,Sandia Park,141,31,94,8,8,0,141
New Mexico,Sandia Knolls,1566,287,715,209,11,108,1330
New Mexico,San Antonito CDP (Bernalillo County),1179,116,605,120,0,31,872
New Mexico,Sandia Heights,3366,380,2295,273,34,152,3134
New York,Middletown,27644,8949,9590,1485,567,1328,21919
New York,New Windsor,9185,2965,3478,713,228,399,7783
New York,Walden village,6726,2152,2142,447,210,306,5257
New York,West Point,6670,3501,1523,112,6,0,5142
New York,Chester village,3981,1270,1346,522,85,281,3504
New York,Fishkill village,1957,471,738,231,88,141,1669
New York,Myers Corner,6620,1109,3717,361,38,214,5439
New York,Pine Plains,1347,364,512,98,31,128,1133
New York,Arlington,3556,1840,636,246,158,97,2977
New York,Philmont village,1165,302,353,157,55,71,938
New York,Brighton,36447,11284,14527,2849,332,2317,31309
New York,Rochester,207778,95078,39208,18324,6436,8655,167701
New York,Stony Point,12869,3601,5843,595,198,652,10889
New York,Greenwood Lake village,3094,540,1393,470,0,116,2519
New York,Mechanicstown,6957,1865,2609,665,154,554,5847
New York,Canton village,6501,4136,1241,332,22,262,5993
New York,Bardonia,3839,879,1793,348,8,236,3264
New York,Piermont village,2543,770,1111,309,36,61,2287
New York,Sloatsburg village,3111,860,1327,236,41,136,2600
New York,Massena village,10090,2616,3593,1115,178,689,8191
New York,Potsdam village,9281,6522,1412,380,105,249,8668
New York,Unadilla village,1074,227,378,128,44,71,848
New York,Highland,5620,1497,2124,607,110,315,4653
New York,Lincoln Park,2147,552,699,244,54,252,1801
New York,Marlboro,3565,829,1450,490,116,175,3060
New York,New Paltz village,7175,5241,943,306,66,260,6816
New York,Pine Hill,166,16,71,48,10,11,156
New York,Angelica village,759,167,343,52,18,49,629
New York,West Haverstraw village,10253,2855,3772,690,223,377,7917
New York,Upper Nyack village,2174,558,1019,126,18,104,1825
New York,Florida village,2836,587,1282,168,50,156,2243
New York,Phoenix village,2440,796,715,240,53,136,1940
New York,Oriskany Falls village,818,188,265,98,15,66,632
New York,Holland Patent village,338,83,146,58,4,26,317
New York,Clark Mills,1588,365,646,198,0,119,1328
New York,Woodsburgh village,755,107,439,20,7,25,598
New York,Westbury village,15320,4462,6508,845,160,862,12837
New York,South Floral Park village,1986,621,744,197,7,59,1628
New York,Plandome Manor village,785,128,407,27,4,44,610
New York,Woodmere,17467,3049,8196,456,87,759,12547
New York,Turin village,265,49,108,15,4,1,177
New York,Silver Creek village,2360,521,950,215,54,148,1888
New York,Jamestown,29799,8943,8911,3654,729,1743,23980
New York,Falconer village,2391,664,801,306,80,165,2016
New York,Phelps village,1737,449,617,178,61,126,1431
New York,Sandy Creek village,789,104,334,76,30,36,580
New York,Bloomfield village,1467,317,724,116,30,47,1234
New York,Hoosick Falls village,3411,1012,1128,324,195,225,2884
New York,Albany,97889,48434,21214,7137,1830,4489,83104
New York,Walton village,3160,567,1331,275,148,149,2470
New York,Sidney village,4009,968,1356,422,61,321,3128
New York,Richfield Springs village,1075,249,467,129,31,34,910
New York,Milford village,380,83,169,50,6,17,325
New York,Cherry Valley village,555,88,269,74,3,13,447
New York,Celoron village,953,222,324,204,34,50,834
New York,Tuxedo Park village,591,85,311,54,9,33,492
New York,Massapequa,21861,5272,10534,1061,314,1128,18309
New York,East Meadow,37358,9801,16114,2332,659,2532,31438
New York,Balmville,3093,731,1215,342,51,227,2566
New York,Washingtonville village,5748,1572,2405,429,91,288,4785
New York,New York,8443713,3020744,2793135,541938,210710,384046,6950573
New York,Middle Island,10216,2620,4064,1024,127,692,8527
New York,Ravena village,3228,1098,1074,318,62,208,2760
New York,Corinth village,2515,544,1036,249,76,129,2034
New York,Clayville village,247,40,115,26,2,14,197
New York,South Dayton village,673,194,224,66,15,39,538
New York,Cattaraugus village,959,255,341,110,18,56,780
New York,Wainscott,321,71,154,30,2,22,279
New York,Setauket-East Setauket,13442,2829,6496,1015,122,634,11096
New York,Old Field village,812,144,466,32,4,29,675
New York,Northwest Harbor,3503,618,2190,212,49,145,3214
New York,Northville,1455,133,978,0,39,78,1228
New York,Lloyd Harbor village,3676,685,2073,117,12,122,3009
New York,Huntington Station,33259,9071,12733,2048,645,1297,25794
New York,Huntington,17341,4249,8049,1402,248,953,14901
New York,Clifton Springs village,2359,518,838,256,48,292,1952
New York,Fabius village,336,78,149,25,0,13,265
New York,Thomaston village,2624,472,1313,186,26,91,2088
New York,Camillus village,1194,421,361,116,35,88,1021
New York,Sylvan Beach village,832,125,397,81,8,119,730
New York,Sherrill,3031,615,1406,210,68,245,2544
New York,Remsen village,418,83,165,49,10,40,347
New York,Rockville Centre village,24442,6159,10685,1463,246,1372,19925
New York,Plainedge,9206,2165,4393,461,52,468,7539
New York,Oyster Bay,6176,1303,2529,504,113,639,5088
New York,Old Brookville village,1695,400,842,55,13,93,1403
New York,North Valley Stream,19202,6170,7318,1319,420,1107,16334
New York,Manhasset,8138,1936,3718,458,46,459,6617
New York,Lynbrook village,19552,4887,8940,1102,257,1195,16381
New York,Locust Valley,3173,950,1271,180,57,155,2613
New York,Levittown,51539,13349,23097,3073,814,2808,43141
New York,Hicksville,42649,11111,20833,1823,429,2114,36310
New York,Yorkville village,2607,915,736,258,17,79,2005
New York,Deposit village,1685,399,703,148,27,113,1390
New York,Searingtown,4547,933,2557,141,17,210,3858
New York,Port Washington North village,3209,685,1598,153,9,210,2655
New York,North Ballston Spa,1539,478,603,178,17,73,1349
New York,East Greenbush,4611,979,2433,289,19,243,3963
New York,Thornwood,4103,930,1988,268,24,141,3351
New York,White Plains,58040,17827,23009,3995,1362,2848,49041
New York,Antwerp village,543,124,221,63,4,18,430
New York,Southampton village,3263,775,1480,397,35,220,2907
New York,Olean,13805,4020,4691,1724,313,795,11543
New York,Yorkshire,1191,269,506,169,9,125,1078
New York,Schuylerville village,1552,418,491,147,35,86,1177
New York,Glens Falls,14359,4530,4642,1886,249,651,11958
New York,Cortland West,1245,112,662,119,0,121,1014
New York,Hamburg village,9618,1813,4287,1000,84,479,7663
New York,Harris Hill,5737,1327,2740,340,8,304,4719
New York,Roslyn Harbor village,936,204,488,54,0,33,779
New York,Lake Erie Beach,3740,1035,1636,362,46,194,3273
New York,Cayuga Heights village,3722,1396,1710,122,0,205,3433
New York,Westvale,4964,1209,2014,454,40,313,4030
New York,Attica village,3190,751,1223,318,65,114,2471
New York,Gainesville village,232,54,106,27,1,9,197
New York,Amsterdam,17927,5852,5047,1820,434,1163,14316
New York,Ames village,132,31,70,15,0,4,120
New York,Morrisonville,1386,272,742,76,7,70,1167
New York,Fultonville village,595,167,157,63,34,44,465
New York,Duanesburg,435,29,352,0,0,0,381
New York,Fair Haven village,882,219,370,142,18,49,798
New York,Rouses Point village,2185,567,877,191,56,171,1862
New York,Cohoes,16599,5710,5158,1705,231,1202,14006
New York,Plainview,25902,4492,13902,796,206,1546,20942
New York,Lancaster village,10152,2952,3632,1090,90,464,8228
New York,Harbor Isle,1163,224,548,67,0,71,910
New York,Saddle Rock village,758,141,398,39,3,33,614
New York,Greenvale,1705,624,704,65,19,31,1443
New York,Sparkill,1785,470,768,84,0,68,1390
New York,South Lima,239,54,154,0,0,8,216
New York,Smithville Flats,365,70,156,35,10,23,294
New York,Scottsburg,99,25,56,4,0,5,90
New York,Scio,595,97,293,31,23,47,491
New York,Schroon Lake,699,133,303,38,0,78,552
New York,Savannah,596,161,213,53,18,38,483
New York,Sanborn,1132,297,428,168,0,69,962
New York,Salt Point,147,73,34,0,0,35,142
New York,Salisbury Mills,305,84,126,10,0,10,230
New York,St. Regis Falls,452,127,143,43,5,39,357
New York,Rushford,462,109,99,104,28,26,366
New York,Rosendale Hamlet,1078,297,445,213,0,0,955
New York,Romulus,410,110,172,23,0,15,320
New York,Rodman,182,14,123,6,3,0,146
New York,Springwater Hamlet,414,114,119,76,28,19,356
New York,Stony Brook University,8938,8369,320,33,0,208,8930
New York,Strykersville,681,115,347,48,0,35,545
New York,Sunset Bay,635,201,231,84,2,41,559
New York,Williamson,2561,583,794,468,72,120,2037
New York,West Valley,547,128,259,26,6,9,428
New York,West Chazy,489,145,218,27,0,7,397
New York,Websters Crossing,34,6,28,0,0,0,34
New York,Water Mill,1906,383,930,128,90,172,1703
New York,Watchtower,2147,771,1343,0,11,11,2136
New York,Washington Mills,1603,553,591,140,64,66,1414
New York,Rhinecliff,454,102,187,17,0,6,312
New York,Wanakah,2904,483,1486,238,12,256,2475
New York,Verona,952,152,435,78,0,32,697
New York,University at Buffalo,6173,6036,74,10,0,0,6120
New York,Tuscarora,69,15,54,0,0,0,69
New York,Titusville,562,80,351,41,10,68,550
New York,Three Mile Bay,215,0,108,16,0,27,151
New York,Thousand Island Park,64,0,50,0,5,9,64
New York,SUNY Oswego,3746,3733,13,0,0,0,3746
New York,Wadsworth,341,68,134,16,0,42,260
New York,Willsboro,861,221,323,113,0,41,698
New York,Retsof,171,29,69,9,0,24,131
New York,Prattsville,199,45,114,12,0,25,196
New York,Montrose,3187,769,1394,329,58,112,2662
New York,Mineville,1335,504,359,218,43,81,1205
New York,Merritt Park,1776,281,834,121,9,73,1318
New York,Marion,1373,276,594,213,35,75,1193
New York,Malden-on-Hudson,291,45,138,19,0,45,247
New York,Madrid,680,202,268,49,18,33,570
New York,Machias,432,114,158,23,0,7,302
New York,Lorraine,107,37,52,15,0,3,107
New York,Long Lake,379,125,177,16,5,16,339
New York,Livonia Center,330,93,193,0,29,15,330
New York,Linwood,85,6,38,41,0,0,85
New York,Lime Lake,845,171,334,83,0,86,674
New York,Lakeville,1002,242,455,102,0,15,814
New York,Kysorville,189,21,103,0,3,0,127
New York,Keuka Park,975,811,135,7,0,0,953
New York,Mountain Lodge Park,1914,883,563,132,0,141,1719
New York,North Creek,592,149,308,39,0,58,554
New York,North Gates,9353,2601,3563,909,282,701,8056
New York,North Rose,425,104,92,102,10,61,369
New York,Prattsburgh,937,151,380,64,18,22,635
New York,Pottersville,294,165,70,16,3,0,254
New York,Port Gibson,373,81,115,47,0,69,312
New York,Plessis,175,79,47,27,0,0,153
New York,Pine Valley,748,281,293,89,11,0,674
New York,Pike,240,62,106,17,0,16,201
New York,Piffard,284,62,64,76,0,23,225
New York,Pultneyville,660,186,322,38,8,31,585
New York,Pierrepont Manor,204,32,59,0,24,0,115
New York,Paul Smiths,632,632,0,0,0,0,632
New York,Pamelia Center,372,48,219,31,0,41,339
New York,Oxbow,109,13,60,1,0,3,77
New York,Ontario,1817,557,672,209,15,201,1654
New York,Parishville,674,99,231,96,49,29,504
New York,Old Forge,454,114,190,48,19,65,436
New York,Oak Beach-Captree,39,0,16,23,0,0,39
New York,Pavilion,614,143,261,54,23,29,510
New York,Wilmington,819,163,427,60,8,63,721
New York,Winthrop,149,28,43,17,16,0,104
New York,York Hamlet,399,85,245,52,0,0,382
New York,Oakdale,7231,1802,3229,671,128,453,6283
New York,Montauk,3655,736,2161,87,0,240,3224
New York,Melville,17872,3369,9169,992,232,1474,15236
New York,Orient,782,122,500,65,5,26,718
New York,Mattituck,4704,1161,2419,397,23,335,4335
New York,Lindenhurst village,27053,7310,12038,1891,399,1317,22955
New York,Hauppauge,19580,4569,9533,1101,184,1114,16501
New York,Great River,1373,333,640,45,13,77,1108
New York,West Glens Falls,7005,1863,2569,673,111,474,5690
New York,Stillwater village,1954,479,875,138,23,83,1598
New York,Fort Edward village,3307,896,1117,304,163,106,2586
New York,Flanders,4787,1263,1760,107,45,151,3326
New York,Shinnecock Hills,2502,896,978,335,16,148,2373
New York,South Huntington,10000,2525,4576,572,166,604,8443
New York,Riverhead,14067,4405,4940,1413,278,1017,12053
New York,Quogue village,803,108,442,84,0,36,670
New York,Ridge,13511,2531,6022,1323,172,1333,11381
New York,Ronkonkoma,18302,5135,7664,1290,199,864,15152
New York,Bedford,2074,421,1030,115,0,107,1673
New York,Sharon Springs village,539,129,174,87,3,59,452
New York,Sherman village,752,155,289,49,15,55,563
New York,Farnham village,474,172,176,42,0,6,396
New York,Sherburne village,1414,351,477,263,36,89,1216
New York,Town Line,1764,337,847,77,12,168,1441
New York,Medford,24247,7867,9370,1457,368,1372,20434
New York,Bohemia,9293,2667,3792,904,120,379,7862
New York,North Lindenhurst,10584,3000,3919,890,275,694,8778
New York,Holley village,1743,510,556,235,66,69,1436
New York,Milton CDP (Ulster County),1371,440,528,90,25,74,1157
New York,Lake Mohegan,6013,1621,2459,505,140,288,5013
New York,Jefferson Valley-Yorktown,14441,2624,7284,758,85,958,11709
New York,Harrison village,27956,9205,10859,1541,250,1275,23130
New York,Greenville CDP (Greene County),597,147,227,68,0,69,511
New York,Catskill village,3861,2072,779,422,51,162,3486
New York,Spencer village,782,144,305,128,6,45,628
New York,Greenwich village,1962,468,775,139,37,69,1488
New York,Margaretville village,543,101,207,69,11,103,491
New York,Hancock village,1070,288,358,124,65,90,925
New York,Franklin village,399,113,156,48,11,14,342
New York,Lake Luzerne,977,235,401,123,0,46,805
New York,Beaver Dam Lake,1654,491,880,53,32,51,1507
New York,Port Henry,1114,242,503,140,17,81,983
New York,Macedon,1984,324,1015,129,40,189,1697
New York,Herrings,112,17,69,10,0,7,103
New York,Hermon,403,114,99,64,9,37,323
New York,Barneveld,319,85,125,25,1,33,269
New York,Limestone,492,102,185,34,3,23,347
New York,Salem,690,143,306,49,4,72,574
New York,Forestville,828,239,242,129,15,22,647
New York,Prospect,319,55,113,42,2,27,239
New York,Lyons,3414,1071,1155,317,85,222,2850
New York,Altmar,442,134,78,69,15,13,309
New York,Worcester,949,199,389,91,19,72,770
New York,Woodsville,105,30,48,6,0,0,84
New York,Witherbee,267,39,111,54,0,12,216
New York,Keeseville,2971,757,1179,335,87,116,2474
New York,Island Park village,4807,1745,1626,375,66,292,4104
New York,Loch Sheldrake,1236,594,293,87,58,31,1063
New York,Quiogue,844,304,347,55,0,53,759
New York,Round Lake village,736,167,313,107,15,34,636
New York,Yonkers,199745,64949,69452,14864,4972,10393,164630
New York,Shrub Oak,2452,440,1352,109,61,97,2059
New York,Bridgewater,529,128,207,22,4,18,379
New York,Wells,654,291,111,25,5,97,529
New York,Virgil,495,66,224,25,0,5,320
New York,Thendara,66,49,0,0,0,17,66
New York,Niskayuna,4882,1051,2215,264,10,163,3703
New York,Taconic Shores,627,105,269,65,13,43,495
New York,Edwards,448,158,145,9,9,30,351
New York,Copake Hamlet,221,40,163,7,0,11,221
New York,Copake Falls,303,118,39,42,0,48,247
New York,Seneca Falls,6032,1553,2479,611,66,364,5073
New York,Perrysburg,395,131,154,17,6,23,331
New York,East Randolph,519,130,135,66,17,23,371
New York,Mastic Beach village,11953,4207,4156,904,256,622,10145
New York,Randolph,1189,231,454,131,51,90,957
New York,Lyndonville village,724,150,272,104,3,23,552
New York,Heritage Hills,4176,416,2321,530,42,719,4028
New York,Laurel,1080,237,411,55,150,0,853
New York,North Boston,2835,606,1484,202,15,139,2446
New York,Dunkirk,11950,3682,3896,1408,300,550,9836
New York,Panama village,412,81,168,38,15,26,328
New York,Croghan village,621,113,292,24,13,57,499
New York,Lowville village,3225,1025,1002,405,19,205,2656
New York,Montour Falls village,1774,382,478,340,41,171,1412
New York,Lodi village,351,91,144,37,17,15,304
New York,Waterloo village,4959,1293,1911,545,84,265,4098
New York,Alfred village,4317,3960,253,11,5,24,4253
New York,Canaseraga village,524,91,231,59,5,19,405
New York,Houghton,1761,982,450,29,4,63,1528
New York,Islandia village,3345,999,1186,295,66,218,2764
New York,East Hampton village,1034,172,525,98,15,119,929
New York,Dering Harbor village,0,0,0,0,0,0,0
New York,Commack,36936,8204,18188,1892,190,2275,30749
New York,Gowanda village,2820,969,766,305,60,211,2311
New York,Clarence Center,3125,513,1620,76,66,102,2377
New York,Angola village,2199,698,666,249,46,102,1761
New York,Voorheesville village,2806,632,1321,238,28,117,2336
New York,Coxsackie village,2685,798,884,288,19,235,2224
New York,Hunter village,478,153,111,81,0,114,459
New York,Glasco,2615,734,964,218,32,141,2089
New York,Kingston,23210,7279,7194,2502,630,1313,18918
New York,Plattekill,969,438,290,51,18,9,806
New York,Tillson,1653,472,681,110,45,80,1388
New York,Saranac Lake village,5552,1742,2086,436,96,271,4631
New York,Calverton,7154,1550,2931,947,106,817,6351
New York,Albion village,5439,1437,2092,472,161,334,4496
New York,Baywood,7389,2295,2671,545,122,367,6000
New York,Brightwaters village,3069,620,1517,173,44,185,2539
New York,Brookhaven,3531,902,1415,309,23,205,2854
New York,East Patchogue,22637,6145,8937,1861,395,1576,18914
New York,Westmere,7001,2141,2705,604,110,404,5964
New York,Melrose Park,2330,450,1195,148,24,78,1895
New York,Meridian village,327,76,126,19,0,8,229
New York,Medina village,5839,1413,2357,667,46,399,4882
New York,Fairview CDP (Westchester County),3194,1185,886,244,50,103,2468
New York,Bay Shore,30685,9058,10271,2512,795,1136,23772
New York,Granville village,2450,577,805,419,54,190,2045
New York,Nelsonville village,699,150,307,32,4,36,529
New York,Cheektowaga,74026,23311,27505,7078,825,4846,63565
New York,Sackets Harbor village,1654,390,743,133,30,66,1362
New York,Redwood,624,190,226,11,49,59,535
New York,Delhi village,3178,1996,571,235,36,111,2949
New York,High Falls,664,228,249,31,58,8,574
New York,Carthage village,3473,814,1126,388,168,162,2658
New York,Black River village,1210,240,571,84,34,61,990
New York,Ellicottville village,283,100,129,12,2,15,258
New York,Cragsmoor,359,87,165,48,8,10,318
New York,Stony Brook,12641,2499,5990,803,164,816,10272
New York,Shelter Island Heights,1049,246,441,118,0,51,856
New York,Rocky Point,12902,3210,5529,1096,125,441,10401
New York,Poquott village,992,230,501,76,0,30,837
New York,Salamanca,5553,1579,1457,609,110,320,4075
New York,Rye Brook village,9459,1917,4788,601,16,449,7771
New York,Tuckahoe village,6587,1947,2384,660,162,315,5468
New York,Elma Center,3043,482,1604,167,0,262,2515
New York,Middleport village,1783,437,629,198,63,96,1423
New York,Copake Lake,580,115,319,57,19,0,510
New York,Newport village,531,127,155,106,13,36,437
New York,Little Falls,4735,1455,1381,541,123,431,3931
New York,Warrensburg,3193,788,1153,325,160,233,2659
New York,Skaneateles village,2411,301,1232,237,25,155,1950
New York,Lakeland,2517,544,1254,273,36,139,2246
New York,Shortsville village,1275,283,569,115,27,93,1087
New York,Victory village,604,187,229,58,9,9,492
New York,Preston-Potter Hollow,289,83,146,25,0,9,263
New York,Hillcrest,7418,2476,2655,419,116,374,6040
New York,Peekskill,24008,7299,7883,2347,335,1307,19171
New York,Mount Vernon,68035,24710,18745,5923,2201,3790,55369
New York,Mamaroneck village,19213,4866,8059,1498,292,967,15682
New York,Carmel Hamlet,6345,1336,3009,353,99,522,5319
New York,North Hornell village,768,117,306,66,8,187,684
New York,Avoca village,960,219,398,109,16,48,790
New York,Mount Ivy,6925,1490,2927,793,23,284,5517
New York,Westhampton Beach village,1653,400,731,157,11,147,1446
New York,Leeds,433,151,108,11,0,30,300
New York,Dansville village,4572,1428,1497,505,149,311,3890
New York,Garden City South,4322,1098,2155,198,15,233,3699
New York,East Massapequa,18331,4418,8166,1203,272,1164,15223
New York,Cedarhurst village,6661,1718,2891,210,31,166,5016
New York,Baldwin,25134,7054,10330,1525,537,1029,20475
New York,Atlantic Beach village,1398,296,801,78,6,67,1248
New York,Pleasantville village,7214,1864,3119,456,56,286,5781
New York,Larchmont village,6092,975,2942,220,18,165,4320
New York,Chittenango village,4920,1157,1995,496,75,205,3928
New York,Centre Island village,472,105,245,29,2,29,410
New York,Mount Kisco village,10894,2848,4967,661,161,491,9128
New York,Bronxville village,6394,1477,2804,237,24,338,4880
New York,Briarcliff Manor village,7697,1556,4009,344,62,385,6356
New York,Oakfield village,1749,438,659,178,23,96,1394
New York,Tannersville village,992,396,324,15,0,75,810
New York,Glens Falls North,8807,2060,3441,1059,91,676,7327
New York,Great Neck village,10203,2071,4674,328,36,354,7463
New York,Kings Point village,5187,1449,2493,79,7,89,4117
New York,Lido Beach,3009,509,1704,143,48,179,2583
New York,Matinecock village,897,209,416,39,0,31,695
New York,North Babylon,16739,4334,7022,1469,214,823,13862
New York,North Bellport,11593,4119,3481,757,380,337,9074
New York,Ocean Beach village,24,14,5,3,0,2,24
New York,Endicott village,12872,4149,4082,1543,325,707,10806
New York,Endwell,11641,2768,5286,1166,80,517,9817
New York,Brewster Hill,1945,345,846,211,46,177,1625
New York,Wyoming village,383,100,165,35,4,12,316
New York,East Marion,954,161,493,87,0,107,848
New York,Seaford,15113,3668,7214,894,146,538,12460
New York,Nelliston village,565,126,227,37,25,52,467
New York,Mannsville village,351,80,138,39,1,10,268
New York,Menands village,3946,1106,1498,389,135,61,3189
New York,East Nassau village,602,142,255,48,22,14,481
New York,North Merrick,12232,2832,6073,413,61,468,9847
New York,Munsey Park village,2719,429,1462,47,0,50,1988
New York,Mill Neck village,1011,204,578,38,5,47,872
New York,Firthcliffe,5178,1244,1952,550,71,372,4189
New York,Nunda village,1231,283,433,151,13,97,977
New York,East Farmingdale,6143,2023,2172,415,32,249,4891
New York,Freeport village,43128,15011,13883,3106,1014,2439,35453
New York,Roscoe,546,183,193,73,0,39,488
New York,Narrowsburg,338,77,170,52,0,15,314
New York,Central Square village,1855,440,716,215,48,152,1571
New York,Johnstown,8307,1938,3394,840,207,370,6749
New York,Tarrytown village,11459,3420,4626,1044,83,505,9678
New York,Scotts Corners,704,149,447,37,0,26,659
New York,Rye,15862,2795,7537,804,224,651,12011
New York,Amenia,1107,211,511,47,76,44,889
New York,Brinckerhoff,2430,570,1173,206,39,190,2178
New York,Dover Plains,1016,365,213,189,26,57,850
New York,Lake Grove village,11130,2763,4975,756,117,647,9258
New York,Fairview CDP (Dutchess County),5332,1975,1897,414,77,163,4526
New York,Millerton village,871,285,393,30,18,43,769
New York,Staatsburg,403,98,223,10,22,28,381
New York,Avon village,3261,827,1403,234,68,165,2697
New York,Gardnertown,5200,1456,1848,406,143,279,4132
New York,Otisville village,1255,272,538,111,32,24,977
New York,Port Jervis,8614,2529,2876,927,153,652,7137
New York,Manorville,14405,3448,6019,878,159,999,11503
New York,Floral Park village,16209,3756,7853,935,209,661,13414
New York,Mechanicville,5144,1672,1437,647,152,250,4158
New York,Cooperstown village,1886,448,927,160,47,144,1726
New York,Fire Island,249,48,113,13,2,16,192
New York,Shoreham village,437,45,256,22,1,28,352
New York,Shirley,28698,8645,10551,2194,513,1134,23037
New York,Shelter Island,1695,224,932,117,0,64,1337
New York,Garden City village,22533,5332,11096,731,48,929,18136
New York,St. James,13155,3067,5806,856,140,1024,10893
New York,Port Jefferson Station,7808,2159,3580,450,45,345,6579
New York,North Great River,3934,1184,1646,235,36,287,3388
New York,Mount Sinai,11529,2410,5831,508,142,456,9347
New York,Moriches,3277,780,1471,165,222,153,2791
New York,Islip Terrace,5529,1420,2492,270,82,255,4519
New York,Islip,17921,5195,7891,967,195,923,15171
New York,Huntington Bay village,1366,278,752,80,17,72,1199
New York,Remsenburg-Speonk,1974,314,1155,164,0,55,1688
New York,Lattingtown village,1827,339,938,118,11,95,1501
New York,Westhampton,2898,621,1309,236,51,202,2419
New York,Smithtown,26298,6060,12643,1389,231,1657,21980
New York,Malone village,5694,1703,1788,627,165,369,4652
New York,Chateaugay village,729,131,333,50,12,78,604
New York,Lake George village,1034,338,353,159,13,64,927
New York,Hudson Falls village,7133,2008,2448,871,81,356,5764
New York,Cambridge village,1806,416,627,251,35,93,1422
New York,Woodstock,2135,585,753,333,9,132,1812
New York,Waterford village,2091,688,676,266,69,91,1790
New York,West Hurley,1871,331,885,257,0,189,1662
New York,Wallkill,2050,506,833,236,26,94,1695
New York,Stone Ridge,1156,217,486,106,22,74,905
New York,Saugerties South,1825,460,772,137,0,155,1524
New York,Port Ewen,3442,891,1342,411,50,272,2966
New York,Napanoch,1004,177,419,125,20,97,838
New York,Accord,521,96,246,37,30,27,436
New York,Athens village,1559,478,597,167,74,119,1435
New York,Aquebogue,1690,349,959,142,0,39,1489
New York,Bridgehampton,1322,353,540,152,31,61,1137
New York,Little Valley village,1180,371,360,144,24,70,969
New York,Centerport,5251,1008,2611,411,43,311,4384
New York,Allegany village,1922,653,679,144,15,52,1543
New York,Sag Harbor village,2184,603,822,252,17,226,1920
New York,Franklinville village,1575,365,630,125,26,102,1248
New York,Hillside,831,158,446,55,0,85,744
New York,North Collins village,1226,262,474,101,24,68,929
New York,East Atlantic Beach,1971,766,724,60,18,175,1743
New York,Malverne Park Oaks,458,67,271,0,0,14,352
New York,Phoenicia,249,40,84,62,28,35,249
New York,Oceanside,31185,7406,15191,1247,311,1674,25829
New York,Baxter Estates village,1065,260,509,55,4,66,894
New York,Stannards,586,115,292,48,12,49,516
New York,Laurens village,180,29,65,22,2,21,139
New York,Natural Bridge,306,60,154,30,0,27,271
New York,Brownville village,1047,176,524,72,26,52,850
New York,West Babylon,42918,11687,17379,3449,440,2813,35768
New York,Dix Hills,26819,5506,14404,751,196,1082,21939
New York,Angola on the Lake,1819,526,757,152,33,103,1571
New York,Northampton,603,287,221,39,0,0,547
New York,Verplanck,1310,508,430,155,0,55,1148
New York,Unionville village,724,152,222,114,26,53,567
New York,East Rockaway village,9802,2574,4328,548,71,634,8155
New York,Bellmore,15730,3199,8078,723,176,799,12975
New York,Bellerose village,1178,263,579,56,8,50,956
New York,Barnum Island,2247,691,1012,151,70,127,2051
New York,Munsons Corners,2998,1212,831,195,95,207,2540
New York,McGraw village,879,219,418,55,42,43,777
New York,Bay Park,1614,526,613,154,29,86,1408
New York,Village Green,3810,1079,1334,526,51,282,3272
New York,Fairmount,9997,2608,4251,700,184,580,8323
New York,Whitesboro village,3665,1384,790,792,150,177,3293
New York,Vernon village,1138,249,459,146,65,48,967
New York,New Hartford village,1731,411,753,163,23,101,1451
New York,Williamsville village,5247,1663,1931,701,55,311,4661
New York,Northwest Ithaca,1289,318,546,118,18,156,1156
New York,Woodridge village,819,272,194,65,14,35,580
New York,Garden City Park,8081,1646,4151,195,100,574,6666
New York,Canajoharie village,1863,556,640,170,29,108,1503
New York,Duane Lake,260,24,168,0,0,0,192
New York,East Glenville,6371,1510,2751,527,55,476,5319
New York,Newburgh,28282,10102,6542,1727,1028,1116,20515
New York,Montgomery village,4537,1139,1727,439,73,267,3645
New York,Wurtsboro village,1104,317,422,122,25,52,938
New York,Smallwood,615,239,193,125,0,20,577
New York,Monroe village,8578,2099,3617,302,119,369,6506
New York,Liberty village,4136,1321,1126,432,153,262,3294
New York,Minetto,1047,274,423,106,20,82,905
New York,Washington Heights,2337,907,802,142,0,30,1881
New York,Lacona village,741,220,246,78,15,22,581
New York,Highland Falls village,3827,1366,1495,269,56,88,3274
New York,Goshen village,5354,1521,1916,433,61,423,4354
New York,Monticello village,6476,2588,1383,555,102,438,5066
New York,Mexico village,1569,357,590,204,33,58,1242
New York,Cleveland village,679,218,238,67,19,47,589
New York,Northville village,1212,262,405,98,74,50,889
New York,Scotia village,7715,1909,2471,1009,187,358,5934
New York,Maybrook village,3368,1102,1239,347,90,141,2919
New York,Sound Beach,8093,2094,3678,523,41,460,6796
New York,Argyle village,555,148,214,32,4,55,453
New York,Sayville,16007,3648,7258,918,193,1229,13246
New York,Carle Place,4867,1278,2233,340,17,337,4205
New York,Bethpage,17215,3523,8684,845,99,1206,14357
New York,Bayville village,6708,1668,3319,284,130,386,5787
New York,Oxford village,1430,342,498,189,64,96,1189
New York,Rensselaer,9290,3369,2584,751,267,595,7566
New York,Averill Park,1330,276,497,165,61,137,1136
New York,Zena,1119,155,630,78,20,43,926
New York,Shokan,1200,349,625,30,15,89,1108
New York,Hurley,3152,723,1503,262,37,249,2774
New York,Gardiner,698,148,369,43,0,35,595
New York,Ellenville village,4043,1298,1424,208,60,183,3173
New York,Red Oaks Mill,3202,606,1783,149,11,197,2746
New York,Kennedy,363,69,153,55,9,39,325
New York,Pawling village,2085,584,704,270,36,163,1757
New York,Crown Heights,2834,805,1192,178,53,156,2384
New York,Rifton,231,79,83,35,0,13,210
New York,Saugerties village,3872,1155,1154,453,78,357,3197
New York,Walker Valley,1215,207,482,105,0,13,807
New York,Geneva,12888,5740,3206,1037,252,580,10815
New York,Selden,19770,5637,7908,1593,380,998,16516
New York,Riverside,3151,1958,572,194,39,285,3048
New York,Port Jefferson village,7871,1826,3803,589,44,386,6648
New York,North Haven village,919,167,467,81,10,40,765
New York,North Bay Shore,21045,6418,7152,1107,483,679,15839
New York,Mastic,14678,4491,5362,957,237,588,11635
New York,Lake Ronkonkoma,20780,5671,8288,1439,284,1256,16938
New York,Poland village,385,91,138,32,4,23,288
New York,Jamesport,1085,211,644,128,0,67,1050
New York,Cayuga village,489,123,207,50,7,36,423
New York,Aurora village,655,470,141,26,3,6,646
New York,Sloan village,3584,1270,1171,364,100,278,3183
New York,Green Island village,2591,898,772,333,110,118,2231
New York,Wellsville village,4466,1209,1437,655,133,358,3792
New York,Cuba village,1534,352,566,185,37,61,1201
New York,Bolivar village,965,264,294,114,38,76,786
New York,Weedsport village,1846,470,684,213,25,107,1499
New York,Wading River,8034,1846,4043,336,91,198,6514
New York,Palenville,897,191,421,55,12,20,699
New York,Cairo,1015,291,351,123,25,77,867
New York,Ballston Spa village,5443,1303,2240,496,70,404,4513
New York,Fleischmanns village,214,42,77,35,13,8,175
New York,Speculator village,348,53,132,92,2,53,332
New York,West Carthage village,1511,328,540,228,23,114,1233
New York,Hammond village,242,51,91,19,2,24,187
New York,Harrisville village,613,114,206,101,18,47,486
New York,Clinton village,1636,412,683,174,24,73,1366
New York,Alden village,2580,656,998,303,39,192,2188
New York,Sodus Point village,893,166,419,119,24,61,789
New York,Hillside Lake,1045,222,440,60,14,66,802
New York,Churchville village,2230,487,963,230,66,104,1850
New York,West Nyack,3876,892,2007,215,39,294,3447
New York,Cold Brook village,344,114,79,33,3,20,249
New York,Chatham village,1655,503,694,167,36,92,1492
New York,Spencerport village,3620,835,1485,385,133,102,2940
New York,Milton CDP (Saratoga County),3111,674,1468,354,15,112,2623
New York,Hewlett Neck village,456,106,222,8,2,23,361
New York,Jericho,13827,2812,7419,624,137,487,11479
New York,Lawrence village,6535,1388,3141,125,17,411,5082
New York,Newark Valley village,1095,276,399,94,19,51,839
New York,Apalachin,1146,329,459,145,16,95,1044
New York,West Hampton Dunes village,69,0,55,2,0,0,57
New York,Bergen village,1118,275,484,83,7,41,890
New York,Whitney Point village,908,231,376,67,11,62,747
New York,Binghamton,45503,17448,11455,5032,987,2822,37744
New York,Norwood village,1624,371,634,172,31,119,1327
New York,Haviland,3246,646,1756,216,32,103,2753
New York,Livonia village,1361,303,547,120,14,91,1075
New York,Sinclairville village,797,141,321,64,25,31,582
New York,Jamestown West,2512,573,1071,216,42,286,2188
New York,North Hills village,5639,591,3605,271,0,568,5035
New York,New Cassel,14648,5230,4882,492,281,579,11464
New York,Mineola village,19132,4736,9095,1484,144,772,16231
New York,Merrick,19966,4201,10548,909,101,888,16647
New York,Manorhaven village,6620,1589,2608,558,75,205,5035
New York,Castorland village,365,89,125,30,5,23,272
New York,Katonah,1895,307,910,163,49,43,1472
New York,Westmoreland,787,237,208,151,0,16,612
New York,Hunt,109,13,52,2,3,12,82
New York,Northport village,7348,1410,3515,718,102,340,6085
New York,North Patchogue,7561,1838,3523,433,53,233,6080
New York,Napeague,112,13,71,4,0,0,88
New York,West Islip,27149,6825,11973,1651,246,1721,22416
New York,Eastport,2091,597,1092,62,0,46,1797
New York,Cutchogue,3178,644,1567,294,56,159,2720
New York,Brentwood,62942,22208,19575,3913,1365,1958,49019
New York,Greenlawn,13978,3495,5666,1086,78,1020,11345
New York,Wyandanch,11612,4505,2949,671,287,382,8794
New York,Old Bethpage,5522,1226,2697,259,0,379,4561
New York,North Lynbrook,417,78,226,19,0,33,356
New York,Muttontown village,3655,764,2121,107,20,139,3151
New York,Long Beach,33509,10579,12647,3413,865,1773,29277
New York,Laurel Hollow village,1993,371,933,57,6,121,1488
New York,Great Neck Plaza village,6957,1490,2812,880,110,816,6108
New York,Bainbridge village,1442,317,475,170,46,56,1064
New York,Schoharie village,850,220,293,140,3,76,732
New York,Esperance village,394,80,174,41,5,26,326
New York,North Wantagh,11802,2279,5826,791,71,874,9841
New York,Cobleskill village,4540,2405,878,401,104,286,4074
New York,Armonk,4381,794,2333,212,8,109,3456
New York,Dobbs Ferry village,11027,3216,4720,712,141,347,9136
New York,Northeast Ithaca,2881,734,1331,84,7,69,2225
New York,Hammondsport village,492,65,220,84,16,29,414
New York,Cohocton village,899,237,355,54,20,28,694
New York,Warsaw village,3300,929,1043,589,64,274,2899
New York,Syracuse,143293,63441,32114,11597,3342,6679,117173
New York,Marcellus village,1893,551,699,164,36,147,1597
New York,Tully village,1057,360,299,168,0,59,886
New York,Wayland village,1810,443,712,239,38,66,1498
New York,Crompond,2307,399,1167,153,0,113,1832
New York,South Corning village,1157,268,447,154,43,81,993
New York,Albertson,5254,1165,2543,274,0,341,4323
New York,Cortland,18828,9062,4923,1389,267,639,16280
New York,Earlville village,1153,267,457,72,22,69,887
New York,Cazenovia village,2853,1345,724,319,58,166,2612
New York,Valley Stream village,37609,10059,15994,2535,515,1758,30861
New York,Sea Cliff village,5051,1122,2406,423,50,280,4281
New York,Baiting Hollow,1654,263,872,136,26,135,1432
New York,Asharoken village,443,84,244,20,5,29,382
New York,Bath village,5572,1248,1831,947,149,434,4609
New York,Westfield village,2982,677,1024,367,34,358,2460
New York,Lakewood village,2872,625,1109,325,48,294,2401
New York,Cassadaga village,516,92,238,62,7,44,443
New York,Deferiet village,300,73,96,36,3,14,222
New York,Clayton village,2018,543,803,168,41,129,1684
New York,Weston Mills,1384,445,595,117,12,97,1266
New York,Colonie village,7793,2366,3261,688,55,388,6758
New York,Union Springs village,1170,284,479,77,49,55,944
New York,Wynantskill,3328,855,1405,110,51,210,2631
New York,Victor village,2733,616,1256,228,35,120,2255
New York,Beacon,14279,4578,5102,1204,439,698,12021
New York,Depauville,382,35,227,40,14,17,333
New York,Middleville village,570,133,221,38,10,35,437
New York,Herkimer village,6899,1758,2598,708,159,702,5925
New York,Dolgeville village,2581,648,871,192,108,171,1990
New York,Heuvelton village,719,164,320,49,25,48,606
New York,Pomona village,2955,599,1437,147,24,179,2386
New York,New City,34652,7990,17327,1485,378,1577,28757
New York,Montebello village,4616,1154,2136,268,16,278,3852
New York,Kaser village,5179,798,1767,32,9,18,2624
New York,Haverstraw village,12081,3670,3835,823,338,539,9205
New York,Schaghticoke village,647,173,258,64,10,26,531
New York,Evans Mills village,472,110,207,58,11,29,415
New York,Odessa village,504,91,203,57,2,56,409
New York,Watkins Glen village,2016,515,660,282,74,105,1636
New York,Richburg village,450,96,209,18,0,14,337
New York,Dundee village,1624,357,600,169,68,103,1297
New York,Shenorock,2179,430,1056,118,38,69,1711
New York,Mahopac,8426,2244,4001,538,82,347,7212
New York,Rapids,1198,252,620,69,16,57,1014
New York,Arcade village,2182,524,763,230,47,124,1688
New York,Pelham village,6949,1610,2982,373,135,234,5334
New York,Croton-on-Hudson village,8183,1566,3720,660,75,352,6373
New York,Ardsley village,4534,991,2326,207,0,282,3806
New York,West Hills,5338,1152,2816,240,77,175,4460
New York,Lansing village,3535,1152,1501,241,13,71,2978
New York,Groton village,2050,515,794,150,25,224,1708
New York,Burdett village,437,122,206,39,1,16,384
New York,West Seneca,45332,12021,19373,3692,263,3333,38682
New York,Orchard Park village,3154,725,1450,317,22,146,2660
New York,Lackawanna,17859,6047,4882,1664,273,1204,14070
New York,Holland,1190,292,514,90,19,97,1012
New York,Belmont village,807,162,335,108,6,34,645
New York,Interlaken village,591,209,200,78,3,18,508
New York,Schenectady,65482,25107,17849,5951,1932,3743,54582
New York,Chestnut Ridge village,8057,1629,3576,483,29,349,6066
New York,Fulton,11419,2621,3904,1319,357,837,9038
New York,Jeffersonville village,363,134,118,31,15,24,322
New York,Scotchtown,9174,3096,3677,402,74,252,7501
New York,Spring Valley village,32281,9089,10257,1673,968,1105,23092
New York,Orangeburg,4200,1724,1448,194,49,347,3762
New York,Nanuet,17775,4306,8051,1115,117,1079,14668
New York,Grand View-on-Hudson village,307,47,166,23,13,14,263
New York,Germantown,898,187,416,77,22,63,765
New York,Claverack-Red Mills,543,98,261,39,16,35,449
New York,Spackenkill,4239,906,2119,195,78,147,3445
New York,Harriman village,2926,922,1007,201,65,101,2296
New York,Pleasant Valley,1367,373,585,123,0,148,1229
New York,Caledonia village,2102,501,822,234,57,186,1800
New York,Wellsburg village,518,158,173,65,4,17,417
New York,Horseheads village,6510,1787,2262,431,205,685,5370
New York,Elmira Heights village,4032,1014,1520,369,75,218,3196
New York,Palmyra village,3383,785,1179,456,69,149,2638
New York,Star Lake,802,112,318,100,39,68,637
New York,Suffern village,10926,3074,4414,1013,176,609,9286
New York,Pearl River,16495,3940,7720,672,127,963,13422
New York,Lima village,2369,646,1019,216,28,50,1959
New York,Nyack village,7188,2349,2360,725,233,355,6022
New York,Kiryas Joel village,23536,2999,7811,84,12,87,10993
New York,Waterville village,1598,391,664,160,38,112,1365
New York,West Bay Shore,4853,923,2247,297,112,283,3862
New York,Cape Vincent village,652,116,292,47,11,58,524
New York,Mooers,420,159,181,0,0,59,399
New York,Stewart Manor village,2191,517,1051,128,4,143,1843
New York,Holbrook,26286,7071,11820,1823,182,1257,22153
New York,Gordon Heights,3667,1347,954,294,121,93,2809
New York,Fort Salonga,9776,1978,4998,526,67,544,8113
New York,Fishers Island,183,36,131,4,2,0,173
New York,Orange Lake,6348,1385,2984,460,33,439,5301
New York,Farmingville,15495,4312,6869,810,163,684,12838
New York,East Moriches,5359,1312,2578,347,35,224,4496
New York,Scarsdale village,17805,2641,9730,369,121,498,13359
New York,Port Chester village,29418,8812,11534,1653,613,982,23594
New York,Pelham Manor village,5595,1233,2518,192,14,213,4170
New York,Lockport,20580,5803,6978,2395,309,1205,16690
New York,Gasport,1520,388,487,214,47,69,1205
New York,Painted Post village,1727,380,656,184,21,126,1367
New York,Gang Mills,4495,711,2170,411,27,181,3500
New York,Hamilton village,3860,2703,537,168,24,173,3605
New York,Greece,14826,3913,5538,1632,392,1076,12551
New York,Rhinebeck village,2583,563,1120,349,38,194,2264
New York,Millbrook village,1421,433,554,141,42,152,1322
New York,Constableville village,287,72,113,25,4,12,226
New York,Fredonia village,10637,4773,3365,599,196,408,9341
New York,Cherry Creek village,481,86,220,23,10,23,362
New York,Silver Springs village,875,258,202,186,2,61,709
New York,West Hempstead,20116,6013,8046,1130,242,873,16304
New York,University Gardens,4202,867,2013,280,73,176,3409
New York,Uniondale,31828,12960,9846,1932,535,1357,26630
New York,Russell Gardens village,932,199,533,34,5,28,799
New York,Copenhagen village,765,228,279,42,26,63,638
New York,Roosevelt,16229,6624,4729,881,309,635,13178
New York,Oyster Bay Cove village,2170,372,1306,60,16,52,1806
New York,Roslyn village,2852,539,1118,411,40,325,2433
New York,North Amityville,18817,7519,5191,1108,392,868,15078
New York,New Suffolk,212,45,105,22,0,27,199
New York,Nesconset,13893,2606,6948,784,107,671,11116
New York,Whitehall village,2274,656,813,187,49,128,1833
New York,Dresden village,331,72,129,24,20,17,262
New York,Livingston Manor,1223,299,464,102,97,92,1054
New York,Port Washington,15600,2892,7630,915,186,877,12500
New York,Lyons Falls village,543,80,241,51,8,48,428
New York,Middleburgh village,1521,456,533,264,18,79,1350
New York,Palatine Bridge village,637,106,289,67,9,112,583
New York,Port Dickinson village,1812,526,611,226,60,55,1478
New York,Mohawk village,2578,903,627,463,59,121,2173
New York,Lisle village,215,63,68,18,4,15,168
New York,Le Roy village,4220,1155,1488,531,88,142,3404
New York,Johnson City village,14575,4688,4319,1246,389,1101,11743
New York,Glen Cove,27226,8291,10626,1998,266,1316,22497
New York,Troy,49610,22741,11514,4009,1072,2042,41378
New York,Nassau village,1048,229,491,81,9,25,835
New York,Dexter village,1022,265,376,63,22,39,765
New York,Nichols village,601,162,247,52,0,20,481
New York,Webster village,5565,1676,1859,685,81,287,4588
New York,Honeoye Falls village,2742,847,1038,242,66,112,2305
New York,Brockport village,8350,5041,1438,659,79,298,7515
New York,Stottville,1359,452,379,144,54,67,1096
New York,Hudson,6339,2666,1559,761,183,223,5392
New York,Elba village,645,130,295,53,2,29,509
New York,Fort Plain village,1739,469,562,195,71,130,1427
New York,Ithaca,30568,21928,4765,1223,270,449,28635
New York,Richmondville village,869,298,251,65,6,64,684
New York,Hannibal village,511,114,214,44,12,29,413
New York,Blauvelt,5620,1521,2642,139,52,248,4602
New York,Scottsville village,2014,508,727,218,31,115,1599
New York,Irondequoit,50427,13321,20313,5164,798,3079,42675
New York,West Elmira,4827,617,2546,329,52,355,3899
New York,Van Etten village,678,147,260,71,5,23,506
New York,Elmira,27695,10225,7256,2643,770,1185,22079
New York,Newark village,8937,2604,2764,1158,312,537,7375
New York,Rensselaer Falls village,361,67,128,23,1,20,239
New York,Gouverneur village,3751,968,1364,464,92,329,3217
New York,Viola,6917,1877,2333,247,50,382,4889
New York,South Nyack village,3517,1586,1125,306,13,164,3194
New York,Mount Morris village,2757,725,857,370,110,97,2159
New York,New Square village,8133,1068,2788,12,0,40,3908
New York,Malverne village,8535,1887,4237,445,56,562,7187
New York,Lake Success village,3102,491,1593,114,26,360,2584
New York,Hewlett Harbor village,1090,208,587,54,8,50,907
New York,Hewlett Bay Park village,366,59,225,8,0,14,306
New York,Ransomville,1601,400,742,143,11,43,1339
New York,North Tonawanda,30596,8165,12506,3035,585,1960,26251
New York,Niagara Falls,48661,16471,14280,4676,1057,2759,39243
New York,Kensington village,1184,213,651,28,8,89,989
New York,Plandome village,1251,217,683,18,4,40,962
New York,Ilion village,7852,2106,2659,732,234,418,6149
New York,Corfu village,707,211,305,73,12,37,638
New York,Ogdensburg,10748,3241,3608,1150,279,697,8975
New York,Brocton village,1319,354,450,218,29,107,1158
New York,Freeville village,394,103,191,41,7,20,362
New York,Bemus Point village,301,64,88,34,10,64,260
New York,Redford,361,54,150,14,35,0,253
New York,Cumberland Head,1395,306,728,166,0,72,1272
New York,Au Sable Forks,426,89,178,39,10,38,354
New York,Port Byron village,1006,341,387,60,42,57,887
New York,Putnam Lake,3519,916,1685,269,95,118,3083
New York,Sodus village,1687,501,502,172,37,94,1306
New York,Lake Carmel,8114,1797,3746,607,157,509,6816
New York,Riverside village,514,72,217,70,26,50,435
New York,Hornell,8308,2677,2527,1005,208,514,6931
New York,Addison village,1753,420,712,132,77,68,1409
New York,Miller Place,11755,2640,5249,982,61,341,9273
New York,Geneseo village,8096,6023,1013,226,107,170,7539
New York,Big Flats,5212,866,2674,379,109,235,4263
New York,Clyde village,2111,543,715,174,88,55,1575
New York,Waddington village,938,185,432,104,28,55,804
New York,Cold Spring village,1862,458,792,198,57,78,1583
New York,Frankfort village,2376,692,870,281,39,111,1993
New York,Chappaqua,1459,372,706,102,0,50,1230
New York,Wheatley Heights,4921,1488,1837,298,96,193,3912
New York,Elwood,11439,2726,5645,492,70,476,9409
New York,Cold Spring Harbor,5164,1108,2603,255,78,169,4213
New York,Centereach,32028,8431,13561,1755,510,1700,25957
New York,Bayport,8392,1932,3495,841,110,632,7010
New York,Amagansett,750,131,432,74,8,72,717
New York,Hartsdale,4822,1320,2211,436,44,245,4256
New York,East Quogue,4797,925,2417,357,41,250,3990
New York,East Northport,20136,4770,9510,1419,114,900,16713
New York,Candor village,645,104,297,47,22,30,500
New York,East Islip,13563,3639,5633,721,174,793,10960
New York,Copiague,23716,7831,8590,1922,426,1079,19848
New York,Central Islip,31846,11551,9454,2364,627,1418,25414
New York,Babylon village,12089,3183,5708,705,104,495,10195
New York,Amityville village,9452,2373,3970,911,84,618,7956
New York,Burke village,225,27,93,29,2,11,162
New York,South Glens Falls village,3595,754,1358,492,65,212,2881
New York,Hyde Park,1982,593,770,196,1,135,1695
New York,Brushton village,456,116,157,52,18,32,375
New York,Coram,39977,10763,15943,3574,568,2147,32995
New York,Crugers,1489,356,561,157,35,239,1348
New York,Golden's Bridge,1813,371,893,95,11,118,1488
New York,Hawthorne,4510,903,2238,220,35,243,3639
New York,West Sayville,4806,1178,2234,308,10,247,3977
New York,Alexander village,589,168,191,82,14,9,464
New York,Wappingers Falls village,5663,1854,2174,432,92,230,4782
New York,Wolcott village,1694,504,482,203,30,116,1335
New York,Red Creek village,684,213,232,26,22,12,505
New York,Millport village,443,123,150,46,9,12,340
New York,Tuckahoe,984,251,474,67,0,0,792
New York,Terryville,12340,2943,5794,593,174,686,10190
New York,Richville village,282,58,110,16,2,17,203
New York,Springs,6912,1391,3718,461,16,201,5787
New York,Deer Park,27273,7095,11391,1771,467,1551,22275
New York,Center Moriches,8395,1960,3912,464,54,261,6651
New York,Bellport village,2008,372,1093,157,24,147,1793
New York,Belle Terre village,681,100,403,16,2,39,560
New York,Kings Park,16707,3927,7779,1077,86,1123,13992
New York,Holtsville,19365,4468,9156,1427,196,835,16082
New York,Hampton Bays,14280,3706,6154,975,145,1033,12013
New York,Halesite,2671,454,1365,261,0,147,2227
New York,East Shoreham,6484,1371,3007,364,68,218,5028
New York,Frewsburg,1664,310,926,43,18,173,1470
New York,Ripley,787,151,378,90,11,51,681
New York,New Berlin village,927,235,379,88,11,101,814
New York,Friendship,1169,201,448,112,40,76,877
New York,DeRuyter village,457,72,150,55,20,39,336
New York,Monsey,22073,3781,7429,208,64,222,11704
New York,Congers,8406,2159,3908,406,157,495,7125
New York,Airmont village,8776,1736,3904,327,65,392,6424
New York,Pittsford village,1667,317,735,220,14,57,1343
New York,Hilton village,5858,1420,2226,567,86,268,4567
New York,Fairport village,5349,1228,2598,484,158,206,4674
New York,Lorenz Park,2150,653,799,155,26,189,1822
New York,Springville village,4306,879,1698,543,79,336,3535
New York,Kinderhook village,1366,296,691,86,24,118,1215
New York,Valatie village,1728,486,581,165,40,143,1415
New York,Galeville,4557,1165,1756,280,84,429,3714
New York,Baldwinsville village,7550,1740,3192,821,95,609,6457
New York,Bellerose Terrace,2055,424,1017,86,42,67,1636
New York,Sleepy Hollow village,10138,2936,3955,568,217,390,8066
New York,Corning,10789,3260,3646,1138,294,528,8866
New York,Cove Neck village,254,38,142,11,0,13,204
New York,Canisteo village,2262,548,972,158,45,141,1864
New York,Ghent,529,113,231,44,21,0,409
New York,Tonawanda,14873,4137,6028,1607,119,880,12771
New York,Canastota village,4605,1393,1434,489,152,202,3670
New York,Tonawanda,57280,14078,22712,5750,784,4400,47724
New York,Niverville,1262,355,467,90,58,68,1038
New York,Warwick village,6779,1442,2854,744,188,515,5743
New York,Vails Gate,3122,936,1080,210,51,336,2613
New York,Sand Ridge,557,105,231,15,31,98,480
New York,Mayfield village,795,213,360,68,4,16,661
New York,Gloversville,14938,4420,4631,1543,582,989,12165
New York,Broadalbin village,1466,397,514,172,10,105,1198
New York,Brewerton,3931,877,1603,314,153,168,3115
New York,Rotterdam,20274,5578,7560,2111,386,1215,16850
New York,Delanson village,376,111,133,30,1,5,280
New York,Tribes Hill,868,151,390,84,12,70,707
New York,Fort Johnson village,839,234,285,75,32,20,646
New York,Castile village,945,176,379,91,84,36,766
New York,Seneca Knolls,2002,431,958,274,0,105,1768
New York,Nedrow,2316,898,675,140,35,159,1907
New York,Minoa village,3474,659,1365,242,47,288,2601
New York,Manlius village,4520,806,1938,502,53,332,3631
New York,Lyncourt,3856,1281,1055,385,31,274,3026
New York,Jordan village,1435,470,470,183,13,58,1194
New York,Almond village,494,56,222,46,7,23,354
New York,Portville village,965,223,297,109,15,83,727
New York,Youngstown village,2047,467,908,156,46,103,1680
New York,Lewiston village,2592,557,1028,315,45,335,2280
New York,East Hills village,7113,854,4042,204,37,228,5365
New York,Watervliet,10120,3745,2983,1000,245,501,8474
New York,Plattsburgh,19515,9063,5148,1906,341,982,17440
New York,Peru,1512,377,689,119,5,175,1365
New York,North Massapequa,18609,4419,8871,1019,138,1097,15544
New York,North Bellmore,20269,4920,9750,940,121,1141,16872
New York,Manhasset Hills,3594,743,1976,58,4,179,2960
New York,Lakeview,6317,2034,2048,487,175,347,5091
New York,Farmingdale village,8842,2339,3745,877,100,563,7624
New York,Hewlett,6484,1382,3134,511,76,291,5394
New York,Hempstead village,55399,21349,14806,3338,1133,2005,42631
New York,Harbor Hills,475,33,202,6,0,50,291
New York,Franklin Square,32329,8797,14826,1562,243,1621,27049
New York,East Norwich,2902,685,1289,188,0,182,2344
New York,Brookville village,3564,1464,1488,55,9,89,3105
New York,Wampsville village,650,286,199,46,16,43,590
New York,Munnsville village,497,135,159,34,12,24,364
New York,Greene village,1704,421,628,171,18,142,1380
New York,Herricks,4074,893,2137,196,12,178,3416
New York,Glenwood Landing,3910,1027,1646,308,90,168,3239
New York,Great Neck Gardens,1183,138,592,27,0,16,773
New York,Inwood,9804,3316,3290,566,170,447,7789
New York,Penn Yan village,4818,1304,1582,612,154,419,4071
New York,Trumansburg village,1805,366,820,221,43,122,1572
New York,Newfield Hamlet,465,72,178,146,0,15,411
New York,Glen Head,4983,1141,2403,329,45,130,4048
New York,Mattydale,6102,1862,1628,1013,150,241,4894
New York,Liverpool village,2174,666,841,211,60,138,1916
New York,Fayetteville village,4133,841,2201,224,24,145,3435
New York,Rome,32338,9587,10785,3281,1117,1905,26675
New York,Oriskany village,1246,332,477,131,7,143,1090
New York,New York Mills village,3381,1122,1046,419,93,175,2855
New York,Woodbury,8603,1274,4465,437,10,1080,7266
New York,Williston Park village,7294,1680,3412,384,72,412,5960
New York,Upper Brookville village,1607,396,851,67,4,82,1400
New York,South Valley Stream,6930,1571,3190,423,39,260,5483
New York,South Hempstead,3123,690,1470,180,46,88,2474
New York,Plandome Heights village,949,180,512,21,3,49,765
New York,Old Westbury village,4742,1963,1965,60,13,110,4111
New York,North New Hyde Park,15726,3953,7876,299,78,896,13102
New York,Massapequa Park village,17120,3699,8403,773,115,978,13968
New York,South Lockport,7315,1914,2564,1060,110,451,6099
New York,Alexandria Bay village,831,195,302,151,22,67,737
New York,East Ithaca,2041,635,775,230,31,56,1727
New York,Glen Park village,568,141,204,40,15,24,424
New York,Lake Katrine,2533,814,915,198,52,306,2285
New York,Auburn,26779,8405,7983,3238,842,1929,22397
New York,Ovid village,531,155,192,48,13,35,443
New York,Valley Falls village,483,133,213,23,4,14,387
New York,Solvay village,6364,2005,1912,722,155,375,5169
New York,Ossining village,25174,7756,9278,2065,404,932,20435
New York,Sands Point village,2857,463,1566,112,0,101,2242
New York,Oneida Castle village,598,113,255,76,7,33,484
New York,East Hampton North,4468,1293,1863,316,12,227,3711
New York,Waverly village,4214,1096,1352,414,111,369,3342
New York,Tupper Lake village,3710,730,1566,332,152,222,3002
New York,Greenport village,1945,506,718,225,24,204,1677
New York,Chenango Bridge,2916,663,1455,172,27,142,2459
New York,Nissequogue village,1574,346,881,49,7,54,1337
New York,Windsor village,972,179,484,81,13,37,794
New York,Hopewell Junction,454,114,166,30,0,0,310
New York,Leicester village,516,110,250,45,10,27,442
New York,Barker village,588,131,239,45,3,25,443
New York,Jefferson Heights,968,199,345,98,22,231,895
New York,Stamford village,1374,461,416,134,31,166,1208
New York,Saltaire village,8,0,4,0,0,2,6
New York,Cornwall-on-Hudson village,2927,762,1301,222,47,79,2411
New York,Fillmore,497,99,234,30,0,27,390
New York,Sagaponack village,260,39,136,5,8,40,228
New York,Schenevus,485,157,207,38,0,31,433
New York,South Blooming Grove village,3145,785,1298,217,68,153,2521
New York,Irvington village,6539,1418,3020,358,149,213,5158
New York,Lyon Mountain,282,66,138,25,13,9,251
New York,Chazy,523,216,125,22,24,18,405
New York,Chautauqua,380,250,69,36,0,8,363
New York,Akron village,2857,700,893,428,7,225,2253
New York,Billington Heights,1384,340,619,200,16,80,1255
New York,Depew village,15164,4281,6091,1360,244,902,12878
New York,East Aurora village,6193,1242,2545,868,119,386,5160
New York,Eden,3244,770,1536,253,75,141,2775
New York,Naples village,1033,302,419,109,16,52,898
New York,Head of the Harbor village,1463,451,654,60,13,103,1281
New York,Saratoga Springs,27772,8948,10984,2762,459,1347,24500
New York,Owego village,3827,1098,1361,417,91,236,3203
New York,Fort Ann village,343,98,130,41,10,14,293
New York,Morristown village,292,87,126,20,4,22,259
New York,New Hempstead village,5354,1339,2242,62,84,160,3887
New York,Tappan,6996,1509,3342,444,48,468,5811
New York,Wesley Hills village,5858,1116,2687,61,15,72,3951
New York,Norfolk,1441,613,378,44,7,154,1196
New York,Poughkeepsie,30356,11584,8250,2779,1057,1460,25130
New York,Tivoli village,1100,502,329,82,13,47,973
New York,Horseheads North,2747,572,1430,124,61,31,2218
New York,Southport,6940,1598,2568,914,325,501,5906
New York,Yaphank,6390,2165,2497,585,65,147,5459
New York,Buchanan village,2132,529,1075,106,23,62,1795
New York,Eastchester,19983,4726,9232,1136,152,1155,16401
New York,Elmsford village,4993,1771,1976,344,79,168,4338
New York,Greenville CDP (Westchester County),7336,1428,3878,225,33,239,5803
New York,Caroga Lake,590,87,281,83,8,57,516
New York,Central Bridge,328,75,180,0,10,0,265
New York,Chadwicks,1366,502,533,124,0,59,1218
New York,Ticonderoga,3120,1017,963,184,72,294,2530
New York,Elbridge village,1004,241,468,101,12,43,865
New York,Westport,404,67,166,73,11,38,355
New York,Andes,243,60,114,28,10,16,228
New York,Eggertsville,15546,4431,6453,1161,182,602,12829
New York,Elizabethtown,716,173,245,58,25,101,602
New York,Erin,396,72,166,74,14,14,340
New York,Felts Mills,396,65,116,15,65,23,284
New York,Fishers Landing,65,0,65,0,0,0,65
New York,Fort Covington Hamlet,1530,386,532,124,8,81,1131
New York,Fowlerville,150,55,57,0,0,31,143
New York,Freedom Plains,336,84,107,56,18,31,296
New York,Gates,5035,1512,1947,349,192,355,4355
New York,Gilgo,206,91,66,49,0,0,206
New York,Glen Aubrey,292,80,128,37,0,21,266
New York,Gorham,687,126,305,47,0,15,493
New York,Edmeston,671,150,300,50,10,13,523
New York,Grandyle Village,4873,937,2303,429,72,130,3871
New York,Groveland Station,260,63,113,24,2,7,209
New York,Guilford,283,11,157,22,0,44,234
New York,Hadley,868,65,549,46,6,39,705
New York,Hailesboro,767,125,413,25,5,43,611
New York,Hall,128,14,83,10,0,6,113
New York,Hamlin,5453,1528,2191,557,84,177,4537
New York,Hannawa Falls,882,210,470,15,0,39,734
New York,Hartwick,641,156,279,41,23,46,545
New York,Hemlock,423,68,154,49,17,69,357
New York,Henderson,151,47,53,25,7,9,141
New York,Honeoye,854,255,316,69,0,46,686
New York,Hortonville,162,34,75,43,0,10,162
New York,Greigsville,338,96,108,10,0,27,241
New York,East Avon,740,131,187,194,0,36,548
New York,Downsville,472,151,185,67,0,27,430
New York,Calcium,3841,704,1749,273,161,18,2905
New York,Bedford Hills,3522,1146,1403,251,0,57,2857
New York,Belfast,715,118,292,61,18,49,538
New York,Belleville,306,22,96,73,9,0,200
New York,Binghamton University,6149,6134,15,0,0,0,6149
New York,Bliss,521,141,169,94,12,31,447
New York,Blodgett Mills,236,68,101,35,25,0,229
New York,Bloomville,160,54,61,27,3,3,148
New York,Bolton Landing,507,164,203,19,18,51,455
New York,Brasher Falls,734,165,225,90,16,29,525
New York,Breesport,614,138,342,0,15,16,511
New York,Busti,334,39,127,52,0,0,218
New York,Byersville,29,8,13,7,0,0,28
New York,Campbell,713,182,212,104,12,94,604
New York,Chestertown,515,104,221,73,0,60,458
New York,Clarence,2756,502,1112,202,100,315,2231
New York,Clarkson,4365,1064,1715,389,35,282,3485
New York,Colton,400,58,208,26,0,31,323
New York,Conesus Hamlet,455,129,179,23,5,3,339
New York,Conesus Lake,2374,541,1286,281,9,123,2240
New York,Coopers Plains,416,65,152,23,7,72,319
New York,Cranberry Lake,170,28,108,8,0,8,152
New York,Crystal Beach,801,160,387,116,24,32,719
New York,Cumminsville,145,0,34,75,10,26,145
New York,Cuylerville,226,54,114,15,5,16,204
New York,Dalton,337,55,192,12,1,9,269
New York,Durhamville,966,236,165,41,28,123,593
New York,Davenport Center,222,0,74,47,49,0,170
New York,Woodbury village,10735,2661,4661,604,126,453,8505
New York,East Syracuse village,2968,1067,881,372,38,142,2500
New York,DeKalb Junction,652,194,184,46,38,21,483
New York,Camden village,2570,512,867,356,46,230,2011
New York,Forest Home,616,245,256,12,6,6,525
New York,West Sand Lake,2714,569,1469,122,0,137,2297
New York,Madison village,468,109,178,38,21,14,360
New York,Norwich,6813,1887,2176,702,237,503,5505
New York,Andover village,818,198,370,60,11,56,695
New York,Morrisville village,1939,1385,235,84,10,63,1777
New York,Hagaman village,1495,294,672,213,18,111,1308
New York,South Hill,6468,4839,967,71,15,248,6140
New York,Savona village,840,187,274,106,13,57,637
New York,North Syracuse village,6740,1822,2105,936,305,474,5642
New York,Bridgeport,1568,253,670,210,3,65,1201
New York,Mayville village,1412,415,477,177,50,66,1185
New York,South Farmingdale,14953,3278,7451,708,211,698,12346
New York,Walton Park,2707,744,1131,214,20,74,2183
New York,Pine Bush,1462,427,446,125,9,177,1184
New York,Fort Montgomery,1586,387,763,127,12,58,1347
New York,Yorktown Heights,1390,468,545,200,39,55,1307
New York,Greenport West,2245,532,1117,96,31,254,2030
New York,Elmont,36028,11559,13881,2505,666,1559,30170
New York,Olcott,1132,389,396,139,30,63,1017
New York,Newfane,3764,675,1586,397,17,371,3046
New York,Rushville village,654,184,198,63,21,47,513
New York,Dannemora village,3947,2392,860,298,130,126,3806
New York,Champlain village,1018,211,348,118,23,68,768
New York,Salisbury,11753,2601,5900,441,76,567,9585
New York,Lake Placid village,2244,737,643,392,33,57,1862
New York,Canandaigua,10348,2945,3522,1146,240,734,8587
New York,Manchester village,1786,396,646,195,39,151,1427
New York,Port Leyden village,660,167,199,41,48,30,485
New York,Homer village,3134,853,1226,375,47,165,2666
New York,Clintondale,1343,353,700,27,14,95,1189
New York,Adams Center,1451,244,764,93,88,12,1201
New York,Thiells,5186,1243,2414,336,113,144,4250
New York,Red Hook village,1963,707,669,177,19,116,1688
New York,West Winfield village,752,135,368,58,22,70,653
New York,Valley Cottage,9637,2176,4409,699,97,589,7970
New York,Hillburn village,996,243,428,63,11,29,774
New York,Callicoon,224,92,111,14,0,0,217
New York,New Hyde Park village,9846,2274,4962,329,40,420,8025
New York,Great Neck Estates village,2841,520,1545,130,4,93,2292
New York,Plattsburgh West,1370,329,531,166,29,70,1125
New York,East Rochester village,6603,2178,1873,782,175,362,5370
New York,Blue Point,4882,1247,2236,327,20,196,4026
New York,La Fargeville,688,180,293,33,21,30,557
New York,Hastings-on-Hudson village,7964,1801,3796,510,98,260,6465
New York,Batavia,14719,4235,4982,1709,291,944,12161
New York,Eatons Neck,1474,281,838,55,0,59,1233
New York,Fort Drum,13109,3709,5408,150,92,10,9369
New York,Chaumont village,827,169,317,67,9,35,597
New York,Flower Hill village,4795,859,2595,152,37,153,3796
New York,East Williston village,2576,605,1219,95,11,133,2063
New York,Moravia village,1340,283,500,125,26,128,1062
New York,Cato village,665,163,245,45,27,9,489
New York,South Fallsburg,2538,716,586,204,0,192,1698
New York,Point Lookout,1008,241,592,29,10,49,921
New York,Rock Hill,1417,336,688,85,5,112,1226
New York,Pulaski village,2093,531,693,286,71,106,1687
New York,Otego village,917,249,411,63,2,51,776
New York,Morris village,537,151,172,31,20,46,420
New York,Watertown,26057,7404,8556,2803,593,1295,20651
New York,Theresa village,679,180,245,57,32,54,568
New York,Hobart village,453,100,187,48,17,29,381
New York,Philadelphia village,1115,231,457,86,31,65,870
New York,Ellisburg village,241,24,117,20,4,5,170
New York,Adams village,1661,348,527,146,79,67,1167
New York,St. Bonaventure,1947,1544,256,52,37,35,1924
New York,Delevan village,1007,297,375,60,33,59,824
New York,Village of the Branch village,1770,418,867,84,3,111,1483
New York,Castleton-on-Hudson village,1393,298,552,115,30,111,1106
New York,Southold,6117,1549,2905,457,71,360,5342
New York,Patchogue village,12398,3809,4761,994,209,589,10362
New York,Noyack,4327,1235,1351,513,14,300,3413
New York,North Sea,4522,993,2224,322,36,348,3923
New York,Kerhonkson,2373,670,743,204,20,161,1798
New York,East Kingston,737,163,155,108,51,70,547
New York,Galway village,221,29,90,19,8,10,156
New York,Country Knolls,2120,365,1156,61,17,104,1703
New York,West End,1887,652,674,129,52,239,1746
New York,Gilbertsville village,355,86,168,37,5,31,327
New York,Oneonta,13834,7968,3099,813,199,585,12664
New York,Utica,60675,20980,16982,5017,1230,3710,47919
New York,Peconic,747,112,474,46,0,96,728
New York,Hampton Manor,2235,642,883,109,14,123,1771
New York,Poestenkill,893,202,354,108,8,112,784
New York,Windham,287,42,167,36,12,23,280
New York,Parish village,498,158,155,51,17,22,403
New York,Oswego,17588,6210,5352,1578,592,965,14697
New York,Constantia,1177,304,467,201,66,58,1096
New York,St. Johnsville village,1907,475,608,207,64,166,1520
New York,Fonda village,838,247,296,52,25,48,668
New York,Dryden village,2092,602,811,174,32,118,1737
New York,Perry village,3594,848,1493,376,33,128,2878
New York,Peach Lake,1804,403,735,143,35,92,1408
New York,New Rochelle,79205,24128,30731,5738,1578,3565,65740
New York,Lincolndale,1475,303,693,144,0,100,1240
New York,Kenmore village,15191,4209,6487,1200,168,797,12861
New York,Buffalo,257518,107083,60455,21813,6773,12676,208800
New York,Blasdell village,2629,831,744,387,36,211,2209
New York,Valhalla,3551,1010,1494,153,134,209,3000
New York,Altamont village,1755,427,704,144,9,115,1399
New York,Baldwin Harbor,7690,2318,3247,563,142,301,6571
New York,Marathon village,843,234,391,48,20,30,723
New York,Oneida,10980,3142,3790,1274,347,480,9033
New York,Smyrna village,230,67,73,32,0,17,189
New York,Afton village,986,226,358,167,22,71,844
New York,Brewster village,2087,768,687,144,37,37,1673
New York,Parc,240,230,0,5,0,5,240
New York,Altona,759,402,175,84,13,15,689
New York,Mariaville Lake,370,172,156,19,0,0,347
New York,Wilson village,1099,213,545,81,12,78,929
New York,Bloomingburg village,392,75,145,38,9,28,295
New York,Roslyn Estates village,1188,169,659,49,3,48,928
New York,Arkport village,853,195,259,91,59,48,652
New York,Boonville village,2063,602,598,241,19,198,1658
New York,Great Bend,1100,216,481,80,8,8,793
New York,Roslyn Heights,6591,1680,3071,366,45,238,5400
New York,Saddle Rock Estates,577,53,277,10,0,10,350
New York,Syosset,19559,3977,10272,614,91,660,15614
New York,Wantagh,18078,4255,8893,765,87,958,14958
North Carolina,North Wilkesboro,4201,1037,1471,354,136,375,3373
North Carolina,Carrboro,21216,7940,6908,1775,404,540,17567
North Carolina,Walnut Creek village,1130,186,650,63,29,51,979
North Carolina,Rennert,386,126,103,31,21,21,302
North Carolina,Holly Springs,33341,6044,15156,1999,410,805,24414
North Carolina,Durham,264310,92089,85555,22209,5583,9377,214813
North Carolina,Norlina,1101,347,288,145,17,142,939
North Carolina,Columbia,898,152,330,65,31,109,687
North Carolina,Ramseur,1738,376,502,221,78,178,1355
North Carolina,Prospect,858,199,340,73,0,70,682
North Carolina,Pilot Mountain,1483,273,534,223,25,132,1187
North Carolina,Flat Rock,1257,351,553,103,48,145,1200
North Carolina,Albemarle,15889,3772,5770,1552,388,1125,12607
North Carolina,Vann Crossroads,285,89,95,0,16,0,200
North Carolina,Stedman,1325,211,655,151,20,60,1097
North Carolina,Laurinburg,15253,4769,4074,1270,540,1249,11902
North Carolina,Falcon,209,42,95,15,0,12,164
North Carolina,Raynham,53,16,22,9,0,4,51
North Carolina,Trinity,6621,1165,3341,451,83,321,5361
North Carolina,Denton,1820,407,666,231,45,101,1450
North Carolina,West Canton,1257,218,577,104,8,106,1013
North Carolina,Raemon,182,55,18,28,0,39,140
North Carolina,Deercroft,484,44,293,19,27,20,403
North Carolina,Delco,242,48,145,31,0,18,242
North Carolina,Denver,3171,550,1419,326,185,66,2546
North Carolina,Edneyville,2478,394,1174,230,9,65,1872
North Carolina,Efland,709,95,404,43,0,69,611
North Carolina,Engelhard,511,145,221,24,15,31,436
North Carolina,Evergreen,230,44,126,12,0,18,200
North Carolina,Fairfield,197,0,123,32,13,29,197
North Carolina,Ayden,5112,1776,1418,455,145,310,4104
North Carolina,Saratoga,502,97,193,43,12,63,408
North Carolina,Macclesfield,555,131,185,76,2,58,452
North Carolina,Concord,89729,19553,37112,7915,1480,3893,69953
North Carolina,Smithfield,12117,2916,4306,1349,486,1035,10092
North Carolina,South Rosemary,2288,747,712,120,51,228,1858
North Carolina,Roanoke Rapids,14937,4064,4556,1520,296,1097,11533
North Carolina,Godwin,113,21,52,5,0,3,81
North Carolina,Whiteville,5450,1292,1566,481,183,690,4212
North Carolina,Norman,98,17,25,16,14,4,76
North Carolina,Oxford,8648,2703,2587,1000,249,745,7284
North Carolina,Rockwell,1811,276,825,194,35,145,1475
North Carolina,Skippers Corner,2583,875,954,183,127,96,2235
North Carolina,Ogden,7692,1207,4025,507,91,296,6126
North Carolina,Bent Creek,1474,267,828,74,11,59,1239
North Carolina,Barker Ten Mile,939,208,448,92,0,84,832
North Carolina,Roxboro,8283,2720,1807,1089,402,637,6655
North Carolina,Rolesville,6957,613,3740,191,49,90,4683
North Carolina,Severn,237,45,87,31,3,31,197
North Carolina,Creedmoor,4429,743,2141,176,104,112,3276
North Carolina,Calypso,462,72,176,67,12,16,343
North Carolina,Boonville,1174,217,485,121,19,84,926
North Carolina,Piney Green,14061,2801,5629,1349,267,447,10493
North Carolina,Granite Falls,4638,1014,1932,458,106,286,3796
North Carolina,Buies Creek,2450,2117,150,76,0,42,2385
North Carolina,Pollocksville,485,54,165,41,5,33,298
North Carolina,Dunn,9635,2384,3029,1027,283,1080,7803
North Carolina,Belville,2328,535,1020,228,33,126,1942
North Carolina,Stokesdale,5367,1202,2495,248,32,248,4225
North Carolina,Belwood,966,159,399,97,36,79,770
North Carolina,Jamestown,4007,1028,1856,317,67,177,3445
North Carolina,Marietta,138,29,72,7,6,8,122
North Carolina,Minnesott Beach,424,33,304,28,4,36,405
North Carolina,Hendersonville,13809,3134,5101,2156,304,1515,12210
North Carolina,Fallston,533,106,221,57,18,37,439
North Carolina,Matthews,31400,6409,15035,2201,420,1506,25571
North Carolina,Morganton,16466,3983,6135,1810,426,1279,13633
North Carolina,Walstonburg,182,36,89,18,3,7,153
North Carolina,St. Stephens,9254,2094,3935,618,158,553,7358
North Carolina,Kill Devil Hills,7035,1814,2517,886,389,246,5852
North Carolina,Barker Heights,1381,291,369,262,70,90,1082
North Carolina,Davis,304,55,131,21,0,60,267
North Carolina,Pleasant Hill,851,288,458,46,14,15,821
North Carolina,Mocksville,5184,1419,1808,559,130,378,4294
North Carolina,Cary,163266,31199,79096,11222,2140,5248,128905
North Carolina,Creswell,203,67,60,6,15,16,164
North Carolina,Chapel Hill,59561,27603,18352,3819,362,1432,51568
North Carolina,Farmville,4710,1506,1259,382,231,214,3592
North Carolina,Jonesville,2390,466,814,328,103,139,1850
North Carolina,Seven Springs,70,12,8,20,6,8,54
North Carolina,Rex,0,0,0,0,0,0,0
North Carolina,Proctorville,142,53,36,7,0,27,123
North Carolina,Orrum,63,18,26,5,0,5,54
North Carolina,McDonald,109,22,45,16,4,7,94
North Carolina,Hamlet,6362,1908,1707,635,190,512,4952
North Carolina,Fairmont,2655,695,746,367,104,256,2168
North Carolina,Brevard,7785,2047,3070,799,175,784,6875
North Carolina,South Henderson,956,297,198,100,42,120,757
North Carolina,Henderson,14986,5228,3634,1241,490,952,11545
North Carolina,Wingate,4078,1998,887,237,66,158,3346
North Carolina,Dobson,1584,382,534,221,49,154,1340
North Carolina,Richfield,549,106,252,46,1,32,437
North Carolina,Lucama,1200,352,417,58,11,61,899
North Carolina,Kenly,1956,571,512,212,79,139,1513
North Carolina,Mar-Mac,3290,824,1125,375,62,261,2647
North Carolina,Elroy,3719,993,1175,570,97,203,3038
North Carolina,Knightdale,15198,3681,6037,1360,305,554,11937
North Carolina,Dana,3585,759,1589,425,108,79,2960
North Carolina,Cove Creek,1058,146,405,261,0,86,898
North Carolina,Cordova,1862,510,759,185,163,55,1672
North Carolina,Murphy,1920,436,650,286,107,188,1667
North Carolina,Dillsboro,247,92,87,39,1,9,228
North Carolina,Middlesex,966,275,270,103,48,70,766
North Carolina,Five Points,896,232,481,7,11,24,755
North Carolina,Teachey,392,62,172,25,22,21,302
North Carolina,Polkton,3187,1566,674,366,103,127,2836
North Carolina,Castalia,418,142,146,61,2,33,384
North Carolina,Saxapahaw,1355,271,656,161,18,92,1198
North Carolina,McFarlan,97,24,50,3,0,16,93
North Carolina,Banner Elk,1445,965,282,68,20,27,1362
North Carolina,Surf City,3264,708,1410,326,35,159,2638
North Carolina,Washington,9649,2633,3006,859,246,777,7521
North Carolina,Kings Grant,9051,2813,3229,966,215,435,7658
North Carolina,Woodland,880,240,283,28,59,58,668
North Carolina,Madison,2463,615,937,264,68,232,2116
North Carolina,Wentworth,2724,729,1186,239,15,142,2311
North Carolina,East Spencer,1537,591,343,203,40,108,1285
North Carolina,Salisbury,33652,10608,10203,3769,927,2186,27693
North Carolina,Mint Hill,26168,4818,12582,2390,367,1578,21735
North Carolina,Spindale,4231,1275,1270,469,145,273,3432
North Carolina,Garland,1052,240,281,95,46,62,724
North Carolina,Newton Grove,546,126,254,34,33,38,485
North Carolina,Hightsville,777,308,179,195,37,24,743
North Carolina,Silver City,912,435,63,33,37,198,766
North Carolina,Atkinson,338,97,89,46,14,31,277
North Carolina,Wilkesboro,3505,837,1097,411,109,470,2924
North Carolina,Mulberry,2327,427,1054,190,109,117,1897
North Carolina,Cricket,1944,381,683,280,110,170,1624
North Carolina,Liberty,2657,717,903,237,62,201,2120
North Carolina,Archdale,11538,2463,4748,1451,358,633,9653
North Carolina,Falkland,76,26,18,7,7,5,63
North Carolina,Holly Ridge,2256,312,1165,230,24,74,1805
North Carolina,East Rockingham,3289,745,1082,233,143,267,2470
North Carolina,Hoffman,693,180,202,66,47,41,536
North Carolina,Greensboro,288719,98909,92165,26187,5715,13224,236200
North Carolina,Summerfield,11044,2007,5759,594,133,362,8855
North Carolina,Sneads Ferry,2797,496,1462,277,44,64,2343
North Carolina,Whitsett,1018,183,501,62,35,71,852
North Carolina,Walkertown,5043,957,2021,646,112,228,3964
North Carolina,Enfield,2322,1050,362,154,128,206,1900
North Carolina,Halifax,148,39,54,5,8,14,120
North Carolina,Scotland Neck,1380,507,373,147,55,123,1205
North Carolina,Littleton,607,208,155,42,36,82,523
North Carolina,Clayton,20324,4118,8388,1856,380,510,15252
North Carolina,Princeton,944,113,313,146,36,83,691
North Carolina,Selma,6577,1861,1852,579,264,360,4916
North Carolina,Beech Mountain,581,63,388,47,3,36,537
North Carolina,Ronda,589,134,222,34,8,38,436
North Carolina,Bethania,392,105,205,37,5,12,364
North Carolina,Half Moon,7669,1863,3156,498,185,272,5974
North Carolina,Warsaw,3131,995,733,232,164,282,2406
North Carolina,Conetoe,294,92,102,16,6,35,251
North Carolina,Ossipee,488,115,189,67,26,17,414
North Carolina,Red Cross,759,126,361,69,24,51,631
North Carolina,Wallburg,3029,473,1641,223,35,130,2502
North Carolina,Chimney Rock Village village,140,14,67,11,0,11,103
North Carolina,Advance,924,119,462,93,0,78,752
North Carolina,Aquadale,259,76,108,15,0,36,235
North Carolina,Archer Lodge,4771,791,1941,393,353,47,3525
North Carolina,Atlantic,458,44,295,71,5,16,431
North Carolina,Belvoir,596,73,288,43,0,40,444
North Carolina,Avon,665,177,136,173,35,46,567
North Carolina,North Topsail Beach,995,194,454,120,27,112,907
North Carolina,Bayview,284,91,136,47,0,10,284
North Carolina,Bennett,440,188,95,45,0,12,340
North Carolina,Blue Clay Farms,10,0,10,0,0,0,10
North Carolina,Broad Creek,2440,427,1174,318,62,92,2073
North Carolina,Bunnlevel,592,167,191,94,4,72,528
North Carolina,Buxton,1319,160,548,174,19,62,963
North Carolina,Camden,740,248,309,48,35,10,650
North Carolina,Caroleen,841,174,430,180,0,0,784
North Carolina,Cherokee,2163,610,752,311,12,182,1867
North Carolina,Cliffside,185,27,97,28,0,0,152
North Carolina,Coinjock,398,114,178,49,0,0,341
North Carolina,Bell Arthur,156,30,75,39,0,0,144
North Carolina,Lexington,18897,5409,5693,1818,646,1296,14862
North Carolina,Misenheimer village,754,586,130,10,0,14,740
North Carolina,Duck,581,63,366,51,2,42,524
North Carolina,Pinetops,1273,432,409,92,16,65,1014
North Carolina,Bailey,450,87,170,30,11,45,343
North Carolina,Dortches,1085,116,588,49,9,67,829
North Carolina,Bayshore,4696,805,2224,282,62,97,3470
North Carolina,Carolina Beach,6194,1260,2954,790,194,179,5377
North Carolina,Bolton,669,202,179,50,16,77,524
North Carolina,Biltmore Forest,1536,215,893,63,10,93,1274
North Carolina,Montreat,454,298,145,6,0,5,454
North Carolina,Hudson,3704,582,1845,288,40,180,2935
North Carolina,Sawmills,5159,1059,2176,688,248,395,4566
North Carolina,Mills River,7173,1750,3522,320,87,399,6078
North Carolina,Cove City,412,101,146,27,16,26,316
North Carolina,Dellview,6,6,0,0,0,0,6
North Carolina,Elon,11008,5762,3196,368,60,665,10051
North Carolina,Fairview,3701,597,1850,430,26,198,3101
North Carolina,Grantsboro,654,110,291,50,33,45,529
North Carolina,Midland,3499,632,1679,203,55,181,2750
North Carolina,Butner,7699,2320,2453,941,187,311,6212
North Carolina,Eastover,3697,790,1554,320,116,247,3027
North Carolina,Midway,4815,1036,2085,310,205,396,4032
North Carolina,Altamahaw,335,100,186,20,0,0,306
North Carolina,Bear Grass,86,14,40,8,0,8,70
North Carolina,Havelock,20330,6127,7308,1285,544,491,15755
North Carolina,Dover,233,68,88,27,0,23,206
North Carolina,Maggie Valley,1654,227,870,183,19,108,1407
North Carolina,Faith,830,126,347,80,19,80,652
North Carolina,Ellerbe,862,255,288,83,11,52,689
North Carolina,Shannon,331,75,66,0,25,9,175
North Carolina,Bethel,1753,506,641,120,51,171,1489
North Carolina,Rose Hill,2547,816,567,144,97,186,1810
North Carolina,Beulaville,1513,315,496,185,80,203,1279
North Carolina,Ashley Heights,484,99,172,65,0,13,349
North Carolina,Brogden,2337,579,761,285,116,198,1939
North Carolina,Raleigh,457159,160310,151543,39955,9304,14659,375771
North Carolina,New London,683,121,329,90,13,26,579
North Carolina,Bonnetsville,537,126,237,26,10,12,411
North Carolina,Wendell,6828,1349,2184,922,215,382,5052
North Carolina,Cedar Rock village,251,24,165,11,2,12,214
North Carolina,Weaverville,3887,790,1781,412,39,418,3440
North Carolina,Avery Creek,2307,567,1126,274,0,23,1990
North Carolina,Pink Hill,437,129,153,55,16,20,373
North Carolina,Micro,672,85,240,94,0,69,488
North Carolina,South Weldon,878,211,210,40,0,43,504
North Carolina,Lewisville,13657,2513,6792,837,296,564,11002
North Carolina,Clemmons village,20050,3708,9226,1777,153,935,15799
North Carolina,Stovall,362,70,154,53,19,28,324
North Carolina,Stem,1048,264,535,32,9,27,867
North Carolina,Belhaven,1879,530,619,190,34,186,1559
North Carolina,Weldon,1679,434,556,110,57,181,1338
North Carolina,Glen Raven,3028,721,1187,211,30,119,2268
North Carolina,Randleman,4111,774,1572,484,96,270,3196
North Carolina,Autryville,207,25,118,12,6,19,180
North Carolina,Sharpsburg,2158,553,476,155,95,274,1553
North Carolina,Elm City,1360,463,460,114,7,81,1125
North Carolina,Pikeville,649,194,189,101,22,20,526
North Carolina,Fremont,1196,315,380,158,57,134,1044
North Carolina,Eureka,222,55,69,13,13,29,179
North Carolina,Black Creek,865,222,285,59,20,24,610
North Carolina,Faison,1227,350,345,68,39,51,853
North Carolina,Stoneville,1300,296,611,71,24,40,1042
North Carolina,Sugar Mountain village,570,48,341,36,4,12,441
North Carolina,Spring Lake,12284,3488,4340,878,334,293,9333
North Carolina,Clyde,1129,253,531,86,12,61,943
North Carolina,Tarboro,11045,3525,3532,1037,186,1024,9304
North Carolina,Mount Olive,4731,2022,1103,452,154,363,4094
North Carolina,Harrells,143,12,85,7,8,10,122
North Carolina,Delway,23,0,0,12,0,11,23
North Carolina,Lake Lure,1557,203,950,148,45,69,1415
North Carolina,Hillsborough,7083,1985,2714,773,162,173,5807
North Carolina,Warrenton,1056,322,327,106,53,137,945
North Carolina,Stallings,15240,2758,7568,1038,210,503,12077
North Carolina,Gibson,482,131,127,67,15,51,391
North Carolina,Wilson,49230,15103,14494,5332,1564,2905,39398
North Carolina,Sanford,29274,8040,9637,2622,702,1494,22495
North Carolina,Tabor City,3990,1587,937,510,157,277,3468
North Carolina,Pleasant Garden,4814,675,2072,488,64,773,4072
North Carolina,Bermuda Run,2568,380,1576,216,1,224,2397
North Carolina,Goldston,264,26,136,21,3,14,200
North Carolina,Lake Norman of Catawba,8241,1202,4673,477,108,350,6810
North Carolina,Mount Pleasant,1904,467,827,152,19,78,1543
North Carolina,Fearrington Village,2780,328,1451,299,0,507,2585
North Carolina,Woodfin,6487,1877,2351,657,207,363,5455
North Carolina,Asheville,90531,30199,31271,10182,1333,4392,77377
North Carolina,Mount Gilead,1161,462,396,96,23,70,1047
North Carolina,Webster,444,57,191,56,9,18,331
North Carolina,Cullowhee,6139,5253,321,118,63,17,5772
North Carolina,McAdenville,717,103,363,54,7,57,584
North Carolina,Siler City,8106,1933,2600,630,272,501,5936
North Carolina,Gastonia,75138,19419,26214,8359,1894,4141,60027
North Carolina,Lincolnton,10678,2553,3815,1268,394,684,8714
North Carolina,Flat Rock village,3298,291,2119,342,53,274,3079
North Carolina,Balfour,1406,407,562,114,16,85,1184
North Carolina,Ahoskie,4882,1707,1267,437,157,390,3958
North Carolina,Grover,710,205,275,44,9,52,585
North Carolina,Valdese,4418,888,1892,504,104,307,3695
North Carolina,Glen Alpine,1557,404,829,59,13,42,1347
North Carolina,St. James,5133,154,4589,230,0,52,5025
North Carolina,Carolina Shores,3944,332,2391,381,52,445,3601
North Carolina,Dublin,354,57,143,36,21,20,277
North Carolina,Belmont,11768,2744,4744,1004,226,565,9283
North Carolina,Elizabeth City,17604,5669,5286,1640,274,1104,13973
North Carolina,Hamilton,355,109,120,19,11,43,302
North Carolina,Butters,227,59,67,53,21,27,227
North Carolina,Lake Waccamaw,1622,308,625,136,33,216,1318
North Carolina,Fairplains,2172,500,867,301,34,151,1853
North Carolina,Greenville,91207,41994,22563,6779,2019,3529,76884
North Carolina,Goldsboro,34972,11366,10510,3486,1084,2264,28710
North Carolina,St. Pauls,1925,425,640,183,108,200,1556
North Carolina,Rowland,1119,382,309,108,39,108,946
North Carolina,Hayesville,407,74,128,44,18,46,310
North Carolina,Long View,4949,1107,1747,645,183,276,3958
North Carolina,Gamewell,3959,967,1438,668,132,190,3395
North Carolina,Kinston,20659,6824,6255,1768,684,1656,17187
North Carolina,Cornelius,28649,6391,12697,3318,226,885,23517
North Carolina,Four Oaks,2159,511,730,157,94,144,1636
North Carolina,Wilson's Mills,2552,596,948,85,44,90,1763
North Carolina,Forest City,7167,2450,2008,574,367,506,5905
North Carolina,Gaston,1172,385,291,91,26,162,955
North Carolina,Conway,650,161,209,44,31,16,461
North Carolina,Wrightsboro,5233,1235,1763,843,113,415,4369
North Carolina,Rocky Mount,54982,16602,16499,5328,1931,3567,43927
North Carolina,Nashville,5523,1398,2037,811,157,315,4718
North Carolina,West Jefferson,1485,372,508,226,51,124,1281
North Carolina,Lilesville,445,106,226,27,6,9,374
North Carolina,Red Oak,3411,604,1955,175,0,158,2892
North Carolina,Benson,3651,483,1763,330,120,293,2989
North Carolina,Tryon,1578,313,524,282,20,270,1409
North Carolina,Spencer,3231,848,1126,210,171,229,2584
North Carolina,Locust,3351,574,1464,360,66,282,2746
North Carolina,Tobaccoville village,2617,331,1372,318,35,139,2195
North Carolina,Toast,1410,244,558,217,30,82,1131
North Carolina,Zebulon,5166,1066,1674,414,249,239,3642
North Carolina,Canton,4240,914,1527,513,163,461,3578
North Carolina,Indian Trail,37983,6815,17085,2601,472,1168,28141
North Carolina,JAARS,459,58,236,28,0,9,331
North Carolina,Wesley Chapel village,8633,1792,4491,348,62,216,6909
North Carolina,Waynesville,9898,1635,4235,1115,309,907,8201
North Carolina,Ocracoke,564,3,340,12,51,0,406
North Carolina,Bowmore,62,14,0,14,0,15,43
North Carolina,Kernersville,24088,5559,9305,2758,617,1710,19949
North Carolina,Taylorsville,2278,475,733,287,87,266,1848
North Carolina,Speed,73,11,21,2,12,27,73
North Carolina,Alamance village,1069,156,606,43,10,53,868
North Carolina,Swepsonville,1844,355,851,194,13,100,1513
North Carolina,Peachland,496,118,144,45,13,26,346
North Carolina,Jefferson,1420,359,496,140,58,139,1192
North Carolina,Elk Park,725,147,239,108,25,38,557
North Carolina,Aurora,554,102,203,79,24,82,490
North Carolina,Bath,218,27,132,13,5,28,205
North Carolina,River Road,3352,704,1214,530,181,384,3013
North Carolina,Wilmington,118094,43223,38064,11562,2610,5686,101145
North Carolina,Leggett,42,10,15,5,2,7,39
North Carolina,Wrightsville Beach,2536,936,806,269,36,145,2192
North Carolina,Hookerton,519,126,148,33,59,45,411
North Carolina,Seven Lakes,4404,406,2543,533,51,286,3819
North Carolina,Milton,199,32,78,25,2,22,159
North Carolina,Boiling Springs,4598,1809,1468,270,8,144,3699
North Carolina,Earl,231,30,73,61,12,26,202
North Carolina,Cofield village,375,134,116,39,18,20,327
North Carolina,Maiden,3397,568,1410,263,30,94,2365
North Carolina,Franklinton,2076,463,693,174,83,145,1558
North Carolina,Youngsville,1766,558,549,181,26,35,1349
North Carolina,Cashiers,78,16,23,7,9,23,78
North Carolina,Candor,1097,311,402,39,38,35,825
North Carolina,Marshall,691,158,262,129,20,38,607
North Carolina,Snow Hill,1604,430,535,169,78,109,1321
North Carolina,Carthage,2811,519,847,398,79,279,2122
North Carolina,Fairview,2968,538,1292,222,71,54,2177
North Carolina,Cajah's Mountain,2722,475,1381,200,48,205,2309
North Carolina,Lenoir,17899,4213,6695,1882,468,1328,14586
North Carolina,Westport,4119,503,2341,215,0,169,3228
North Carolina,Marion,7839,2083,2467,966,325,549,6390
North Carolina,Bunn,323,96,101,30,6,28,261
North Carolina,Mount Holly,15305,4019,5748,1589,270,782,12408
North Carolina,Stanley,3643,569,1544,404,116,238,2871
North Carolina,Star,830,192,299,99,26,87,703
North Carolina,Pinebluff,1471,350,569,187,29,60,1195
North Carolina,Black Mountain,8137,1555,3500,993,137,851,7036
North Carolina,Maysville,1038,188,408,148,11,90,845
North Carolina,Garysburg,930,347,184,107,36,101,775
North Carolina,Mayodan,2754,751,882,286,100,222,2241
North Carolina,Rutherford College,1253,305,512,144,46,146,1153
North Carolina,Bogue,670,82,410,30,11,48,581
North Carolina,Emerald Isle,3699,594,2112,340,48,212,3306
North Carolina,Edenton,4734,1497,1205,493,114,541,3850
North Carolina,East Flat Rock,5036,1680,1792,373,151,203,4199
North Carolina,Casar,255,42,106,22,9,14,193
North Carolina,Kingstown,510,146,157,47,49,58,457
North Carolina,Mooresboro,343,85,93,48,5,55,286
North Carolina,Etowah,7420,1214,3846,665,177,490,6392
North Carolina,Mooresville,37165,8780,15285,2599,652,1486,28802
North Carolina,Sunset Beach,3826,435,2549,310,39,260,3593
North Carolina,Pine Level,2132,524,783,197,62,102,1668
North Carolina,Saluda,864,127,423,85,14,94,743
North Carolina,Mebane,15198,3508,6015,1215,359,595,11692
North Carolina,Apex,48254,8663,22284,3459,641,1092,36139
North Carolina,Roper,646,255,64,51,21,37,428
North Carolina,Macon,147,76,41,2,4,16,139
North Carolina,Mount Airy,10227,2161,3525,1260,192,1235,8373
North Carolina,King,6885,1076,2992,874,239,548,5729
North Carolina,Turkey,260,45,118,14,0,24,201
North Carolina,Keener,234,0,75,53,44,33,205
North Carolina,Ruth,531,91,230,59,6,58,444
North Carolina,Lumber Bridge,77,7,43,1,1,13,65
North Carolina,Lasker,169,23,98,12,7,8,148
North Carolina,Oak Island,7612,1118,4310,895,110,499,6932
North Carolina,Askewville,199,31,104,17,1,20,173
North Carolina,Reidsville,13909,3670,4571,1898,367,1117,11623
North Carolina,Raeford,4882,1383,1412,512,229,426,3962
North Carolina,Bethlehem,4052,777,2172,251,115,254,3569
North Carolina,Kure Beach,2271,432,1357,164,30,100,2083
North Carolina,Green Level,2153,695,493,226,84,135,1633
North Carolina,Woodlawn,804,207,428,93,14,13,755
North Carolina,Morven,548,223,77,49,8,71,428
North Carolina,Chocowinity,903,221,253,124,53,91,742
North Carolina,Myrtle Grove,10563,1821,5238,935,55,496,8545
North Carolina,Sea Breeze,1861,285,946,235,72,82,1620
North Carolina,Boiling Spring Lakes,5888,1042,2992,459,176,118,4787
North Carolina,Silver Lake,6330,1613,2559,746,153,136,5207
North Carolina,Granite Quarry,2955,572,1249,240,51,129,2241
North Carolina,Kannapolis,47553,11979,17095,4214,1307,2231,36826
North Carolina,Bostic,296,64,113,53,8,30,268
North Carolina,Clinton,8557,2257,2652,977,349,727,6962
North Carolina,Ingold,597,13,159,14,0,12,198
North Carolina,Highlands,1186,240,569,125,25,111,1070
North Carolina,Newton,13005,3390,4720,1501,324,745,10680
North Carolina,Fairfield Harbour,2887,312,1902,229,30,269,2742
North Carolina,Kitty Hawk,3462,437,1953,264,13,234,2901
North Carolina,Huntersville,54572,9976,25901,3895,482,1489,41743
North Carolina,Jackson,496,153,182,22,24,65,446
North Carolina,Foscoe,1616,402,630,272,0,106,1410
North Carolina,Gatesville,277,32,146,24,0,26,228
North Carolina,Fruitland,2407,448,1107,277,35,97,1964
North Carolina,Salemburg,415,101,149,63,3,45,361
North Carolina,Trent Woods,4081,451,2545,148,41,218,3403
North Carolina,Robersonville,1647,494,538,167,37,142,1378
North Carolina,Brunswick,878,495,98,122,72,52,839
North Carolina,Patterson Springs,882,374,253,59,36,24,746
North Carolina,Morehead City,9304,2260,3609,1204,214,728,8015
North Carolina,Salem,1872,315,856,327,59,147,1704
North Carolina,Cape Carteret,2376,369,1151,172,25,164,1881
North Carolina,Cedar Point,1899,308,981,113,7,111,1520
North Carolina,Lattimore,443,193,162,15,7,16,393
North Carolina,Nags Head,2894,769,1230,282,67,144,2492
North Carolina,Wanchese,1832,370,751,175,18,120,1434
North Carolina,Parmele,249,111,55,23,7,29,225
North Carolina,Colerain,268,76,86,27,12,25,226
North Carolina,Clarkton,739,194,312,48,23,47,624
North Carolina,Tar Heel,228,40,96,9,13,24,182
North Carolina,Connelly Springs,1588,273,762,187,16,121,1359
North Carolina,Beaufort,4314,1289,1502,587,172,416,3966
North Carolina,Newport,4624,937,1747,626,152,399,3861
North Carolina,Yanceyville,2248,914,464,237,55,220,1890
North Carolina,Polkville,527,89,253,50,10,54,456
North Carolina,Roseboro,1249,380,404,125,70,133,1112
North Carolina,Plain View,1657,348,728,191,42,148,1457
North Carolina,Ivanhoe,372,73,43,25,60,18,219
North Carolina,Kenansville,775,177,282,134,3,128,724
North Carolina,Hickory,40402,11197,15102,3489,785,2451,33024
North Carolina,James City,5684,1062,2407,870,91,323,4753
North Carolina,Coats,2368,556,760,226,49,96,1687
North Carolina,Erwin,4956,1285,1696,633,131,356,4101
North Carolina,Jamesville,617,159,181,42,1,40,423
North Carolina,Oak City,272,93,74,33,29,25,254
North Carolina,Williamston,5375,1577,1867,531,194,317,4486
North Carolina,Davidson,12666,3411,5297,953,113,207,9981
North Carolina,Cerro Gordo,176,37,87,6,3,16,149
North Carolina,Chadbourn,2412,759,605,267,155,162,1948
North Carolina,Pinehurst village,15821,1386,9570,1083,214,1544,13797
North Carolina,Red Springs,3419,1206,950,219,120,261,2756
North Carolina,Mountain Home,3851,724,1747,429,109,280,3289
North Carolina,Lowesville,3034,510,1566,328,10,125,2539
North Carolina,Old Fort,900,219,233,114,65,129,760
North Carolina,West Marion,1403,205,464,280,28,142,1119
North Carolina,Oak Ridge,6829,876,3416,437,107,391,5227
North Carolina,Sedalia,513,139,197,69,3,56,464
North Carolina,Bladenboro,1934,468,565,158,55,189,1435
North Carolina,Burlington,52524,14669,17380,5737,1545,3517,42848
North Carolina,Lake Junaluska,3057,496,1308,489,36,423,2752
North Carolina,Rockfish,3619,858,1648,217,29,80,2832
North Carolina,Harrellsville,116,19,48,11,2,5,85
North Carolina,Fletcher,7952,1711,3382,754,122,500,6469
North Carolina,Bessemer City,5438,1553,1980,575,169,312,4589
North Carolina,Cherryville,5889,1325,2320,600,86,487,4818
North Carolina,Enochville,2990,790,1280,220,69,182,2541
North Carolina,Landis,3092,388,1306,246,96,375,2411
North Carolina,Rutherfordton,4044,686,1339,887,138,431,3481
North Carolina,Sims,510,80,192,51,13,14,350
North Carolina,Fountain,341,87,88,48,14,42,279
North Carolina,Hertford,2336,596,745,204,72,246,1863
North Carolina,Elrod,656,207,185,33,14,42,481
North Carolina,Pembroke,3044,1503,433,239,62,188,2425
North Carolina,Burnsville,1990,367,891,243,42,178,1721
North Carolina,Moravian Falls,1997,418,1034,304,17,18,1791
North Carolina,Seaboard,736,251,149,35,24,86,545
North Carolina,Richlands,2524,402,959,212,5,89,1667
North Carolina,Fair Bluff,594,195,178,73,19,92,557
North Carolina,Fayetteville,209867,64134,69435,19215,6319,9044,168147
North Carolina,Hope Mills,15762,3692,5546,1532,487,653,11910
North Carolina,Cooleemee,948,248,338,65,39,56,746
North Carolina,Stony Point,2301,934,601,304,36,46,1921
North Carolina,La Grange,2702,759,812,260,102,384,2317
North Carolina,Kelford,430,156,68,26,6,19,275
North Carolina,Middleburg,119,39,20,9,3,25,96
North Carolina,Graham,14670,3692,4741,1631,349,908,11321
North Carolina,Haw River,2516,626,850,305,50,141,1972
North Carolina,Alliance,734,141,269,86,26,88,610
North Carolina,Catawba,512,76,196,75,30,58,435
North Carolina,Murraysville,15831,3626,6515,1787,245,602,12775
North Carolina,Momeyer,279,60,104,19,9,35,227
North Carolina,Whispering Pines village,3221,345,1667,156,0,161,2329
North Carolina,Forest Oaks,3683,683,2011,273,26,173,3166
North Carolina,McLeansville,897,154,414,111,0,83,762
North Carolina,Claremont,1609,320,747,153,15,72,1307
North Carolina,Conover,8300,2002,3219,835,192,434,6682
North Carolina,Bridgeton,275,57,106,47,4,32,246
North Carolina,New Bern,29958,7164,11311,3174,596,2125,24370
North Carolina,River Bend,3065,435,1777,310,32,213,2767
North Carolina,Vanceboro,1291,287,349,110,28,52,826
North Carolina,Manteo,1852,296,747,285,37,139,1504
North Carolina,Whitakers,921,242,235,99,46,89,711
North Carolina,Angier,5376,951,2370,438,76,232,4067
North Carolina,Spruce Pine,2204,384,808,328,75,186,1781
North Carolina,Pineville,8574,2578,2439,855,165,699,6736
North Carolina,Spring Hope,1603,471,414,183,60,152,1280
North Carolina,Welcome,4274,725,2189,272,65,250,3501
North Carolina,Princeville,2357,857,589,221,44,152,1863
North Carolina,Magnolia,1252,339,310,84,68,70,871
North Carolina,Sparta,1851,402,600,266,63,178,1509
North Carolina,Wadesboro,5351,1950,1581,350,237,294,4412
North Carolina,Crossnore,174,66,53,6,0,2,127
North Carolina,Washington Park,584,125,303,49,7,37,521
North Carolina,Bakersville,468,103,161,37,21,59,381
North Carolina,Ansonville,735,301,121,109,8,102,641
North Carolina,Boardman,273,88,66,26,23,22,225
North Carolina,Biscoe,2490,606,866,77,0,101,1650
North Carolina,Rhodhiss,1009,320,300,132,43,60,855
North Carolina,Stantonsburg,683,182,237,86,23,59,587
North Carolina,East Bend,602,120,307,24,8,33,492
North Carolina,Hays,1304,166,808,56,0,113,1143
North Carolina,Jacksonville,73226,26967,24686,4065,1943,1664,59325
North Carolina,Bayboro,1213,479,224,256,62,91,1112
North Carolina,Stonewall,279,78,77,40,10,25,230
North Carolina,Burgaw,4057,1434,1071,431,115,422,3473
North Carolina,Sandyfield,371,101,122,24,12,18,277
North Carolina,Linden,126,19,51,4,6,11,91
North Carolina,Harmony,592,129,177,68,28,52,454
North Carolina,Rural Hall,3137,666,1209,329,167,168,2539
North Carolina,Statesville,26263,7723,8364,2630,791,1437,20945
North Carolina,Gibsonville,7024,1428,3083,533,92,222,5358
North Carolina,Aulander,831,187,231,88,67,35,608
North Carolina,Lewiston Woodville,808,247,239,20,14,20,540
North Carolina,Elizabethtown,3525,1047,1044,379,226,250,2946
North Carolina,Swannanoa,4288,1376,1664,431,100,165,3736
North Carolina,Pittsboro,4098,1072,1423,440,64,406,3405
North Carolina,Brookford,483,124,164,69,13,52,422
North Carolina,Brices Creek,4078,655,2109,140,82,51,3037
North Carolina,Royal Pines,4921,855,2269,501,38,315,3978
North Carolina,Vass,658,165,215,38,7,52,477
North Carolina,Southern Pines,13694,3238,5123,1601,240,1316,11518
North Carolina,Yadkinville,2908,519,1025,281,44,410,2279
North Carolina,Wagram,777,241,253,63,24,73,654
North Carolina,Lansing,182,59,58,10,0,8,135
North Carolina,Pantego,211,17,99,16,8,14,154
North Carolina,Bryson City,1709,298,688,173,57,149,1365
North Carolina,Fuquay-Varina,25932,4240,11815,1720,537,879,19191
North Carolina,Franklinville,1106,311,362,127,36,46,882
North Carolina,White Plains,1150,216,585,102,39,77,1019
North Carolina,Norwood,2800,780,982,209,49,158,2178
North Carolina,Stanfield,1498,242,810,74,48,38,1212
North Carolina,Hemby Bridge,2044,485,907,122,29,65,1608
North Carolina,Neuse Forest,1377,77,771,108,25,137,1118
North Carolina,Marshville,2644,792,863,232,66,160,2113
North Carolina,Unionville,6826,1203,3692,434,92,333,5754
North Carolina,Kittrell,199,39,56,26,2,11,134
North Carolina,Seagrove,348,48,150,44,7,10,259
North Carolina,Thomasville,26839,5692,9687,3189,737,1884,21189
North Carolina,Foxfire village,1189,204,627,88,24,69,1012
North Carolina,Everetts,139,44,20,28,10,8,110
North Carolina,Mountain View,3715,726,1923,404,33,69,3155
North Carolina,Sylva,2672,851,713,287,46,222,2119
North Carolina,Hot Springs,603,186,201,84,14,33,518
North Carolina,Cameron,390,61,168,14,5,42,290
North Carolina,Mineral Springs,2956,664,1399,261,52,124,2500
North Carolina,Southern Shores,2850,337,1781,141,20,150,2429
North Carolina,Lillington,3509,1520,729,514,88,313,3164
North Carolina,Hassell,24,0,19,3,0,2,24
North Carolina,Castle Hayne,1023,99,362,234,68,74,837
North Carolina,Rich Square,898,206,233,157,44,173,813
North Carolina,Eden,15121,3728,5300,1632,778,1088,12526
North Carolina,Cleveland,1163,277,449,89,23,40,878
North Carolina,Broadway,1416,336,577,177,35,118,1243
North Carolina,Greenevers,742,279,186,42,66,78,651
North Carolina,Light Oak,1274,376,313,225,0,167,1081
North Carolina,White Oak,260,16,78,62,0,19,175
North Carolina,Holden Beach,1012,112,632,85,3,45,877
North Carolina,Leland,19157,2673,10280,1756,169,814,15692
North Carolina,China Grove,4177,928,1731,387,176,229,3451
North Carolina,Atlantic Beach,1736,369,704,256,76,190,1595
North Carolina,Shelby,20053,5109,6206,2237,968,1608,16128
North Carolina,Waco,300,66,155,8,11,21,261
North Carolina,Gorman,906,255,239,71,33,72,670
North Carolina,Como,111,42,43,2,4,6,97
North Carolina,Murfreesboro,3069,1304,877,160,103,171,2615
North Carolina,Winton,849,233,219,100,43,57,652
North Carolina,Laurel Park,2883,491,1556,332,14,171,2564
North Carolina,Louisburg,3490,1474,835,320,48,377,3054
North Carolina,Robbinsville,656,114,128,140,105,67,554
North Carolina,Forest Hills village,273,117,102,18,2,11,250
North Carolina,Hildebran,2052,428,825,207,80,112,1652
North Carolina,Troy,3348,1201,782,415,147,237,2782
North Carolina,Newland,856,247,302,78,3,53,683
North Carolina,Harkers Island,1361,260,608,146,10,142,1166
North Carolina,Franklin,3943,891,1293,666,71,342,3263
North Carolina,Charlotte,841611,270992,286656,68550,18299,27711,672208
North Carolina,Trenton,408,112,95,32,10,28,277
North Carolina,Harrisburg,15269,3495,6790,773,305,380,11743
North Carolina,Northlakes,1586,185,823,240,16,25,1289
North Carolina,Mesic,203,33,85,26,6,21,171
North Carolina,Millers Creek,1661,261,809,245,61,139,1515
North Carolina,Boone,18795,14043,2178,757,338,664,17980
North Carolina,Seven Devils,304,59,186,23,2,22,292
North Carolina,Vander,1218,272,518,73,20,122,1005
North Carolina,Grandfather village,84,13,66,1,0,2,82
North Carolina,Wade,729,143,253,73,17,46,532
North Carolina,Hobgood,395,163,98,18,16,27,322
North Carolina,Love Valley,97,9,54,18,2,13,96
North Carolina,Troutman,2634,695,981,260,16,132,2084
North Carolina,Drexel,1789,454,550,232,66,206,1508
North Carolina,Badin,2036,689,579,299,110,132,1809
North Carolina,Dundarrach,36,0,36,0,0,0,36
North Carolina,East Arcadia,622,174,197,56,29,25,481
North Carolina,Calabash,1680,340,722,182,9,201,1454
North Carolina,Sandy Creek,224,38,118,34,8,9,207
North Carolina,Icard,2468,651,786,407,81,184,2109
North Carolina,Winston-Salem,242125,77325,78579,21026,5673,11463,194066
North Carolina,Frisco,145,52,86,0,0,7,145
North Carolina,Winterville,9546,1833,4168,878,91,453,7423
North Carolina,Elkin,4179,782,1673,324,163,251,3193
North Carolina,Pinnacle,1010,135,442,24,2,16,619
North Carolina,Porters Neck,7802,1072,4649,286,77,603,6687
North Carolina,Potters Hill,632,88,141,144,33,0,406
North Carolina,Riegelwood,712,251,216,46,0,33,546
North Carolina,Robbins,1743,491,560,121,21,71,1264
North Carolina,Rocky Point,1772,324,795,51,104,45,1319
North Carolina,Rodanthe,125,23,86,0,0,16,125
North Carolina,Rougemont,695,68,397,75,10,32,582
North Carolina,Ruffin,359,29,166,59,22,24,300
North Carolina,Salvo,70,10,60,0,0,0,70
North Carolina,Scotch Meadows,419,44,261,29,15,13,362
North Carolina,South Mills,499,49,145,130,0,39,363
North Carolina,Southmont,978,170,581,75,0,30,856
North Carolina,Spivey's Corner,511,118,262,28,0,14,422
North Carolina,Stokes,716,229,266,21,0,109,625
North Carolina,Sunbury,224,50,119,29,0,13,211
North Carolina,Swan Quarter,474,210,165,26,0,29,430
North Carolina,Tyro,3903,618,1931,316,95,129,3089
North Carolina,Valle Crucis,223,27,119,21,0,9,176
North Carolina,Wakulla,90,0,34,0,0,0,34
North Carolina,Waves,54,17,27,10,0,0,54
North Carolina,Centerville,345,57,161,18,0,28,264
North Carolina,High Shoals,675,185,257,73,5,51,571
North Carolina,Fontana Dam,10,0,6,4,0,0,10
North Carolina,Valley Hill,2148,502,1049,283,20,56,1910
North Carolina,East Laurinburg,295,79,87,19,17,24,226
North Carolina,Varnamtown,476,86,223,57,16,42,424
North Carolina,Pinetown,110,10,67,0,9,24,110
North Carolina,Southport,3585,635,1577,419,39,351,3021
North Carolina,Old Hundred,420,166,66,45,0,27,304
North Carolina,Moncure,732,125,352,84,0,54,615
North Carolina,Germanton,967,151,386,173,0,86,796
North Carolina,Gerton,293,108,139,35,0,0,282
North Carolina,Glenville,61,0,33,4,0,24,61
North Carolina,Gloucester,514,147,192,49,24,30,442
North Carolina,Gulf,336,98,200,0,0,0,298
North Carolina,Hallsboro,391,68,271,21,18,13,391
North Carolina,Hampstead,5717,895,2485,600,168,339,4487
North Carolina,Hatteras,511,109,324,0,0,68,501
North Carolina,Henrietta,387,68,117,44,0,14,243
North Carolina,Hiddenite,388,130,218,0,13,0,361
North Carolina,Hobucken,99,14,29,0,0,22,65
North Carolina,Hollister,740,201,218,71,15,62,567
North Carolina,Hoopers Creek,984,137,550,126,7,47,867
North Carolina,Horse Shoe,2362,381,1369,216,0,89,2055
North Carolina,Iron Station,743,200,219,118,0,97,634
North Carolina,Jackson Heights,739,160,331,128,0,92,711
North Carolina,Lake Royale,2884,768,1073,345,135,172,2493
North Carolina,Lake Santeetlah,51,0,46,2,0,0,48
North Carolina,Laurel Hill,1096,322,432,108,11,97,970
North Carolina,Lowgap,415,171,134,39,0,44,388
North Carolina,Mamers,1016,214,489,55,0,0,758
North Carolina,Manns Harbor,907,202,468,40,50,14,774
North Carolina,Marble,362,95,83,81,0,7,266
North Carolina,Marshallberg,326,77,182,19,0,23,301
North Carolina,Maury,1349,639,203,289,69,62,1262
North Carolina,Northchase,3678,879,1440,505,142,124,3090
North Carolina,Millingport,426,50,226,29,25,34,364
North Carolina,Moyock,3717,596,1901,236,79,79,2891
North Carolina,Northwest,922,315,355,82,19,54,825
North Carolina,Morrisville,25007,4683,11816,1386,300,596,18781
North Carolina,Bald Head Island village,234,4,201,11,0,18,234
North Carolina,Peletier,821,217,271,104,36,41,669
North Carolina,Pine Knoll Shores,1368,116,889,94,8,131,1238
North Carolina,Lawndale,807,210,296,119,51,26,702
North Carolina,Caswell Beach,430,38,322,14,11,29,414
North Carolina,Cramerton,4312,842,1798,396,93,274,3403
North Carolina,Dallas,4650,1139,1683,485,133,362,3802
North Carolina,Kings Mountain,10955,2472,3333,1378,227,809,8219
North Carolina,Watha,178,34,93,28,1,15,171
North Carolina,Lowell,3612,1083,1253,372,117,240,3065
North Carolina,Ranlo,3556,792,1400,326,71,177,2766
North Carolina,Spencer Mountain,0,0,0,0,0,0,0
North Carolina,Mars Hill,2746,1408,663,229,17,90,2407
North Carolina,Aberdeen,7419,1222,3009,892,185,295,5603
North Carolina,Taylortown,782,290,232,75,1,84,682
North Carolina,Parkton,507,100,210,49,9,25,393
North Carolina,Simpson village,428,124,200,26,9,26,385
North Carolina,Pumpkin Center,1708,430,857,105,88,95,1575
North Carolina,Topsail Beach,376,48,246,30,4,16,344
North Carolina,Swansboro,3145,901,1175,283,17,154,2530
North Carolina,St. Helena village,388,69,196,44,10,16,335
North Carolina,Oriental,996,155,510,89,12,119,885
North Carolina,Wallace,3922,937,1155,649,193,320,3254
North Carolina,Dobbins Heights,928,347,212,87,31,54,731
North Carolina,White Lake,1072,194,522,96,19,67,898
North Carolina,Blowing Rock,1202,183,717,172,8,33,1113
North Carolina,Arapahoe,524,73,262,52,13,32,432
North Carolina,Vandemere,271,111,68,17,18,25,239
North Carolina,Indian Beach,199,19,128,22,14,13,196
North Carolina,Shallotte,3961,593,1854,383,110,359,3299
North Carolina,Andrews,1830,258,721,235,73,113,1400
North Carolina,Navassa,1677,557,427,247,96,96,1423
North Carolina,Windsor,3523,1382,997,390,156,265,3190
North Carolina,Rockingham,8994,2543,2962,729,284,896,7414
North Carolina,Ellenboro,695,181,249,95,11,58,594
North Carolina,Danbury,191,67,72,32,7,6,184
North Carolina,Maxton,2494,949,599,190,82,175,1995
North Carolina,Oakboro,1872,349,897,124,26,115,1511
North Carolina,Walnut Cove,1599,409,610,149,48,187,1403
North Carolina,Lake Park village,3753,848,1641,428,122,189,3228
North Carolina,Ocean Isle Beach,705,22,527,56,13,35,653
North Carolina,Monroe,34679,9519,12039,2792,1184,1499,27033
North Carolina,Waxhaw,14383,2653,6561,705,161,409,10489
North Carolina,Weddington,10574,1470,6144,336,44,274,8268
North Carolina,Asheboro,25859,6624,8618,2464,866,1869,20441
North Carolina,High Point,111035,32065,37449,10437,3211,5343,88505
North Carolina,Marvin village,6298,925,3290,124,10,111,4460
North Carolina,Rosman,487,137,133,84,22,35,411
North Carolina,Staley,297,62,136,41,1,8,248
North Carolina,Grifton,2863,701,1045,198,83,189,2216
North Carolina,Bolivia,257,61,86,38,0,7,192
North Carolina,Kelly,373,20,207,14,0,0,241
North Carolina,Roxobel,375,104,121,46,1,29,301
North Carolina,Powellsville,249,73,96,19,7,26,221
North Carolina,Grimesland,483,113,214,32,14,36,409
North Carolina,Columbus,1094,206,432,142,12,99,891
North Carolina,Winfall,653,152,230,50,28,52,512
North Carolina,Wake Forest,40159,8115,17592,2339,786,1228,30060
North Carolina,Garner,28731,7414,11682,2585,550,1093,23324
North Carolina,Plymouth,3542,993,807,303,219,387,2709
North Carolina,Lumberton,21198,6468,5832,2064,573,1491,16428
North Dakota,Ross,97,45,19,5,0,1,70
North Dakota,Hebron,868,94,495,45,2,47,683
North Dakota,Flasher,369,64,179,29,2,7,281
North Dakota,LaMoure,762,161,381,32,0,54,628
North Dakota,Medora,138,41,74,14,0,4,133
North Dakota,Dazey,60,21,27,8,0,3,59
North Dakota,New Leipzig,199,21,133,17,0,16,187
North Dakota,Drake,429,96,150,28,0,29,303
North Dakota,Palermo,164,54,55,19,0,11,139
North Dakota,Dickey,38,12,14,2,0,0,28
North Dakota,Wyndmere,478,45,231,35,9,38,358
North Dakota,Crystal,109,28,45,15,0,9,97
North Dakota,St. Thomas,322,70,129,27,2,36,264
North Dakota,Walhalla,1035,299,422,64,0,82,867
North Dakota,Barton,0,0,0,0,0,0,0
North Dakota,Blanchard,6,0,6,0,0,0,6
North Dakota,Brooktree Park,106,26,62,0,0,0,88
North Dakota,Caledonia,33,0,33,0,0,0,33
North Dakota,Dahlen,46,14,8,11,0,0,33
North Dakota,De Lamere,27,0,16,0,0,0,16
North Dakota,Denhoff,25,0,14,2,0,3,19
North Dakota,Driscoll,78,16,25,9,0,8,58
North Dakota,East Fairview,52,19,17,0,0,5,41
North Dakota,Embden,27,0,22,0,0,0,22
North Dakota,Englevale,198,62,67,12,0,0,141
North Dakota,Foxholm,22,4,4,5,4,0,17
North Dakota,Green Acres,529,134,105,21,0,27,287
North Dakota,Harmon,257,12,181,0,0,0,193
North Dakota,Heil,16,0,16,0,0,0,16
North Dakota,Heimdal,7,0,7,0,0,0,7
North Dakota,Jessie,39,8,13,0,0,0,21
North Dakota,Ypsilanti,58,22,0,29,0,7,58
North Dakota,Sutton,6,0,0,3,0,3,6
North Dakota,Selz,25,13,0,12,0,0,25
North Dakota,Ruthville,147,30,46,35,0,9,120
North Dakota,Raleigh,12,3,7,0,0,2,12
North Dakota,Spiritwood,7,0,7,0,0,0,7
North Dakota,Auburn,19,0,10,6,0,0,16
North Dakota,Porcupine,263,75,41,0,5,0,121
North Dakota,Nash,47,12,35,0,0,0,47
North Dakota,Menoken,70,14,37,3,0,2,56
North Dakota,Manning,85,32,33,10,0,0,75
North Dakota,McLeod,5,0,0,0,0,5,5
North Dakota,Logan,239,13,126,13,0,0,152
North Dakota,Larson,12,4,0,8,0,0,12
North Dakota,Orrin,0,0,0,0,0,0,0
North Dakota,Glenburn,479,90,188,41,13,6,338
North Dakota,Gascoyne,12,4,5,1,0,2,12
North Dakota,Anamoose,257,33,141,24,0,19,217
North Dakota,Newburg,79,9,27,8,0,18,62
North Dakota,Sherwood,198,44,98,12,0,7,161
North Dakota,Wolford,36,7,23,2,0,0,32
North Dakota,Loma,11,2,4,3,0,2,11
North Dakota,Nekoma,29,3,26,0,0,0,29
North Dakota,Ambrose,11,0,4,7,0,0,11
North Dakota,Karlsruhe,65,19,24,8,0,10,61
North Dakota,Upham,158,35,76,17,0,10,138
North Dakota,Bucyrus,10,3,2,0,0,5,10
North Dakota,Parshall,1116,351,326,97,43,50,867
North Dakota,Crosby,1056,261,492,111,0,121,985
North Dakota,Almont,117,19,52,9,1,5,86
North Dakota,New Salem,962,108,576,45,6,123,858
North Dakota,Plaza,200,52,81,7,2,8,150
North Dakota,Bathgate,66,20,23,16,0,1,60
North Dakota,Langdon,1867,307,945,94,0,169,1515
North Dakota,Turtle Lake,550,157,200,50,8,66,481
North Dakota,Tappen,281,66,116,14,8,13,217
North Dakota,Bottineau,2199,542,917,160,12,215,1846
North Dakota,Stanley,2594,788,1000,148,1,105,2042
North Dakota,Killdeer,894,116,385,108,0,74,683
North Dakota,Dunn Center,258,70,82,14,0,24,190
North Dakota,Buchanan,73,17,40,0,0,0,57
North Dakota,Voltaire,35,4,12,15,0,0,31
North Dakota,Great Bend,62,7,38,4,0,3,52
North Dakota,Hope,308,41,188,7,0,39,275
North Dakota,Shell Valley,1300,401,254,60,21,35,771
North Dakota,Rolette,876,294,200,56,8,39,597
North Dakota,Mapleton,992,161,484,38,10,13,706
North Dakota,Gladstone,373,62,140,9,0,4,215
North Dakota,Forbes,52,0,32,0,0,0,32
North Dakota,Cleveland,88,23,47,5,0,3,78
North Dakota,Pembina,504,57,295,35,1,30,418
North Dakota,Pillsbury,14,0,11,3,0,0,14
North Dakota,Halliday,379,56,133,38,0,23,250
North Dakota,Tolna,175,46,89,17,1,19,172
North Dakota,Grafton,4192,1156,1514,314,19,318,3321
North Dakota,Esmond,83,24,16,18,0,13,71
North Dakota,Oberon,122,30,31,3,2,8,74
North Dakota,Oakes,2042,354,996,100,3,135,1588
North Dakota,Braddock,12,2,8,0,0,0,10
North Dakota,Columbus,127,6,53,2,0,16,77
North Dakota,Minnewaukan,228,38,119,10,6,6,179
North Dakota,Calvin,8,0,6,0,0,0,6
North Dakota,Forman,503,123,187,61,2,42,415
North Dakota,Alamo,44,6,18,5,0,1,30
North Dakota,Tioga,1121,189,518,92,0,85,884
North Dakota,Gwinner,1081,203,535,63,7,39,847
North Dakota,Wildrose,60,17,18,14,0,2,51
North Dakota,Aneta,278,119,64,36,0,27,246
North Dakota,Michigan City,190,28,100,31,2,12,173
North Dakota,Osnabrock,158,39,69,22,0,11,141
North Dakota,Maddock,401,67,184,56,7,24,338
North Dakota,Lakota,708,92,366,66,3,27,554
North Dakota,Amidon,20,0,19,0,0,1,20
North Dakota,Riverdale,221,15,150,36,1,4,206
North Dakota,Hampden,22,0,12,3,0,7,22
North Dakota,Sawyer,325,67,163,36,0,14,280
North Dakota,Cando,1110,213,540,70,15,89,927
North Dakota,Gardena,26,6,5,7,0,1,19
North Dakota,Landa,55,9,22,13,0,8,52
North Dakota,Willow City,184,51,70,28,1,16,166
North Dakota,Marmarth,124,35,20,15,6,23,99
North Dakota,Benedict,77,25,38,5,0,0,68
North Dakota,Hatton,736,129,365,63,3,51,611
North Dakota,Wing,128,26,55,9,0,7,97
North Dakota,Buxton,426,50,243,29,0,4,326
North Dakota,Grandin,211,20,130,4,0,1,155
North Dakota,Portland,637,170,294,14,12,27,517
North Dakota,Wahpeton,7792,2833,2795,606,8,410,6652
North Dakota,Walcott,253,40,122,12,2,12,188
North Dakota,Ruso,8,2,2,0,0,0,4
North Dakota,Casselton,2508,332,1154,159,0,110,1755
North Dakota,Wilton,948,217,418,84,2,38,759
North Dakota,Richardton,766,139,335,72,7,53,606
North Dakota,Hunter,217,47,111,22,2,5,187
North Dakota,Kenmare,922,187,433,92,3,91,806
North Dakota,Sykeston,96,3,53,3,0,14,73
North Dakota,Surrey,1043,141,509,80,1,77,808
North Dakota,McHenry,76,18,27,4,0,6,55
North Dakota,Mott,763,116,314,78,9,99,616
North Dakota,Emerado,370,136,111,33,14,19,313
North Dakota,Erie,49,4,30,5,0,0,39
North Dakota,Munich,292,58,132,6,0,22,218
North Dakota,Max,355,39,198,23,3,18,281
North Dakota,Washburn,1509,237,816,84,8,55,1200
North Dakota,Fort Totten,1311,517,116,61,9,37,740
North Dakota,York,26,12,11,3,0,0,26
North Dakota,Ardoch,49,8,37,3,0,1,49
North Dakota,Minto,783,52,406,64,16,17,555
North Dakota,Strasburg,349,63,141,48,4,60,316
North Dakota,South Heart,304,40,134,62,6,13,255
North Dakota,Dickinson,22707,6059,8715,1869,211,1096,17950
North Dakota,Buffalo,226,22,90,34,4,17,167
North Dakota,Hazelton,267,36,129,6,0,16,187
North Dakota,Taylor,223,40,91,24,0,10,165
North Dakota,Ludden,36,4,23,4,0,0,31
North Dakota,Crary,78,23,34,5,0,3,65
North Dakota,Devils Lake,7317,2001,2709,711,21,579,6021
North Dakota,Lincoln,3594,584,1587,247,0,50,2468
North Dakota,Mayville,1813,608,611,142,6,167,1534
North Dakota,Reynolds,306,72,152,20,2,18,264
North Dakota,Hannaford,102,13,50,20,1,14,98
North Dakota,Amenia,91,6,58,1,0,2,67
North Dakota,Fordville,220,47,91,17,0,13,168
North Dakota,Forest River,102,13,77,4,0,3,97
North Dakota,Lankin,93,17,54,6,0,5,82
North Dakota,Martin,66,15,35,3,0,6,59
North Dakota,Coleharbor,63,7,36,8,7,5,63
North Dakota,White Shield,243,73,70,19,2,14,178
North Dakota,Monango,47,8,20,6,0,0,34
North Dakota,Briarwood,47,15,25,1,1,1,43
North Dakota,Bowdon,168,17,102,18,1,20,158
North Dakota,Clifford,25,5,16,3,0,1,25
North Dakota,McVille,323,50,148,34,5,39,276
North Dakota,Hannah,14,7,4,0,0,0,11
North Dakota,Fingal,121,21,57,17,0,4,99
North Dakota,Leal,15,2,10,0,0,3,15
North Dakota,Rutland,140,31,63,20,0,16,130
North Dakota,Elgin,643,124,282,57,4,87,554
North Dakota,Carson,239,66,98,20,1,26,211
North Dakota,Barney,53,5,17,9,0,12,43
North Dakota,Rugby,2677,536,1162,353,28,210,2289
North Dakota,Dwight,99,16,52,4,0,2,74
North Dakota,Belfield,975,199,397,92,9,35,732
North Dakota,Luverne,38,2,14,4,5,0,25
North Dakota,Butte,91,7,60,3,0,6,76
North Dakota,Garrison,1537,283,660,158,0,145,1246
North Dakota,Mercer,43,2,27,4,0,7,40
North Dakota,Underwood,803,128,442,40,10,43,663
North Dakota,Milton,71,5,56,5,0,0,66
North Dakota,Fredonia,34,10,20,1,0,2,33
North Dakota,Epping,72,18,33,9,0,0,60
North Dakota,Westhope,341,42,193,44,0,19,298
North Dakota,Neche,361,84,159,15,1,25,284
North Dakota,Grenora,208,23,77,16,0,9,125
North Dakota,Dawson,39,5,17,14,0,3,39
North Dakota,Pettibone,91,11,57,5,0,6,79
North Dakota,Tuttle,86,21,42,8,0,6,77
North Dakota,Deering,114,43,43,3,0,5,94
North Dakota,Towner,571,134,258,46,0,35,473
North Dakota,Rhame,265,46,152,7,0,5,210
North Dakota,Souris,63,15,19,13,0,8,55
North Dakota,Kathryn,59,3,20,17,2,10,52
North Dakota,Sibley,46,19,6,9,0,2,36
North Dakota,Colfax,180,27,99,4,0,2,132
North Dakota,Mooreton,199,54,85,17,2,11,169
North Dakota,Kensal,250,87,80,17,0,14,198
North Dakota,Berlin,42,7,22,0,0,3,32
North Dakota,Marion,122,32,53,12,0,5,102
North Dakota,Mandan,21943,4863,9776,1854,210,1067,17770
North Dakota,Sanborn,169,56,70,7,1,10,144
North Dakota,Conway,17,3,2,2,0,7,14
North Dakota,Wales,41,7,16,1,0,2,26
North Dakota,Milnor,703,104,391,48,0,57,600
North Dakota,New Rockford,1436,351,563,111,21,128,1174
North Dakota,Solen,89,31,22,12,0,8,73
North Dakota,Wimbledon,221,39,112,25,0,5,181
North Dakota,Fortuna,8,3,0,3,0,2,8
North Dakota,Bowman,1552,313,711,76,14,131,1245
North Dakota,Noonan,324,58,94,36,0,14,202
North Dakota,Cavalier,1191,230,560,77,9,111,987
North Dakota,Gackle,312,66,138,29,6,31,270
North Dakota,Mohall,729,177,317,94,0,45,633
North Dakota,Robinson,31,6,12,4,0,5,27
North Dakota,Hettinger,1152,185,554,83,0,115,937
North Dakota,New Town,2495,922,588,263,24,60,1857
North Dakota,Hoople,342,71,153,19,0,11,254
North Dakota,Prairie Rose,53,4,36,2,0,1,43
North Dakota,Sharon,55,6,35,5,0,4,50
North Dakota,Bismarck,71731,18913,28747,6796,361,3736,58553
North Dakota,Oriska,130,24,58,12,0,9,103
North Dakota,Cogswell,71,14,44,8,0,5,71
North Dakota,Lansford,288,59,135,15,1,2,212
North Dakota,Jamestown,15368,4366,5590,1699,112,1043,12810
North Dakota,Ray,479,53,208,64,0,37,362
North Dakota,Williston,26102,7308,10191,1829,155,958,20441
North Dakota,Churchs Ferry,8,0,8,0,0,0,8
North Dakota,Edmore,204,36,86,10,0,41,173
North Dakota,Grano,3,0,3,0,0,0,3
North Dakota,Canton City,24,6,14,1,0,0,21
North Dakota,Hamilton,60,7,33,3,0,4,47
North Dakota,Dodge,145,49,62,1,0,11,123
North Dakota,Horace,2660,385,1504,82,17,47,2035
North Dakota,Brocket,53,14,22,0,0,1,37
North Dakota,Edinburg,171,29,113,8,0,11,161
North Dakota,Davenport,291,40,136,42,0,9,227
North Dakota,Pekin,61,5,37,7,0,1,50
North Dakota,Beulah,3296,516,1665,213,0,235,2629
North Dakota,Minot AFB,5384,1217,2452,96,0,0,3765
North Dakota,Fort Ransom,101,12,52,12,0,8,84
North Dakota,Springbrook,9,7,0,0,0,2,9
North Dakota,Hamberg,22,9,9,4,0,0,22
North Dakota,Kramer,56,6,31,10,1,0,48
North Dakota,Cooperstown,1104,180,489,65,3,145,882
North Dakota,Valley City,6487,1754,2700,652,21,481,5608
North Dakota,Leith,47,0,22,3,0,4,29
North Dakota,Abercrombie,216,54,126,13,0,0,193
North Dakota,Haynes,20,3,13,2,0,2,20
North Dakota,Glen Ullin,791,140,330,97,2,107,676
North Dakota,Reeder,130,29,52,26,0,15,122
North Dakota,Courtenay,58,10,28,5,0,1,44
North Dakota,Hankinson,971,185,380,92,0,85,742
North Dakota,Watford City,6197,1705,2160,511,53,294,4723
North Dakota,White Earth,140,29,30,21,2,0,82
North Dakota,Maxbass,106,48,28,18,0,7,101
North Dakota,Steele,764,136,392,60,1,50,639
North Dakota,Balfour,23,8,12,2,1,0,23
North Dakota,Napoleon,860,170,388,58,7,92,715
North Dakota,Bantry,8,4,3,1,0,0,8
North Dakota,Kief,20,5,11,4,0,0,20
North Dakota,Verona,58,10,36,4,0,5,55
North Dakota,Selfridge,271,71,67,34,0,20,192
North Dakota,Douglas,59,13,33,0,0,2,48
North Dakota,Hazen,2610,398,1475,97,9,109,2088
North Dakota,Frontier,478,97,251,41,0,5,394
North Dakota,Harwood,728,83,428,34,0,7,552
North Dakota,Kindred,846,158,431,25,0,21,635
North Dakota,Reile's Acres,521,59,307,3,0,2,371
North Dakota,Wheatland,37,0,15,0,0,22,37
North Dakota,Carpio,139,22,76,5,2,5,110
North Dakota,Des Lacs,220,36,116,14,1,2,169
North Dakota,St. John,270,70,72,15,13,28,198
North Dakota,Pisek,116,25,34,7,1,12,79
North Dakota,Harvey,1758,239,862,114,0,180,1395
North Dakota,Bisbee,112,23,39,14,0,18,94
North Dakota,Sarles,14,3,4,2,0,0,9
North Dakota,Enderlin,910,202,386,93,2,107,790
North Dakota,Rocklake,104,30,42,15,0,8,95
North Dakota,Finley,452,82,274,42,4,13,415
North Dakota,Oxbow,301,49,180,10,1,0,240
North Dakota,Center,604,71,283,67,27,28,476
North Dakota,Fargo,120209,43282,42074,8683,1036,4546,99621
North Dakota,Bowbells,347,56,190,18,11,10,285
North Dakota,Alsen,52,2,13,1,15,0,31
North Dakota,Granville,255,83,106,23,0,18,230
North Dakota,Tolley,25,1,11,8,5,0,25
North Dakota,Lidgerwood,639,145,261,58,10,74,548
North Dakota,Ashley,604,78,338,40,0,116,572
North Dakota,Arnegard,55,19,14,8,0,9,50
North Dakota,Four Bears Village,426,156,40,59,0,4,259
North Dakota,Velva,1292,244,514,102,0,90,950
North Dakota,Bergen,11,1,9,1,0,0,11
North Dakota,Cannon Ball,945,405,148,60,3,44,660
North Dakota,Nome,52,3,30,1,1,3,38
North Dakota,Rogers,54,15,14,5,0,0,34
North Dakota,Christine,175,28,77,24,0,5,134
North Dakota,Fairmount,377,78,131,45,4,18,276
North Dakota,Mantador,52,21,17,1,0,1,40
North Dakota,Pingree,53,8,24,4,0,5,41
North Dakota,Spiritwood Lake,109,14,75,6,0,8,103
North Dakota,Litchville,205,38,93,5,1,5,142
North Dakota,Lignite,159,61,48,3,0,8,120
North Dakota,Mandaree,606,172,91,48,8,21,340
North Dakota,Wishek,965,173,444,85,0,121,823
North Dakota,Scranton,339,57,177,13,0,16,263
North Dakota,Fort Yates,211,87,36,25,5,7,160
North Dakota,Balta,128,23,45,22,0,6,96
North Dakota,Calio,3,0,0,0,0,3,3
North Dakota,Cayuga,56,2,25,11,0,1,39
North Dakota,Havana,57,6,33,6,0,0,45
North Dakota,Medina,271,52,100,35,0,23,210
North Dakota,Zeeland,89,27,15,15,0,10,67
North Dakota,Montpelier,93,12,47,9,0,5,73
North Dakota,Woodworth,50,17,21,7,0,2,47
North Dakota,Edgeley,516,66,306,30,4,37,443
North Dakota,Jud,75,20,41,5,2,3,71
North Dakota,Kulm,417,63,186,30,0,56,335
North Dakota,Fullerton,59,13,23,11,0,7,54
North Dakota,Sheyenne,197,15,119,21,0,15,170
North Dakota,Lehr,83,16,46,13,0,6,81
North Dakota,Streeter,116,27,47,14,1,12,101
North Dakota,Elliott,22,2,9,5,0,4,20
North Dakota,Drayton,702,62,426,58,7,36,589
North Dakota,Grand Forks AFB,2685,634,1256,33,7,0,1930
North Dakota,Carrington,2020,401,963,142,16,191,1713
North Dakota,Golva,64,4,46,5,0,0,55
North Dakota,Beach,1015,203,460,129,0,71,863
North Dakota,Starkweather,89,15,45,7,0,6,73
North Dakota,Goodrich,96,28,44,7,0,10,89
North Dakota,McClusky,411,86,161,67,2,48,364
North Dakota,Dunseith,678,202,164,69,16,46,497
North Dakota,New England,674,149,255,83,27,52,566
North Dakota,Gardner,90,18,43,6,6,1,74
North Dakota,Knox,25,15,4,0,0,3,22
North Dakota,Leeds,549,142,239,46,0,35,462
North Dakota,Adams,165,70,59,7,0,14,150
North Dakota,Grace City,94,16,28,16,0,4,64
North Dakota,Alice,29,5,11,3,0,2,21
North Dakota,Ayr,11,4,4,3,0,0,11
North Dakota,Thompson,1139,190,531,79,6,22,828
North Dakota,Park River,1489,276,701,80,10,167,1234
North Dakota,Inkster,32,6,19,3,0,3,31
North Dakota,Regent,180,30,80,15,9,9,143
North Dakota,Argusville,521,51,262,26,0,3,342
North Dakota,Northwood,790,124,342,70,8,73,617
North Dakota,Linton,1019,151,552,74,0,128,905
North Dakota,Hague,64,7,31,0,0,10,48
North Dakota,Ellendale,1201,348,558,46,5,108,1065
North Dakota,Powers Lake,316,38,149,13,1,25,226
North Dakota,Flaxton,117,14,45,9,0,1,69
North Dakota,Loraine,13,1,8,4,0,0,13
North Dakota,Galesburg,173,31,69,19,4,12,135
North Dakota,Alexander,316,59,161,3,0,0,223
North Dakota,Overly,16,1,10,5,0,0,16
North Dakota,Perth,6,4,2,0,0,0,6
North Dakota,Portal,141,21,78,9,0,4,112
North Dakota,Hansboro,22,11,6,3,0,0,20
North Dakota,Binford,178,42,57,30,0,17,146
North Dakota,Antler,30,3,11,6,0,3,23
North Dakota,Mountain,66,2,28,18,0,16,64
North Dakota,Venturia,15,4,7,2,0,1,14
North Dakota,Manvel,367,80,147,40,0,3,270
North Dakota,Lawton,15,5,8,0,0,2,15
North Dakota,Egeland,36,6,15,6,0,7,34
North Dakota,Gilby,223,42,103,23,2,7,177
North Dakota,Grand Forks,56556,20705,19488,4521,494,1897,47105
North Dakota,Larimore,1461,355,602,80,16,63,1116
North Dakota,Lisbon,2052,400,861,176,6,207,1650
North Dakota,Niagara,44,5,29,2,0,1,37
North Dakota,Petersburg,168,38,73,13,0,5,129
North Dakota,Arthur,326,45,130,36,3,51,265
North Dakota,Burlington,1477,353,494,187,8,31,1073
North Dakota,Leonard,263,45,117,16,2,22,202
North Dakota,Cathay,29,8,6,11,1,1,27
North Dakota,West Fargo,34419,6899,15787,2283,159,844,25972
North Dakota,Mylo,11,1,7,0,3,0,11
North Dakota,Berthold,459,53,256,40,0,33,382
North Dakota,Makoti,106,17,45,12,0,8,82
North Dakota,Ryder,120,28,46,9,0,7,90
North Dakota,Regan,41,10,13,12,0,0,35
North Dakota,Sentinel Butte,134,21,48,9,2,3,83
North Dakota,Glenfield,124,26,36,12,1,6,81
North Dakota,Hillsboro,1610,291,705,181,0,118,1295
North Dakota,Hurdsfield,36,8,24,0,0,1,33
North Dakota,Zap,157,18,81,13,2,5,119
North Dakota,Rolla,1321,341,374,132,3,105,955
North Dakota,Sheldon,113,10,68,13,1,3,95
North Dakota,Brinsmade,30,5,9,9,0,0,23
North Dakota,East Dunseith,528,181,125,50,5,6,367
North Dakota,Minot,48304,14192,18273,3996,598,2130,39189
North Dakota,Pick City,131,28,56,24,0,14,122
North Dakota,Stanton,337,57,164,40,1,22,284
North Dakota,Warwick,77,15,15,6,2,2,40
North Dakota,Fairdale,35,4,21,3,1,1,30
North Dakota,Tower City,280,33,143,30,0,18,224
North Dakota,Donnybrook,70,8,43,0,0,1,52
North Dakota,Page,269,47,109,21,3,10,190
North Dakota,Belcourt,2038,831,412,181,20,97,1541
North Dakota,North River,59,3,39,2,0,2,46
North Dakota,Fessenden,552,113,183,73,1,40,410
North Dakota,Golden Valley,237,24,131,23,0,22,200
Ohio,Addyston village,1040,299,329,108,23,51,810
Ohio,Gratis village,915,194,430,69,10,35,738
Ohio,Roswell village,226,49,109,28,4,11,201
Ohio,Port Washington village,447,74,210,30,11,30,355
Ohio,Bolivar village,1193,193,551,125,16,115,1000
Ohio,North Robinson village,354,39,153,49,3,61,305
Ohio,West Millgrove village,128,32,27,19,0,19,97
Ohio,Perrysburg,21430,4321,9697,1725,180,951,16874
Ohio,Golf Manor village,3549,1272,1066,316,42,145,2841
Ohio,Finneytown,12689,3725,4737,1103,144,628,10337
Ohio,Mount Gilead village,3428,645,1006,651,123,345,2770
Ohio,Harrisburg village,498,96,213,46,10,36,401
Ohio,Clarksville village,681,137,236,67,11,26,477
Ohio,Marengo village,301,76,83,50,15,20,244
Ohio,Donnelsville village,370,82,159,52,3,11,307
Ohio,South Bloomfield village,2116,474,894,223,29,58,1678
Ohio,Rittman,6541,1456,2669,651,193,357,5326
Ohio,Mount Carmel,5372,1634,1515,646,213,265,4273
Ohio,Chilo village,123,29,71,3,0,5,108
Ohio,Unionville Center village,369,61,223,17,0,17,318
Ohio,Milford Center village,920,209,369,94,5,32,709
Ohio,Akron,198314,70052,55353,23278,4027,10299,163009
Ohio,Glendale village,2228,387,1145,201,14,125,1872
Ohio,Beaver village,471,74,179,70,13,25,361
Ohio,Sycamore village,1031,228,404,131,3,56,822
Ohio,Cygnet village,634,126,228,57,8,35,454
Ohio,Pemberville village,1590,311,713,142,27,52,1245
Ohio,Luckey village,949,117,476,101,2,62,758
Ohio,Hoytville village,357,124,109,35,2,14,284
Ohio,Custar village,200,54,89,11,10,6,170
Ohio,Bradner village,1074,243,415,106,17,44,825
Ohio,Bowling Green,31541,18419,7020,1614,256,957,28266
Ohio,Gibsonburg village,2591,635,879,296,39,129,1978
Ohio,Clyde,6213,1173,2351,830,130,237,4721
Ohio,Sciotodale,1057,121,596,147,0,46,910
Ohio,Martinsville village,492,88,187,46,3,17,341
Ohio,West Milton village,4728,1129,1924,392,55,505,4005
Ohio,Ludlow Falls village,260,60,104,42,7,13,226
Ohio,Franklin Furnace,1582,566,587,137,53,115,1458
Ohio,Fletcher village,468,91,190,43,8,25,357
Ohio,Elida village,2120,443,914,247,2,93,1699
Ohio,Albany village,833,146,342,124,5,63,680
Ohio,Flushing village,875,204,346,88,3,40,681
Ohio,McComb village,1711,348,706,190,4,75,1323
Ohio,Fort Loramie village,1521,323,726,89,8,53,1199
Ohio,Fairfield Beach,1084,174,606,155,0,48,983
Ohio,Troy,25894,6187,9872,3021,387,1258,20725
Ohio,Tipp City,9912,2245,4280,906,98,655,8184
Ohio,Portsmouth,20366,6241,5940,2496,460,1520,16657
Ohio,Rarden village,192,47,103,16,0,12,178
Ohio,Cheviot,8318,2539,2593,853,265,368,6618
Ohio,Blue Ash,12150,2395,5548,973,47,610,9573
Ohio,Reynoldsburg,37644,10051,14163,3744,513,1491,29962
Ohio,Amanda village,827,197,322,95,8,17,639
Ohio,Harrisville village,190,38,81,26,0,15,160
Ohio,Cadiz village,3196,628,1357,365,24,234,2608
Ohio,Leavittsburg,1516,423,498,193,46,92,1252
Ohio,Wilkesville village,178,42,73,22,0,13,150
Ohio,North Lewisburg village,1607,303,576,233,18,95,1225
Ohio,Green Springs village,1376,396,390,172,36,173,1167
Ohio,Bloomville village,1034,271,350,120,28,71,840
Ohio,Woodsfield village,2371,490,962,255,81,207,1995
Ohio,Beallsville village,384,98,130,52,10,32,322
Ohio,Timberlake village,751,165,329,103,7,47,651
Ohio,Gnadenhutten village,1484,289,599,167,6,66,1127
Ohio,Caldwell village,2172,329,746,290,0,295,1660
Ohio,Ottawa Hills village,4436,718,2373,219,0,129,3439
Ohio,Parral village,207,48,74,37,5,18,182
Ohio,Centerburg village,1673,370,593,218,20,159,1360
Ohio,Ballville,2737,360,1514,225,20,130,2249
Ohio,Montezuma village,142,23,52,26,0,16,117
Ohio,Deer Park,5688,1689,2059,600,48,424,4820
Ohio,Leesville village,283,53,161,27,4,11,256
Ohio,Haskins village,1126,212,538,74,4,33,861
Ohio,Evendale village,2859,503,1666,169,13,112,2463
Ohio,North Perry village,701,138,354,49,7,39,587
Ohio,Ottoville village,816,141,378,72,8,47,646
Ohio,Beechwood Trails,3297,537,1772,262,17,133,2721
Ohio,Trenton,12755,2861,5108,1352,141,293,9755
Ohio,Wright-Patterson AFB,2579,1078,776,46,0,31,1931
Ohio,Gilboa village,163,33,62,17,0,3,115
Ohio,North Baltimore village,3316,742,1138,381,173,163,2597
Ohio,Nevada village,841,127,389,72,8,53,649
Ohio,McGuffey village,514,141,179,73,8,26,427
Ohio,Logan Elm Village,1022,226,416,142,1,60,845
Ohio,Walton Hills village,2215,390,1190,247,35,189,2051
Ohio,Wadsworth,23155,4858,10249,2124,291,1233,18755
Ohio,Tiltonsville village,1385,339,532,184,29,106,1190
Ohio,Norwalk,16881,4118,6238,1971,270,1081,13678
Ohio,Quincy village,605,138,203,93,9,34,477
Ohio,Republic village,625,155,237,79,0,31,502
Ohio,Mount Healthy Heights,2796,578,974,224,66,105,1947
Ohio,Churchill,2328,537,933,161,52,192,1875
Ohio,Van Wert,11077,2171,4336,1460,134,696,8797
Ohio,Columbus,867628,314453,254770,86748,14625,30162,700758
Ohio,Mount Blanchard village,466,135,164,43,4,21,367
Ohio,Weston village,1543,379,638,137,41,61,1256
Ohio,Lindsey village,517,92,236,40,1,34,403
Ohio,Fort Recovery village,1487,312,577,94,27,90,1100
Ohio,North Fairfield village,486,116,190,44,8,32,390
Ohio,Burton village,1266,309,488,131,3,156,1087
Ohio,Morrow village,1660,386,651,142,17,79,1275
Ohio,Pandora village,1048,155,514,111,18,47,845
Ohio,Belmore village,106,18,57,14,0,3,92
Ohio,Avon Lake,23777,3960,11725,2307,125,1059,19176
Ohio,Lewisville village,197,52,75,10,8,18,163
Ohio,Summerfield village,224,31,114,37,1,14,197
Ohio,Berkey village,286,72,130,20,9,9,240
Ohio,Benton Ridge village,357,80,136,68,6,12,302
Ohio,Pickerington,20148,4020,8900,1610,177,638,15345
Ohio,Amberley village,3780,644,2087,108,18,146,3003
Ohio,Richwood village,2381,613,844,285,25,149,1916
Ohio,Magnolia village,1006,211,428,78,10,52,779
Ohio,Montpelier village,3960,965,1579,484,77,193,3298
Ohio,Chagrin Falls village,4061,756,1799,548,4,240,3347
Ohio,Rome village,67,15,11,12,0,19,57
Ohio,Junction City village,893,246,175,173,40,25,659
Ohio,Marseilles village,92,15,36,16,0,11,78
Ohio,Crooksville village,2675,653,840,322,93,181,2089
Ohio,Wellsville village,3393,830,1091,398,50,166,2535
Ohio,Venedocia village,142,33,43,6,7,12,101
Ohio,Ohio City village,833,137,370,86,12,36,641
Ohio,Tuscarawas village,1461,304,625,141,13,73,1156
Ohio,Champion Heights,6495,1053,3071,727,14,511,5376
Ohio,South Zanesville village,2253,419,710,388,28,167,1712
Ohio,Avon,22786,3876,10980,1151,122,1058,17187
Ohio,East Sparta village,922,162,420,94,8,64,748
Ohio,Kenwood,7244,1702,2771,658,53,670,5854
Ohio,Chesterhill village,491,106,180,17,1,30,334
Ohio,Smithfield village,787,179,287,82,6,34,588
Ohio,Stockport village,745,235,239,66,4,33,577
Ohio,Caledonia village,774,216,347,85,7,21,676
Ohio,Norton,12047,2389,6024,1065,47,502,10027
Ohio,Limaville village,235,43,78,52,2,10,185
Ohio,Bainbridge,2870,479,1431,142,0,113,2165
Ohio,Bergholz village,745,114,286,71,23,48,542
Ohio,Burgoon village,186,36,70,24,2,12,144
Ohio,Ney village,226,49,93,29,0,10,181
Ohio,Huntsville village,484,108,235,60,10,14,427
Ohio,Bay View village,712,144,301,93,20,48,606
Ohio,Burkettsville village,270,33,146,16,0,11,206
Ohio,Mount Victory village,590,79,278,79,8,15,459
Ohio,Fairport Harbor village,3091,886,932,596,55,214,2683
Ohio,Mogadore village,3645,882,1533,295,6,232,2948
Ohio,Congress village,213,73,34,14,13,4,138
Ohio,Liberty Center village,1234,288,470,167,0,68,993
Ohio,Enon village,2479,444,1231,226,29,152,2082
Ohio,Blakeslee village,52,8,24,6,0,9,47
Ohio,Baltimore village,2982,627,939,435,66,163,2230
Ohio,Alger village,943,196,302,124,45,77,744
Ohio,Hills and Dales village,300,59,175,20,0,11,265
Ohio,Midway village,316,73,137,29,6,29,274
Ohio,London,10139,2579,3431,1386,371,480,8247
Ohio,Wauseon,7531,1627,2953,717,150,461,5908
Ohio,Twinsburg,18915,3846,8435,1725,122,1180,15308
Ohio,Richfield village,3647,769,1787,345,0,201,3102
Ohio,Hudson,22287,3453,12390,1134,50,712,17739
Ohio,South Charleston village,1937,406,721,279,24,83,1513
Ohio,Woodlawn village,3319,1010,998,382,122,243,2755
Ohio,Turpin Hills,5351,1094,2701,372,20,58,4245
Ohio,Lockland village,3459,1167,688,481,88,287,2711
Ohio,Harrison,11521,2054,5037,976,132,466,8665
Ohio,Groesbeck,6656,1605,2745,586,57,455,5448
Ohio,Fruit Hill,3931,774,1524,408,85,66,2857
Ohio,Hamersville village,808,143,369,58,22,28,620
Ohio,Solon,23038,3797,11883,1371,223,1039,18313
Ohio,Bedford Heights,10633,3751,2956,1632,294,798,9431
Ohio,North Olmsted,31888,8052,14270,2696,275,1630,26923
Ohio,Adamsville village,159,38,47,31,1,5,122
Ohio,Obetz village,4740,980,1980,397,132,135,3624
Ohio,Mantua village,1204,427,396,126,23,72,1044
Ohio,Kent,29824,15957,6637,2066,230,1020,25910
Ohio,Ashville village,4143,981,1682,348,18,91,3120
Ohio,Holiday Valley,1390,234,702,161,22,100,1219
Ohio,Middleport village,2137,450,607,432,44,185,1718
Ohio,Whitehall,18874,6069,4983,1813,396,767,14028
Ohio,Riverlea village,541,89,286,33,3,20,431
Ohio,Brice village,85,16,42,13,0,6,77
Ohio,Blacklick Estates,9596,2482,3013,1117,83,442,7137
Ohio,New Washington village,1120,233,433,105,16,75,862
Ohio,Bucyrus,11906,2657,4383,1622,175,1064,9901
Ohio,Beaverdam village,414,76,186,47,3,13,325
Ohio,Nelsonville,4990,2354,1057,524,176,285,4396
Ohio,Adelphi village,285,71,100,18,9,24,222
Ohio,Pomeroy village,1786,464,677,185,44,133,1503
Ohio,Bellevue,7987,1694,3275,676,132,613,6390
Ohio,Beckett Ridge,9114,1815,4446,767,88,289,7405
Ohio,Linndale village,132,30,46,14,4,9,103
Ohio,Manchester village,1933,482,571,292,75,130,1550
Ohio,Martinsburg village,277,78,72,38,8,9,205
Ohio,Chesterland,2277,405,973,205,9,212,1804
Ohio,Green,25758,5769,11491,1909,207,1299,20675
Ohio,Clinton village,1246,311,562,157,0,44,1074
Ohio,Fulton village,241,51,85,41,10,7,194
Ohio,Edison village,494,116,191,56,8,29,400
Ohio,Williamsport village,955,192,355,122,17,39,725
Ohio,Darbyville village,204,51,71,24,11,15,172
Ohio,Springfield,59305,17883,16825,7222,1237,4257,47424
Ohio,South Vienna village,585,152,240,50,5,20,467
Ohio,Crystal Lakes,1467,345,618,207,69,31,1270
Ohio,Clifton village,157,47,52,22,2,10,133
Ohio,Milford,6861,1684,2446,786,172,524,5612
Ohio,Batavia village,1762,577,503,227,59,77,1443
Ohio,Yankee Lake village,87,21,48,8,0,2,79
Ohio,Defiance,17105,4253,6556,1621,276,1053,13759
Ohio,Seaman village,1117,178,341,141,35,62,757
Ohio,Fredericktown village,2494,514,1037,275,26,108,1960
Ohio,Patterson village,152,29,53,7,13,7,109
Ohio,Proctorville village,574,141,152,118,14,47,472
Ohio,Ironton,10912,2747,3185,1353,329,1218,8832
Ohio,Marion,36268,10550,11183,5076,879,2217,29905
Ohio,Clarksburg village,478,98,144,65,5,37,349
Ohio,Centerville village,64,10,44,0,0,5,59
Ohio,Summitville village,98,9,63,3,0,3,78
Ohio,Cumberland village,353,107,154,27,3,9,300
Ohio,Cambridge,10432,2482,2917,1671,237,808,8115
Ohio,Thurston village,627,125,228,55,3,36,447
Ohio,Lisbon village,2713,631,837,390,64,202,2124
Ohio,Brookfield Center,1541,435,524,172,2,146,1279
Ohio,Gratiot village,274,61,94,38,5,11,209
Ohio,Potsdam village,328,81,142,23,3,13,262
Ohio,Laura village,480,94,204,56,3,20,377
Ohio,Danville village,1061,320,370,123,21,67,901
Ohio,Gambier village,2498,1999,373,47,0,22,2441
Ohio,Fairfield,42636,9943,17071,4811,730,2275,34830
Ohio,Millville village,677,150,276,101,10,34,571
Ohio,Oxford,22612,16763,3461,688,153,382,21447
Ohio,Metamora village,628,163,238,63,10,32,506
Ohio,Lyons village,521,117,206,66,0,51,440
Ohio,Apple Creek village,1000,150,495,109,6,55,815
Ohio,Withamsville,7788,1739,3230,917,104,269,6259
Ohio,Neville village,76,22,30,16,2,3,73
Ohio,Day Heights,2910,417,1503,169,30,69,2188
Ohio,South Canal,894,147,640,22,7,7,823
Ohio,Worthington,14705,2267,7016,1459,142,672,11556
Ohio,Glenwillow village,1034,193,378,94,4,132,801
Ohio,Cleveland,387398,162339,78204,44625,9790,19837,314795
Ohio,Broadview Heights,19242,4101,9387,1302,94,914,15798
Ohio,Bratenahl village,1334,280,656,197,8,73,1214
Ohio,Gates Mills village,2198,340,1219,128,16,137,1840
Ohio,Ada village,5970,2987,1598,369,73,155,5182
Ohio,Put-in-Bay village,68,4,52,8,0,4,68
Ohio,Middlefield village,2707,743,973,277,13,292,2298
Ohio,Oak Harbor village,2724,562,1077,258,13,230,2140
Ohio,Mechanicsburg village,1591,337,558,192,17,84,1188
Ohio,South Solon village,309,76,122,20,17,28,263
Ohio,Granville South,1324,138,657,64,29,31,919
Ohio,Wellston,5540,1068,1914,596,177,469,4224
Ohio,College Corner village,306,72,111,37,11,10,241
Ohio,Aberdeen village,1538,257,688,208,13,137,1303
Ohio,Dayton,140782,56471,31599,16326,2945,7345,114686
Ohio,Kirtland Hills village,702,110,393,50,2,22,577
Ohio,Greenwich village,1559,360,572,124,33,71,1160
Ohio,Creston village,2091,372,914,288,32,103,1709
Ohio,Lexington village,5073,900,2287,606,48,251,4092
Ohio,Mineral Ridge,3477,900,1365,479,11,273,3028
Ohio,Higginsport village,253,30,122,20,5,31,208
Ohio,Pleasant Hill village,1305,240,582,103,0,38,963
Ohio,Lewisburg village,1806,331,765,218,7,92,1413
Ohio,St. Louisville village,500,123,187,42,4,24,380
Ohio,Ravenna,11552,3220,3511,1815,377,809,9732
Ohio,Mount Sterling village,1988,535,580,305,63,87,1570
Ohio,Wetherington,1283,234,861,9,29,55,1188
Ohio,Jacksonburg village,50,16,19,3,1,4,43
Ohio,Mount Orab village,3714,832,1658,288,0,116,2894
Ohio,Sinking Spring village,191,94,42,20,0,6,162
Ohio,Mowrystown village,353,83,131,44,10,22,290
Ohio,Lakeview village,1196,206,468,198,40,80,992
Ohio,Cincinnati,300357,126002,68245,30663,6323,12698,243931
Ohio,Cleves village,3394,716,1229,350,50,87,2432
Ohio,Jewett village,750,156,263,88,2,18,527
Ohio,Hopedale village,961,183,439,96,26,113,857
Ohio,Tiffin,17599,5903,5395,2161,238,951,14648
Ohio,Scio village,952,154,333,112,18,48,665
Ohio,Willowick,14160,3634,5484,1405,129,873,11525
Ohio,Lower Salem village,113,21,43,10,0,6,80
Ohio,Spencer village,594,147,225,100,13,38,523
Ohio,Beach City village,940,174,385,95,25,73,752
Ohio,Utica village,1801,435,705,241,20,144,1545
Ohio,Alliance,21927,7073,5903,2571,555,1700,17802
Ohio,South Salem village,278,46,112,26,1,12,197
Ohio,Morral village,433,86,213,42,1,10,352
Ohio,Waldo village,327,64,140,58,4,30,296
Ohio,Kettlersville village,164,17,102,7,0,5,131
Ohio,Waynesville village,3038,763,1083,343,59,263,2511
Ohio,Mason,32749,6806,15470,2348,175,1687,26486
Ohio,Corwin village,502,88,272,41,6,18,425
Ohio,Green Meadows,2366,587,954,287,16,144,1988
Ohio,Westerville,39242,8397,17934,3156,402,2096,31985
Ohio,Ostrander village,955,125,436,81,9,52,703
Ohio,Ashley village,1682,359,609,256,6,84,1314
Ohio,Uniontown,3250,477,1639,240,7,167,2530
Ohio,Lebanon,20584,4657,8076,2291,120,934,16078
Ohio,Kalida village,1355,249,744,52,8,60,1113
Ohio,Murray City village,401,88,187,35,0,46,356
Ohio,Sidney,20639,5220,7689,1974,303,1171,16357
Ohio,Russia village,724,125,355,41,0,21,542
Ohio,Vandalia,15080,3519,6331,2031,114,793,12788
Ohio,Oakwood,9030,1458,4309,646,41,485,6939
Ohio,Moraine,6445,1362,2657,587,51,388,5045
Ohio,West Leipsic village,223,50,91,23,0,21,185
Ohio,Gann village,129,51,39,11,2,6,109
Ohio,Haydenville,302,54,144,0,0,42,240
Ohio,Garrettsville village,2594,659,1059,304,10,162,2194
Ohio,Taylor Creek,3336,661,1635,321,66,111,2794
Ohio,Sulphur Springs,127,34,56,26,0,11,127
Ohio,Stony Ridge,432,74,120,70,28,22,314
Ohio,Stockdale,19,0,0,19,0,0,19
Ohio,Stewart,327,88,57,21,0,0,166
Ohio,Sterling,406,87,163,36,9,28,323
Ohio,Skyline Acres,2522,970,504,250,21,135,1880
Ohio,Sixteen Mile Stand,2804,461,1506,164,31,94,2256
Ohio,Shawnee,598,155,386,28,0,29,598
Ohio,Sawyerwood,1331,348,433,201,44,124,1150
Ohio,Sardis,659,41,411,39,0,38,529
Ohio,Miamitown,1560,746,159,159,58,29,1151
Ohio,Miami Heights,4873,851,2467,288,27,272,3905
Ohio,Melmore,160,71,7,9,12,11,110
Ohio,Marne,692,124,367,33,0,0,524
Ohio,Tedrow,116,34,29,13,5,11,92
Ohio,McKinley Heights,512,101,192,110,40,26,469
Ohio,Tuppers Plains,372,25,226,12,0,0,263
Ohio,Tippecanoe,90,25,34,0,31,0,90
Ohio,Miamiville,229,80,74,38,0,0,192
Ohio,Wolfhurst,1232,305,398,66,10,244,1023
Ohio,Winesburg,279,114,124,20,0,21,279
Ohio,Williston,407,147,164,29,4,21,365
Ohio,Williamsdale,1076,319,323,102,0,43,787
Ohio,Wightmans Grove,47,0,38,9,0,0,47
Ohio,Whites Landing,478,134,164,45,0,38,381
Ohio,West Carrollton,12954,3455,4236,1797,177,801,10466
Ohio,Waterford,651,78,299,42,0,34,453
Ohio,Walnut Creek,1271,157,556,103,5,107,928
Ohio,Vincent,242,19,93,84,0,0,196
Ohio,Vickery,47,29,18,0,0,0,47
Ohio,Vaughnsville,203,53,110,0,0,0,163
Ohio,Twinsburg Heights,735,299,146,22,0,35,502
Ohio,Trinway,216,101,58,37,0,20,216
Ohio,Thornport,964,40,438,298,16,40,832
Ohio,Millfield,294,71,162,51,0,0,284
Ohio,Mack,11422,2297,5759,600,46,386,9088
Ohio,McCutchenville,281,106,42,66,0,11,225
Ohio,Kansas,15,6,9,0,0,0,15
Ohio,Kanauga,110,11,45,24,0,0,80
Ohio,Iberia,623,36,315,73,10,45,479
Ohio,Howard,86,25,43,18,0,0,86
Ohio,Hooven,400,107,157,34,12,45,355
Ohio,Homeworth,476,222,199,12,0,35,468
Ohio,Holiday Lakes,590,122,323,47,0,35,527
Ohio,Hockingport,150,25,54,0,25,46,150
Ohio,Highpoint,1338,294,479,133,54,59,1019
Ohio,Highland Holiday,403,54,132,60,20,40,306
Ohio,Hide-A-Way Hills,557,125,381,51,0,0,557
Ohio,Hessville,201,64,25,48,0,13,150
Ohio,Orient,254,29,128,13,0,27,197
Ohio,Hannibal,403,139,70,119,0,24,352
Ohio,Good Hope,227,40,110,0,48,0,198
Ohio,Kidron,922,165,492,23,0,28,708
Ohio,McDermott,691,250,193,4,18,8,473
Ohio,Kilbourne,34,0,15,9,0,0,24
Ohio,Kings Mills,1564,458,628,183,15,41,1325
Ohio,Little Hocking,416,157,158,32,35,0,382
Ohio,Lewistown,254,60,83,42,0,16,201
Ohio,Lansing,627,27,290,120,0,62,499
Ohio,Lake Waynoka,993,99,494,113,36,92,834
Ohio,Lake Tomahawk,781,125,441,75,0,0,641
Ohio,Lakeside,674,47,452,52,2,121,674
Ohio,Lake Seneca,517,44,369,42,0,17,472
Ohio,Lake Mohawk,1771,281,768,263,0,84,1396
Ohio,Lake Lorelei,1137,150,625,107,0,56,938
Ohio,Lake Lakengren,3415,484,1674,245,33,155,2591
Ohio,Lake Buckhorn,654,139,325,57,0,25,546
Ohio,Lafferty,151,40,12,78,0,10,140
Ohio,Lafayette,190,6,145,7,4,9,171
Ohio,Kunkle,308,128,74,49,0,26,277
Ohio,Kinsman Center,595,119,381,0,11,10,521
Ohio,Kimbolton,62,13,0,0,0,49,62
Ohio,Glencoe,150,73,0,77,0,0,150
Ohio,Minford,508,139,212,32,44,63,490
Ohio,Morgandale,753,191,240,122,0,108,661
Ohio,Groveport,5593,1316,2288,535,113,180,4432
Ohio,Greenfield village,4597,1024,1411,716,211,358,3720
Ohio,Germantown,5505,952,2165,722,131,300,4270
Ohio,East Palestine village,4535,874,1664,548,77,442,3605
Ohio,Canal Winchester,8328,1679,3952,612,139,473,6855
Ohio,St. Johns,158,53,75,0,0,0,128
Ohio,Uniopolis,222,63,84,29,0,12,188
Ohio,Somerville,244,44,95,44,2,13,198
Ohio,Salesville,116,29,44,22,11,0,106
Ohio,Cherry Fork,290,73,132,20,1,2,228
Ohio,Atwater,1078,331,415,72,0,15,833
Ohio,Apple Valley,5408,801,3028,372,3,387,4591
Ohio,Andersonville,853,202,343,124,5,17,691
Ohio,Sandyville,290,20,107,37,20,18,202
Ohio,Salem Heights,3277,882,1515,350,47,133,2927
Ohio,New Albany,10896,1757,5382,390,10,217,7756
Ohio,Rudolph,579,119,153,86,5,32,395
Ohio,St. Bernard village,4355,1227,1679,334,78,252,3570
Ohio,Silverton village,4767,1819,1430,392,106,371,4118
Ohio,New Richmond village,2666,472,1144,257,47,133,2053
Ohio,Westminster,544,55,291,18,7,8,379
Ohio,Valley City,552,76,264,52,26,50,468
Ohio,Rose Farm,247,82,33,54,0,17,186
Ohio,Parkman,123,35,50,38,0,0,123
Ohio,Nettle Lake,254,61,111,4,0,26,202
Ohio,Mitiwanga,275,52,159,17,38,0,266
Ohio,Marlboro,358,76,132,35,0,14,257
Ohio,Lake Milton,582,170,244,57,34,36,541
Ohio,Goshen,463,68,196,103,0,44,411
Ohio,East Springfield,511,214,73,48,0,0,335
Ohio,Connorville,218,37,109,18,0,9,173
Ohio,Fort Shawnee,5960,1128,2862,649,56,426,5121
Ohio,Waverly village,4294,1121,1541,565,30,428,3685
Ohio,Waterville,5484,887,2783,381,36,251,4338
Ohio,St. Martin,265,26,153,39,0,26,244
Ohio,Monfort Heights,13064,3015,5758,1003,72,731,10579
Ohio,Alvordton,176,35,48,32,10,27,152
Ohio,Rosewood,192,57,53,17,0,49,176
Ohio,Oceola,96,0,61,0,0,0,61
Ohio,Northridge,7343,1308,3523,718,151,613,6313
Ohio,North Lawrence,221,0,123,10,28,9,170
Ohio,Newport CDP (Washington County),867,183,446,71,0,25,725
Ohio,Newport CDP (Shelby County),152,55,80,0,0,8,143
Ohio,New Pittsburg,411,147,125,37,0,20,329
Ohio,New Marshfield,369,136,116,60,0,0,312
Ohio,New Haven CDP (Huron County),270,32,150,23,0,16,221
Ohio,New Haven CDP (Hamilton County),507,177,194,8,0,54,433
Ohio,New Hampshire,250,20,112,15,0,8,155
Ohio,New California,1738,244,865,69,11,56,1245
Ohio,New Burlington,4819,897,2058,458,85,362,3860
Ohio,New Baltimore,920,197,406,73,0,48,724
Ohio,Negley,165,32,102,0,0,8,142
Ohio,Neapolis,287,47,141,33,6,0,227
Ohio,Old Fort,189,18,80,8,0,27,133
Ohio,Rossmoyne,1744,723,456,292,27,145,1643
Ohio,Pancoastburg,144,8,90,11,25,0,134
Ohio,Pheasant Run,1337,196,563,112,63,30,964
Ohio,Rocky Fork Point,681,114,319,110,0,65,608
Ohio,Rockbridge,27,0,19,0,0,8,27
Ohio,Robertsville,241,47,111,0,0,14,172
Ohio,Ridgeville Corners,525,62,319,0,0,22,403
Ohio,Richville,3298,745,1682,256,16,170,2869
Ohio,Richmond Dale,367,64,165,27,30,0,286
Ohio,Reno,1138,283,277,222,30,209,1021
Ohio,Remington,273,58,98,63,0,19,238
Ohio,Raymond,156,35,50,8,9,7,109
Ohio,Radnor,159,37,103,19,0,0,159
Ohio,Pulaski,104,22,35,26,0,8,91
Ohio,Pottery Addition,201,109,34,18,8,0,169
Ohio,Plumwood,365,66,97,61,21,40,285
Ohio,Pleasant Hills,779,322,215,62,0,74,673
Ohio,Plainville,182,101,0,0,81,0,182
Ohio,Pettisville,455,88,236,14,2,20,360
Ohio,South Webster village,680,102,325,97,2,33,559
Ohio,Fresno,282,24,148,32,0,0,204
Ohio,Fort Seneca,222,33,133,14,5,5,190
Ohio,Berea,18859,6674,6237,2092,176,826,16005
Ohio,Polk village,347,69,173,20,4,14,280
Ohio,Jeromesville village,659,128,247,42,19,24,460
Ohio,Parma,79559,22101,31200,8083,788,5321,67493
Ohio,Newburgh Heights village,1778,476,516,318,23,176,1509
Ohio,Lyndhurst,13630,3111,6152,1203,66,1160,11692
Ohio,Lakewood,50553,19128,16317,5072,548,1940,43005
Ohio,Tarlton village,259,67,102,32,7,19,227
Ohio,New Holland village,848,176,350,104,27,33,690
Ohio,Commercial Point village,1758,272,791,136,24,51,1274
Ohio,Park Layne,4082,755,1500,412,88,287,3042
Ohio,New Carlisle,5622,942,1853,929,27,343,4094
Ohio,Wilmot village,329,71,146,35,6,16,274
Ohio,Tremont City village,319,86,120,40,3,12,261
Ohio,Johnstown village,5111,1374,1875,511,1,288,4049
Ohio,Brook Park,18721,4939,7128,2045,246,1334,15692
Ohio,Heath,10646,2468,4027,1431,168,758,8852
Ohio,Fairview Park,16400,4695,6602,1596,63,777,13733
Ohio,Pepper Pike,6242,1119,3440,166,51,267,5043
Ohio,Hanover village,1106,255,470,85,10,48,868
Ohio,Barberton,26189,6821,9283,2906,420,1885,21315
Ohio,Chesterville village,182,25,54,30,0,43,152
Ohio,Newtonsville village,374,86,122,85,6,6,305
Ohio,Moscow village,88,23,36,13,5,8,85
Ohio,Bethel village,2770,673,908,375,51,194,2201
Ohio,New Concord village,2627,1540,500,143,15,146,2344
Ohio,Frazeysburg village,1700,423,575,165,32,88,1283
Ohio,Sheffield Lake,9011,2292,3831,773,108,532,7536
Ohio,Continental village,1091,206,489,89,0,91,875
Ohio,Sunbury village,5280,998,2285,393,69,227,3972
Ohio,Dalton village,1557,318,671,171,0,134,1294
Ohio,Hanging Rock village,206,25,94,36,0,31,186
Ohio,Chesapeake village,830,249,276,83,19,58,685
Ohio,Shaker Heights,27620,7010,11161,2179,413,1136,21899
Ohio,Garfield Heights,28001,9854,7714,3192,519,1658,22937
Ohio,Malta village,718,111,292,98,9,29,539
Ohio,Harbor Hills,1485,219,828,189,0,61,1297
Ohio,Clay Center village,270,50,105,24,1,27,207
Ohio,Sherrodsville village,292,63,126,43,3,9,244
Ohio,Carrollton village,3064,766,1421,273,88,96,2644
Ohio,Reminderville village,4113,840,1920,393,49,126,3328
Ohio,Wilmington,12403,3664,3990,1361,241,875,10131
Ohio,Wooster,26778,8165,9008,3277,482,1568,22500
Ohio,Stratton village,363,53,138,74,0,25,290
Ohio,Richmond village,390,76,208,23,9,21,337
Ohio,Rayland village,422,93,141,54,2,33,323
Ohio,Mount Pleasant village,420,64,194,51,0,30,339
Ohio,Bloomingdale village,223,50,83,11,8,8,160
Ohio,Fairborn,33433,10313,11259,3592,621,1678,27463
Ohio,Beavercreek,46600,9503,23742,3637,276,1782,38940
Ohio,Florida village,241,73,95,23,1,21,213
Ohio,Navarre village,1797,431,661,207,20,198,1517
Ohio,Windham village,1988,615,558,265,46,87,1571
Ohio,Orangeville village,173,42,68,12,4,10,136
Ohio,Port Clinton,5939,1342,2151,694,135,497,4819
Ohio,Orrville,8239,1817,3774,678,45,503,6817
Ohio,Hebron village,2183,521,640,399,41,154,1755
Ohio,Sharonville,13942,3500,5916,1377,65,1019,11877
Ohio,Ripley village,1786,394,666,269,49,100,1478
Ohio,Genoa village,2221,487,949,208,23,183,1850
Ohio,Hamler village,661,153,290,35,3,18,499
Ohio,Perry Heights,8581,2006,3172,1253,71,635,7137
Ohio,Greentown,3240,710,1631,185,3,129,2658
Ohio,East Canton village,1379,302,604,178,0,70,1154
Ohio,Canton,71313,24768,17299,8976,1361,4159,56563
Ohio,Pataskala,15465,3188,6407,1623,186,615,12019
Ohio,Newark,49070,12893,16595,6353,1052,2961,39854
Ohio,Alexandria village,697,194,235,76,14,57,576
Ohio,Octa village,41,4,21,7,1,8,41
Ohio,Milledgeville village,102,23,40,15,0,6,84
Ohio,Olde West Chester,357,78,130,0,0,16,224
Ohio,Sabina village,2454,521,785,435,84,212,2037
Ohio,Urbana,11434,2947,3672,1697,203,891,9410
Ohio,Four Bridges,3387,489,1794,156,10,241,2690
Ohio,Louisville,9317,1968,4174,947,28,575,7692
Ohio,Seville village,2598,624,1075,259,6,163,2127
Ohio,Curtice,1428,365,705,65,10,61,1206
Ohio,Crystal Rock,83,29,0,11,17,12,69
Ohio,Concorde Hills,704,143,348,37,0,66,594
Ohio,Collins,531,101,251,40,0,15,407
Ohio,Coldstream,1224,134,758,26,0,25,943
Ohio,Clarktown,407,39,244,87,14,15,399
Ohio,Cinnamon Lake,1092,108,507,30,36,147,828
Ohio,Chippewa Park,720,139,309,99,28,107,682
Ohio,Celeryville,89,25,27,13,0,0,65
Ohio,Carbon Hill,289,92,90,22,0,44,248
Ohio,Candlewood Lake,526,107,231,45,11,0,394
Ohio,Canal Lewisville,349,47,167,26,0,58,298
Ohio,Camp Dennison,320,66,160,27,0,4,257
Ohio,Buford,133,34,37,33,0,20,124
Ohio,Buffalo,306,33,90,30,25,68,246
Ohio,Cynthiana,0,0,0,0,0,0,0
Ohio,Brownsville,81,0,55,0,0,0,55
Ohio,Damascus,402,141,102,102,0,0,345
Ohio,Darrtown,504,79,277,58,0,9,423
Ohio,Friendship,181,43,63,17,0,39,162
Ohio,Flat Rock,141,57,49,8,0,15,129
Ohio,Etna,948,287,310,114,0,14,725
Ohio,Elizabethtown,309,72,63,33,11,27,206
Ohio,East Rochester,213,131,51,31,0,0,213
Ohio,East Liberty,280,84,139,16,0,15,254
Ohio,East Fultonham,314,49,199,0,0,0,248
Ohio,Dunlap,1498,290,1014,72,0,31,1407
Ohio,Dundee,273,34,178,0,9,0,221
Ohio,Duncan Falls,1052,254,420,70,0,113,857
Ohio,Dry Ridge,2630,594,1327,147,79,146,2293
Ohio,Dola,155,17,112,0,0,4,133
Ohio,Derby,431,103,177,73,0,10,363
Ohio,Delshire,3277,814,1377,145,25,145,2506
Ohio,Delhi Hills,5308,1319,2659,222,0,202,4402
Ohio,Darbydale,904,239,418,36,0,45,738
Ohio,Waynesburg village,822,232,275,89,5,68,669
Ohio,Gahanna,35061,7038,15702,3627,356,1392,28115
Ohio,Crown City village,379,60,119,75,10,28,292
Ohio,Edgerton village,2132,462,902,194,7,187,1752
Ohio,New Straitsville village,650,134,242,64,24,29,493
Ohio,Kingston village,961,141,403,213,7,56,820
Ohio,Frankfort village,1308,304,458,133,10,46,951
Ohio,Syracuse village,787,115,429,55,11,37,647
Ohio,Rutland village,453,115,183,33,5,40,376
Ohio,Valleyview village,526,130,186,70,7,41,434
Ohio,Lockbourne village,167,41,58,28,4,4,135
Ohio,Lake Darby,4577,987,1979,318,8,86,3378
Ohio,Kettering,55405,13505,22411,6203,685,2972,45776
Ohio,Minerva Park village,1352,251,672,94,4,43,1064
Ohio,Brookside village,707,183,323,53,0,47,606
Ohio,Bridgeport village,1651,421,589,194,39,134,1377
Ohio,Butler village,755,177,285,86,16,46,610
Ohio,Bellville village,2278,352,1002,227,37,183,1801
Ohio,Stryker village,1170,271,453,117,14,29,884
Ohio,Vinton village,279,32,148,28,11,16,235
Ohio,Corning village,417,89,131,39,9,27,295
Ohio,West Union village,3231,737,906,656,58,339,2696
Ohio,Cheshire village,176,41,61,13,0,26,141
Ohio,Galion,10089,2203,3653,1255,196,803,8110
Ohio,Chatfield village,247,27,123,26,6,10,192
Ohio,Sarahsville village,133,17,69,13,0,8,107
Ohio,Belle Valley village,249,79,87,45,4,18,233
Ohio,Rawson village,504,79,218,22,7,25,351
Ohio,Spencerville village,2367,416,850,193,49,151,1659
Ohio,Chauncey village,1019,282,278,168,56,76,860
Ohio,Sandusky,25012,7585,6902,3151,424,1847,19909
Ohio,Huron,6958,1627,2846,827,63,442,5805
Ohio,Barnesville village,3716,835,1317,445,6,281,2884
Ohio,Harrod village,373,73,180,27,0,10,290
Ohio,Bluffton village,4216,837,1906,296,42,395,3476
Ohio,Jerry City village,578,109,217,65,5,13,409
Ohio,Mifflin village,123,20,51,27,4,10,112
Ohio,Shawnee village,449,98,153,42,7,5,305
Ohio,Glenmoor,1918,364,805,120,43,135,1467
Ohio,Delta village,3210,660,1334,431,22,137,2584
Ohio,Willshire village,399,74,150,70,7,18,319
Ohio,Zanesfield village,303,84,97,45,2,3,231
Ohio,Grover Hill village,368,79,141,31,4,30,285
Ohio,Paulding village,3465,597,1437,383,56,311,2784
Ohio,Bellbrook,7174,1066,3621,548,76,336,5647
Ohio,Amsterdam village,480,65,219,59,0,14,357
Ohio,Dillonvale village,668,203,255,81,10,28,577
Ohio,New Alexandria village,286,78,143,21,10,11,263
Ohio,Hamden village,797,198,253,113,13,42,619
Ohio,Coshocton,11067,2650,4035,1569,128,983,9365
Ohio,Warsaw village,605,130,231,106,0,25,492
Ohio,West Lafayette village,2445,606,748,320,26,224,1924
Ohio,Melrose village,209,51,67,31,0,13,162
Ohio,Oakwood village (Paulding County),644,101,296,61,10,30,498
Ohio,Maple Ridge,853,240,316,88,0,34,678
Ohio,Beloit village,992,242,330,139,18,85,814
Ohio,West Liberty village,1696,303,770,170,12,172,1427
Ohio,Boardman,34557,8894,13569,3984,459,2296,29202
Ohio,De Graff village,1366,280,632,97,3,83,1095
Ohio,Norwood,19796,8474,5104,1941,306,860,16685
Ohio,La Croft,1226,376,490,143,11,65,1085
Ohio,Rogers village,263,77,91,27,7,24,226
Ohio,Marble Cliff village,541,150,262,57,2,28,499
Ohio,Lucasville,1484,337,588,190,35,51,1201
Ohio,Rosemount,1993,494,786,227,0,120,1627
Ohio,Carey village,3516,781,1498,344,21,150,2794
Ohio,Springboro,18042,3044,8804,1196,73,695,13812
Ohio,Middletown,48449,12745,15740,6069,1333,2887,38774
Ohio,Seven Mile village,828,164,364,111,5,28,672
Ohio,Jackson,6274,1431,2569,822,275,344,5441
Ohio,Oak Hill village,1691,397,524,249,36,156,1362
Ohio,Newtown village,2658,574,1120,267,39,69,2069
Ohio,Portage Lakes,7139,1993,2648,1183,93,420,6337
Ohio,Dellroy village,430,95,170,40,10,17,332
Ohio,North Bend village,843,113,498,80,8,56,755
Ohio,Piketon village,2137,346,668,287,69,130,1500
Ohio,Calcutta,3538,759,1694,306,0,364,3123
Ohio,Mentor-on-the-Lake,7410,1965,2745,980,107,514,6311
Ohio,Mutual village,141,8,74,11,0,6,99
Ohio,Hilliard,35665,8031,16171,2297,411,1439,28349
Ohio,Roaming Shores village,1494,235,746,152,8,47,1188
Ohio,Hollansburg village,225,34,111,22,0,15,182
Ohio,North Star village,259,49,118,8,0,20,195
Ohio,Palestine village,242,57,98,9,0,13,177
Ohio,Wayne Lakes village,641,101,288,78,17,52,536
Ohio,Celina,10288,2337,3981,1217,226,546,8307
Ohio,Rockford village,941,172,431,98,19,69,789
Ohio,Bloomdale village,619,160,246,91,6,17,520
Ohio,Fostoria,13249,3136,4026,1850,146,998,10156
Ohio,Millbury village,1517,306,582,133,0,105,1126
Ohio,Milton Center village,140,26,53,26,6,14,125
Ohio,Dunkirk village,756,179,329,67,15,53,643
Ohio,Mount Vernon,16669,4601,5831,1827,446,1002,13707
Ohio,Otway village,57,9,14,11,0,10,44
Ohio,Grove City,40171,7823,17553,3839,467,1623,31305
Ohio,Antioch village,105,43,31,18,0,2,94
Ohio,Salineville village,1223,333,358,178,26,66,961
Ohio,New Paris village,1692,297,563,225,38,85,1208
Ohio,Zaleski village,285,58,151,5,8,12,234
Ohio,Xenia,26364,6470,9300,3372,439,1726,21307
Ohio,West Jefferson village,4343,911,1577,557,173,311,3529
Ohio,Napoleon,8676,2249,3102,870,93,706,7020
Ohio,Cedarville village,4082,2877,707,145,4,73,3806
Ohio,Mingo Junction village,3358,805,1529,320,33,206,2893
Ohio,Fredericksburg village,306,44,151,23,0,17,235
Ohio,Shreve village,1627,348,645,165,14,42,1214
Ohio,Midland village,278,61,90,30,5,13,199
Ohio,Macedonia,11808,2177,6368,628,36,655,9864
Ohio,Mansfield,46638,14726,13931,5835,1279,3068,38839
Ohio,Shelby,8809,1927,3101,1215,261,818,7322
Ohio,Devola,2599,537,1255,222,33,211,2258
Ohio,Eastlake,18229,4811,7304,2061,252,1065,15493
Ohio,East Liverpool,10762,2510,3465,1280,337,685,8277
Ohio,West Manchester village,436,91,157,39,3,20,310
Ohio,Wheelersburg,5996,903,2801,658,46,421,4829
Ohio,New Philadelphia,17432,3999,6562,1838,364,1136,13899
Ohio,Dennison village,2745,603,1049,241,52,116,2061
Ohio,Bolindale,2246,464,830,264,46,186,1790
Ohio,Warren,39668,13479,9426,5523,862,2697,31987
Ohio,New Lebanon village,4243,1073,1494,409,34,285,3295
Ohio,Forestville,10866,1875,5090,933,86,754,8738
Ohio,Lincoln Heights village,3337,1192,410,547,110,229,2488
Ohio,Mariemont village,3429,871,1467,266,61,170,2835
Ohio,Phillipsburg village,445,94,193,64,0,17,368
Ohio,Riverside,25087,6360,9247,2605,414,1266,19892
Ohio,Trotwood,24361,8223,6430,3115,622,1658,20048
Ohio,Logan,6846,1468,2401,876,45,496,5286
Ohio,Glenmont village,257,63,95,42,0,16,216
Ohio,Portage village,492,164,193,31,3,26,417
Ohio,Rossford,6507,1565,2732,630,39,315,5281
Ohio,Tontogany village,520,125,253,29,2,10,419
Ohio,Arlington village,1453,225,644,152,9,98,1128
Ohio,Norwich village,117,40,36,14,3,10,103
Ohio,Toledo,278193,93928,76218,33767,5037,14152,223102
Ohio,Grafton village,6094,2837,1470,1002,318,141,5768
Ohio,St. Marys,8145,1825,3292,723,7,574,6421
Ohio,Upper Sandusky,6757,1564,2478,815,158,475,5490
Ohio,Cleveland Heights,44865,16361,14542,3952,465,1623,36943
Ohio,Cuyahoga Heights village,630,162,167,101,7,43,480
Ohio,Euclid,47456,16505,12605,5738,1116,3178,39142
Ohio,Independence,7156,1441,3682,429,5,359,5916
Ohio,Mayfield village,3397,740,1758,140,58,264,2960
Ohio,Middleburg Heights,15670,3534,7059,1550,153,1072,13368
Ohio,North Randall village,1023,293,209,196,66,157,921
Ohio,North Royalton,30322,7242,14035,2649,136,1509,25571
Ohio,Strongsville,44752,8536,21970,3772,239,2661,37178
Ohio,Elgin village,112,15,51,10,6,0,82
Ohio,West Alexandria village,1603,305,615,204,34,64,1222
Ohio,Hanoverton village,362,76,148,44,9,24,301
Ohio,New Waterford village,1190,204,500,171,6,73,954
Ohio,Roseville village,2262,524,783,275,43,91,1716
Ohio,Northbrook,10832,3079,3511,1131,191,446,8358
Ohio,Mineral City village,737,167,311,92,0,37,607
Ohio,Clarington village,380,69,170,41,0,31,311
Ohio,Streetsboro,16395,4246,6630,1815,321,773,13785
Ohio,Williamsburg village,2535,563,917,326,59,117,1982
Ohio,Burbank village,243,52,87,38,5,23,205
Ohio,Blanchester village,4086,977,1499,494,48,294,3312
Ohio,Deshler village,1536,293,532,175,35,121,1156
Ohio,McClure village,644,152,263,70,8,43,536
Ohio,New Bavaria village,112,24,52,13,0,1,90
Ohio,Findlay,41276,11577,15403,4084,642,2562,34268
Ohio,Jenera village,195,46,99,16,0,0,161
Ohio,Mount Cory village,184,24,86,20,3,10,143
Ohio,Vanlue village,283,55,116,38,0,11,220
Ohio,Harbor View village,61,10,33,4,1,1,49
Ohio,Oregon,20012,5087,8091,2211,247,1385,17021
Ohio,Midvale village,817,179,288,144,24,31,666
Ohio,Swanton village,3637,648,1509,268,23,327,2775
Ohio,Sylvania,18928,4138,8556,1674,116,1145,15629
Ohio,Summerside,4692,1111,1647,557,29,322,3666
Ohio,Hiram village,1272,805,252,59,6,2,1124
Ohio,Mount Repose,4446,1174,1774,423,18,210,3599
Ohio,Amelia village,5074,1086,2101,466,15,198,3866
Ohio,Grand River village,442,104,174,34,8,46,366
Ohio,Attica village,925,195,379,172,2,37,785
Ohio,Bettsville village,694,148,244,105,8,47,552
Ohio,New Riegel village,266,39,118,41,1,16,215
Ohio,Christiansburg village,478,116,198,40,2,45,401
Ohio,Hunter,2210,406,1031,275,14,150,1876
Ohio,Eaton Estates,1244,285,531,133,0,89,1038
Ohio,Kipton village,224,44,114,13,4,13,188
Ohio,Sheffield village,4126,849,2130,321,54,236,3590
Ohio,South Amherst village,1807,415,902,181,4,89,1591
Ohio,Seven Hills,11690,2545,5981,806,76,851,10259
Ohio,Prospect village,975,173,466,100,0,38,777
Ohio,Athalia village,285,45,113,32,11,28,229
Ohio,Clayton,13172,2653,6014,1160,100,620,10547
Ohio,Owensville village,946,181,326,163,58,61,789
Ohio,Felicity village,669,150,198,131,19,47,545
Ohio,Wharton village,346,97,152,16,1,17,283
Ohio,Pitsburg village,371,66,186,39,1,10,302
Ohio,Rossburg village,201,52,81,24,0,14,171
Ohio,Silver Lake village,2511,482,1421,121,6,122,2152
Ohio,Stow,34796,8251,15777,3219,233,1671,29151
Ohio,Aquilla village,325,76,137,30,5,22,270
Ohio,Plymouth village,1600,374,568,174,49,80,1245
Ohio,Macksburg village,202,39,81,46,3,12,181
Ohio,Marietta,13718,4566,4249,1467,228,1112,11622
Ohio,Kirtland,6818,1321,3688,288,126,342,5765
Ohio,Arcanum village,2110,420,967,195,20,88,1690
Ohio,Orwell village,1583,435,435,205,20,169,1264
Ohio,Jefferson village,3327,804,1069,474,12,304,2663
Ohio,Conneaut,12659,3570,4785,1571,238,701,10865
Ohio,Baltic village,802,132,361,42,6,76,617
Ohio,West Mansfield village,688,119,322,44,17,42,544
Ohio,Russells Point village,1158,183,479,183,22,65,932
Ohio,Stoutsville village,655,148,298,63,8,12,529
Ohio,Wren village,110,27,55,11,0,10,103
Ohio,Lancaster,39942,9366,14506,5049,1028,2681,32630
Ohio,Pigeon Creek,721,87,421,26,0,36,570
Ohio,Fairlawn,7522,1808,3336,527,45,633,6349
Ohio,Lakemore village,3085,701,1406,335,0,320,2762
Ohio,Peninsula village,632,106,322,50,6,25,509
Ohio,Brady Lake village,525,168,189,68,10,30,465
Ohio,McArthur village,1522,321,519,280,3,72,1195
Ohio,Aurora,15941,3173,7713,1212,145,978,13221
Ohio,Magnetic Springs village,277,59,79,64,5,21,228
Ohio,Niles,18606,5272,6215,2553,418,1191,15649
Ohio,Monroe,14013,2102,6397,898,137,934,10468
Ohio,Vienna Center,623,135,295,56,0,25,511
Ohio,Georgetown village,4637,812,1584,441,121,437,3395
Ohio,Elmore village,1401,234,600,126,6,132,1098
Ohio,Montrose-Ghent,4928,799,2364,378,33,288,3862
Ohio,Arlington Heights village,903,320,229,69,10,39,667
Ohio,Old Washington village,506,110,112,95,50,26,393
Ohio,Boston Heights village,1122,196,632,55,2,40,925
Ohio,Munroe Falls,5065,1149,2437,418,103,315,4422
Ohio,Plainfield village,132,8,84,9,0,6,107
Ohio,Bremen village,1725,389,669,174,44,79,1355
Ohio,Andover village,1021,201,294,178,24,179,876
Ohio,Hamilton,62259,16742,19060,8693,1307,3735,49537
Ohio,Russellville village,827,167,263,118,7,41,596
Ohio,Fayetteville village,353,73,131,64,3,13,284
Ohio,Union,6555,1334,3115,451,69,202,5171
Ohio,Lockington village,161,30,101,6,0,13,150
Ohio,Drexel,1991,586,564,222,0,84,1456
Ohio,New Knoxville village,965,166,399,79,9,44,697
Ohio,New Bremen village,3318,628,1711,198,21,74,2632
Ohio,Minster village,2727,531,1426,84,10,147,2198
Ohio,Westlake,32378,7181,14320,2891,418,2195,27005
Ohio,Warrensville Heights,13258,4789,2776,1587,396,774,10322
Ohio,Valley View village,2013,454,1006,104,22,111,1697
Ohio,Cridersville village,1778,273,790,190,17,199,1469
Ohio,Pleasant Grove,1682,566,642,131,20,68,1427
Ohio,Philo village,1148,253,438,92,15,48,846
Ohio,Hemlock village,115,36,43,9,0,8,96
Ohio,North Kingsville village,2816,667,1329,227,23,125,2371
Ohio,Savannah village,367,92,131,25,0,27,275
Ohio,Bentleyville village,976,126,570,27,0,14,737
Ohio,Amesville village,144,26,69,19,4,16,134
Ohio,Ithaca village,59,18,22,8,0,3,51
Ohio,Yellow Springs village,3858,960,1345,546,97,295,3243
Ohio,Hayesville village,470,72,237,53,8,13,383
Ohio,Winchester village,1065,241,356,116,27,63,803
Ohio,Peebles village,1851,430,580,212,37,162,1421
Ohio,Galena village,589,109,271,66,4,13,463
Ohio,Delaware,39219,9590,14977,3950,392,1760,30669
Ohio,Wapakoneta,9732,2261,3852,1037,80,607,7837
Ohio,La Rue village,660,155,240,100,3,38,536
Ohio,West Unity village,1749,347,703,218,21,87,1376
Ohio,Maple Heights,22539,8411,5512,2649,495,1234,18301
Ohio,Highland Hills village,922,499,97,192,17,72,877
Ohio,Highland Heights,8396,1572,4495,412,60,498,7037
Ohio,Brooklyn Heights village,1686,278,824,140,11,76,1329
Ohio,Beachwood,11704,1969,5253,956,53,1440,9671
Ohio,Shiloh village,663,145,261,55,9,41,511
Ohio,Kelleys Island village,202,39,139,6,0,14,198
Ohio,Castalia village,907,229,358,79,0,49,715
Ohio,Burlington,2643,426,765,485,51,233,1960
Ohio,Centerville,23821,4616,11298,2064,189,1581,19748
Ohio,Cherry Grove,4521,803,2250,137,0,160,3350
Ohio,Covedale,6209,1378,2810,401,17,359,4965
Ohio,Lore City village,282,54,110,38,2,13,217
Ohio,Pleasant City village,430,122,94,51,10,15,292
Ohio,Elmwood Place village,1907,605,485,237,44,168,1539
Ohio,Belpre,6422,1423,2717,863,53,363,5419
Ohio,Beverly village,1420,285,535,122,19,140,1101
Ohio,Matamoras village,699,149,251,87,8,91,586
Ohio,Lakeline village,243,59,107,37,7,10,220
Ohio,Mentor,47062,9782,22315,4669,341,2809,39916
Ohio,Waite Hill village,399,52,261,19,2,16,350
Ohio,Wickliffe,12733,3022,5077,1619,135,952,10805
Ohio,Willoughby Hills,9526,3029,4331,656,190,343,8549
Ohio,Richmond Heights,10449,3430,3657,870,231,836,9024
Ohio,Graysville village,68,18,39,3,1,5,66
Ohio,Buckeye Lake village,2792,728,995,309,20,219,2271
Ohio,Westfield Center village,1191,192,680,86,7,57,1022
Ohio,Chickasaw village,375,84,165,7,0,17,273
Ohio,Edgewood,4251,1104,1520,543,23,128,3318
Ohio,New Madison village,906,205,347,88,15,58,713
Ohio,Osgood village,239,36,122,2,0,21,181
Ohio,Yorkshire village,83,28,20,4,0,8,60
Ohio,Belmont village,418,135,175,26,0,16,352
Ohio,Yorkville village,1049,286,384,90,20,85,865
Ohio,Vermilion,10226,2012,4820,1168,38,842,8880
Ohio,Glouster village,1709,421,551,266,21,97,1356
Ohio,Payne village,1197,290,467,161,10,89,1017
Ohio,Somerset village,1673,429,625,176,7,156,1393
Ohio,Port Jefferson village,492,69,196,99,0,15,379
Ohio,Brunswick,34733,8241,14975,3196,301,1687,28400
Ohio,Choctaw Lake,1547,266,901,109,9,9,1294
Ohio,Medina,26220,6008,10566,2522,431,1334,20861
Ohio,Lucas village,617,128,240,64,7,28,467
Ohio,Miltonsburg village,84,22,18,3,0,8,51
Ohio,Miller City village,133,27,72,10,0,11,120
Ohio,Ottawa village,4377,951,1754,424,66,286,3481
Ohio,Fayette village,1441,280,549,174,36,51,1090
Ohio,Adena village,679,159,263,86,3,48,559
Ohio,Monroeville village,1206,192,412,154,64,68,890
Ohio,Willard,6060,1473,2174,563,147,374,4731
Ohio,Granville village,5766,2741,1913,198,8,40,4900
Ohio,Hartford village,340,62,148,39,9,14,272
Ohio,Ashtabula,18243,5048,5037,2794,528,1090,14497
Ohio,Jacksonville village,426,138,167,25,4,28,362
Ohio,The Plains,3001,909,1055,309,0,185,2458
Ohio,Sherwood village,854,167,315,111,13,53,659
Ohio,Fairview village,72,20,27,8,0,12,67
Ohio,Holloway village,289,60,129,49,5,7,250
Ohio,Martins Ferry,6703,1917,2323,828,108,532,5708
Ohio,Shadyside village,3623,1031,1450,358,51,325,3215
Ohio,Berlin Heights village,646,156,276,66,2,58,558
Ohio,Archbold village,4409,879,1930,234,52,303,3398
Ohio,Woodstock village,301,57,103,33,7,3,203
Ohio,St. Paris village,2059,490,802,193,31,128,1644
Ohio,Youngstown,64734,24314,14206,8319,1435,4461,52735
Ohio,Franklin,11734,2513,4796,1385,184,742,9620
Ohio,Harveysburg village,664,98,349,24,10,12,493
Ohio,Loveland Park,1888,384,993,74,0,31,1482
Ohio,Maineville village,1047,147,442,133,21,65,808
Ohio,South Lebanon village,4622,787,2561,356,87,132,3923
Ohio,Fultonham village,123,29,39,1,0,18,87
Ohio,Sardinia village,1360,277,438,205,6,30,956
Ohio,Perry village,1646,307,767,146,18,68,1306
Ohio,North Zanesville,2390,349,1194,347,11,148,2049
Ohio,Cortland,6889,1519,3279,557,21,558,5934
Ohio,Hilltop,924,201,291,116,0,119,727
Ohio,Hubbard,7564,1457,3604,661,8,467,6197
Ohio,Girard,9465,2269,3627,1120,153,703,7872
Ohio,Howland Center,6400,1442,2738,691,71,421,5363
Ohio,West Farmington village,434,77,180,20,8,9,294
Ohio,West Hill,2045,467,537,319,101,311,1735
Ohio,Zanesville,25376,6550,7731,3470,674,1813,20238
Ohio,Gettysburg village,564,142,219,52,12,16,441
Ohio,Madison village,3164,694,1450,170,0,201,2515
Ohio,South Point village,3609,797,1569,487,7,225,3085
Ohio,Bethesda village,1259,214,513,164,11,93,995
Ohio,Milan village,1316,290,519,180,10,96,1095
Ohio,Eldorado village,510,114,216,58,4,44,436
Ohio,Hicksville village,3253,761,1278,357,20,230,2646
Ohio,Campbell,7964,2395,2303,1080,96,504,6378
Ohio,Poland village,2582,378,1351,211,5,167,2112
Ohio,West Elkton village,185,19,67,29,2,13,130
Ohio,Grandview Heights,7681,2215,3351,467,30,265,6328
Ohio,Huber Ridge,4511,1422,1675,397,60,79,3633
Ohio,Lincoln Village,10071,2622,3332,1227,308,532,8021
Ohio,North Canton,17362,4559,6899,1712,109,1303,14582
Ohio,Kirkersville village,405,59,186,77,4,30,356
Ohio,Lowell village,638,122,230,72,26,46,496
Ohio,Painesville,19828,6184,6233,1783,346,699,15245
Ohio,Willoughby,22770,6260,8544,2582,223,1711,19320
Ohio,Greenville,12824,2542,4728,1872,152,1488,10782
Ohio,Jerusalem village,136,28,63,12,1,11,115
Ohio,Rock Creek village,403,94,183,40,19,22,358
Ohio,Walbridge village,3110,686,1208,545,0,259,2698
Ohio,New Weston village,98,34,29,4,0,14,81
Ohio,Morristown village,261,53,90,37,12,28,220
Ohio,St. Clairsville,5071,1101,2220,634,69,330,4354
Ohio,Wilson village,136,21,66,10,0,9,106
Ohio,Athens,24771,18577,3689,661,137,364,23428
Ohio,Buchtel village,566,119,315,48,0,40,522
Ohio,Van Buren village,448,59,197,17,24,23,320
Ohio,Holland village,1613,316,676,227,16,171,1406
Ohio,Maumee,13857,3197,6231,1354,149,592,11523
Ohio,Batesville village,89,26,39,6,0,6,77
Ohio,Dover,12811,2726,5131,1566,62,1089,10574
Ohio,Newcomerstown village,3883,479,1631,553,7,283,2953
Ohio,Stone Creek village,187,31,58,23,10,8,130
Ohio,Zoar village,169,27,88,8,3,21,147
Ohio,Gordon village,183,41,92,16,0,10,159
Ohio,Wayne village,1047,305,389,82,6,42,824
Ohio,Castine village,225,50,65,16,7,8,146
Ohio,Stafford village,112,19,51,2,0,12,84
Ohio,Whitehouse village,4713,817,1926,532,21,248,3544
Ohio,Cecil village,123,34,42,30,2,1,109
Ohio,Latty village,154,34,70,23,8,2,137
Ohio,New London village,2458,550,845,262,20,146,1823
Ohio,Terrace Park village,2350,296,1255,110,8,36,1705
Ohio,Wyoming,8535,1484,4170,585,49,292,6580
Ohio,Upper Arlington,35223,5997,17138,2542,192,1394,27263
Ohio,Chillicothe,21717,5146,7405,3237,306,1518,17612
Ohio,Coolville village,563,148,238,67,2,26,481
Ohio,Trimble village,532,164,131,72,23,52,442
Ohio,Delphos,7044,1504,2792,787,141,466,5690
Ohio,Lima,37335,12739,9494,4491,603,1859,29186
Ohio,Tiro village,193,35,61,21,2,19,138
Ohio,Dexter City village,72,28,15,8,1,6,58
Ohio,Glenford village,193,46,67,25,0,9,147
Ohio,Rendville village,27,6,13,0,0,0,19
Ohio,Valley Hi village,175,32,58,30,15,4,139
Ohio,Cairo village,492,80,194,50,5,37,366
Ohio,Belle Center village,734,157,321,72,3,56,609
Ohio,Spring Valley village,535,111,194,103,0,69,477
Ohio,Barnhill village,307,57,127,46,9,26,265
Ohio,Strasburg village,2814,463,1472,301,7,148,2391
Ohio,Lafayette village,430,56,178,42,8,35,319
Ohio,Sugarcreek village,2220,384,1049,189,0,139,1761
Ohio,Uhrichsville,5370,1214,2071,661,60,332,4338
Ohio,Rio Grande village,842,565,107,29,9,8,718
Ohio,Bexley,13764,3825,5747,780,37,315,10704
Ohio,Urbancrest village,1085,297,323,48,11,44,723
Ohio,Racine village,704,143,265,118,8,57,591
Ohio,Doylestown village,3097,469,1486,280,32,176,2443
Ohio,Marshallville village,829,186,335,91,12,27,651
Ohio,Mount Eaton village,179,37,93,9,3,5,147
Ohio,Smithville village,1346,372,567,116,9,57,1121
Ohio,Broughton village,113,18,51,14,4,4,91
Ohio,Ridgeway village,334,71,139,43,10,12,275
Ohio,Steubenville,18095,6449,5213,2115,224,1282,15283
Ohio,Piqua,20941,5246,7364,2818,132,1334,16894
Ohio,Geneva,5989,1451,2017,839,196,484,4987
Ohio,Rushville village,397,85,150,36,1,13,285
Ohio,Coalton village,436,95,173,68,10,42,388
Ohio,Marblehead village,775,141,451,45,6,60,703
Ohio,Jeffersonville village,1279,346,354,187,27,28,942
Ohio,Bloomingburg village,917,243,370,82,10,40,745
Ohio,Waynesfield village,722,158,338,75,4,44,619
Ohio,Hartville village,3016,840,1235,391,13,147,2626
Ohio,Botkins village,1171,196,519,106,29,88,938
Ohio,Huber Heights,39219,8915,16366,3493,481,1744,30999
Ohio,Bentonville,180,28,118,0,0,17,163
Ohio,Coal Grove village,1811,410,701,232,26,206,1575
Ohio,Woodmere village,786,252,260,96,4,47,659
Ohio,University Heights,13138,4741,4687,777,69,413,10687
Ohio,South Euclid,21688,7697,7617,1649,242,877,18082
Ohio,Rocky River,20310,4634,8372,2060,259,1415,16740
Ohio,Orange village,3285,572,1637,265,16,132,2622
Ohio,Nashville village,167,26,84,5,0,6,121
Ohio,Moreland Hills village,3316,367,2008,240,16,138,2769
Ohio,Cloverdale village,145,35,47,24,0,9,115
Ohio,Landen,7214,1275,3043,912,89,302,5621
Ohio,Wakeman village,1218,260,421,243,31,75,1030
Ohio,Nellie village,101,17,41,8,4,12,82
Ohio,Conesville village,427,90,190,38,0,31,349
Ohio,Rushsylvania village,582,131,218,76,11,33,469
Ohio,Bellefontaine,13531,3019,4542,1567,434,759,10321
Ohio,Wintersville village,4482,1158,1631,628,52,274,3743
Ohio,Toronto,5298,1124,2055,681,81,396,4337
Ohio,Empire village,242,66,103,10,10,22,211
Ohio,Wilberforce,2291,1850,211,36,0,14,2111
Ohio,Shawnee Hills,2254,339,1233,111,17,106,1806
Ohio,Bowersville village,322,64,120,45,3,21,253
Ohio,Lodi village,2849,624,1018,486,52,217,2397
Ohio,Five Points,1723,161,1066,69,26,23,1345
Ohio,Leipsic village,2402,488,787,266,8,141,1690
Ohio,Dupont village,257,46,123,22,1,17,209
Ohio,Columbus Grove village,2272,468,945,219,11,71,1714
Ohio,Versailles village,2676,493,1101,259,42,209,2104
Ohio,Brooklyn,10862,3626,3747,1155,222,740,9490
Ohio,Bailey Lakes village,397,57,200,47,10,20,334
Ohio,New Vienna village,1214,275,419,189,8,42,933
Ohio,Malvern village,1343,333,548,117,11,49,1058
Ohio,Holgate village,1103,202,487,145,16,71,921
Ohio,Malinta village,277,60,111,37,7,15,230
Ohio,Jamestown village,2082,438,783,251,39,181,1692
Ohio,Mount Healthy,6076,1826,1625,798,59,584,4892
Ohio,North College Hill,9307,3173,2216,1261,241,617,7508
Ohio,Northgate,7099,1770,2657,767,141,425,5760
Ohio,Northfield village,3677,1151,1296,459,10,232,3148
Ohio,Cardington village,1911,535,561,285,39,65,1485
Ohio,Cuyahoga Falls,49317,12487,19203,5678,392,2882,40642
Ohio,Tallmadge,17581,4513,7892,1512,141,823,14881
Ohio,Pioneer village,1650,428,646,77,8,100,1259
Ohio,Convoy village,1125,250,495,67,13,50,875
Ohio,Lithopolis village,1655,334,705,157,25,55,1276
Ohio,Beulah Beach,13,0,0,0,0,13,13
Ohio,Loudonville village,2654,494,1039,328,40,267,2168
Ohio,Bladensburg,166,80,71,15,0,0,166
Ohio,Bourneville,279,55,197,0,0,0,252
Ohio,Mulberry,3772,733,1613,504,67,413,3330
Ohio,Loveland,13082,3164,5494,1107,113,697,10575
Ohio,Plain City village,4421,846,1977,433,0,202,3458
Ohio,Washingtonville village,983,283,319,106,33,51,792
Ohio,Salem,11870,2630,4621,1245,117,969,9582
Ohio,Minerva village,3482,710,1305,504,38,308,2865
Ohio,Verona village,446,95,174,60,9,14,352
Ohio,Eaton,8195,1783,3158,1071,122,610,6744
Ohio,Camden village,1942,463,864,147,20,147,1641
Ohio,Sebring village,4263,1087,1655,393,75,435,3645
Ohio,New Middletown village,1490,285,619,215,5,136,1260
Ohio,Lowellville village,1142,288,422,170,11,97,988
Ohio,Canfield,7295,1285,3955,500,15,477,6232
Ohio,Bridgetown,13824,3611,5250,1368,148,995,11372
Ohio,Brecon,518,16,207,24,17,80,344
Ohio,Blue Jay,1111,271,617,75,0,27,990
Ohio,Port William village,226,64,84,21,0,5,174
Ohio,West Portsmouth,2795,394,1215,398,70,143,2220
Ohio,Geneva-on-the-Lake village,1320,246,496,302,9,82,1135
Ohio,North Madison,8573,1705,3501,919,130,382,6637
Ohio,New Athens village,304,56,116,35,5,33,245
Ohio,Madeira,9091,1467,4802,427,29,374,7099
Ohio,Greenhills village,3596,1026,1355,287,44,216,2928
Ohio,Masury,1893,456,753,222,10,136,1577
Ohio,Laurelville village,584,190,137,118,24,55,524
Ohio,McDonald village,3116,721,1264,319,74,301,2679
Ohio,New Miami village,2416,632,824,162,120,141,1879
Ohio,West Salem village,1562,337,603,184,17,79,1220
Ohio,Bainbridge village,777,112,348,77,26,49,612
Ohio,Sugar Bush Knolls village,196,32,130,6,0,12,180
Ohio,Bellaire village,4139,1175,1118,507,153,330,3283
Ohio,Brookville,5813,1090,2467,613,166,531,4867
Ohio,Canal Fulton,5464,1285,2339,560,28,482,4694
Ohio,Carlisle,5337,1136,2475,405,86,396,4498
Ohio,Quaker City village,376,102,111,49,2,38,302
Ohio,Chardon,5171,1096,2359,569,24,228,4276
Ohio,Ross,3526,666,1609,303,0,159,2737
Ohio,Irondale village,351,92,146,17,7,15,277
Ohio,Edon village,672,186,280,41,8,57,572
Ohio,Holiday City village,31,6,18,0,0,1,25
Ohio,Coldwater village,4385,752,1911,213,15,453,3344
Ohio,St. Henry village,2503,502,1296,58,0,86,1942
Ohio,Bradford village,1962,442,757,240,6,113,1558
Ohio,Kenton,8296,1591,2830,1176,124,676,6397
Ohio,Englewood,13485,2685,5539,1622,128,944,10918
Ohio,Rocky Ridge village,521,107,191,47,15,17,377
Ohio,South Russell village,3801,556,2255,166,0,111,3088
Ohio,Meyers Lake village,605,121,292,105,2,32,552
Ohio,Millersport village,1163,234,434,153,12,40,873
Ohio,Haviland village,216,66,87,16,2,7,178
Ohio,Lordstown village,3300,712,1580,256,39,198,2785
Ohio,West Rushville village,251,68,94,10,6,9,187
Ohio,Dry Run,7754,1239,4199,159,23,154,5774
Ohio,North Hampton village,439,128,186,30,6,17,367
Ohio,Bryan,8285,2146,2693,1128,93,671,6731
Ohio,Columbiana,6293,969,3114,601,63,608,5355
Ohio,Gallipolis village,3589,855,961,636,31,385,2868
Ohio,Hillsboro,6520,1429,2258,922,145,484,5238
Ohio,Leesburg village,1442,377,553,223,36,71,1260
Ohio,Senecaville village,336,81,134,44,3,24,286
Ohio,Fairfax village,1707,458,571,177,21,120,1347
Ohio,Montgomery,10663,1253,5947,502,31,637,8370
Ohio,Pleasant Run Farm,4653,1041,1952,345,64,210,3612
Ohio,Reading,10286,3274,3310,1141,278,504,8507
Ohio,Amherst,12097,2272,5871,1073,130,762,10108
Ohio,Elyria,53910,15854,17366,6604,558,3000,43382
Ohio,Wellington village,5249,1575,1760,633,105,419,4492
Ohio,Helena village,309,60,135,37,2,14,248
Ohio,Bairdstown village,136,11,50,25,2,4,92
Ohio,Dent,11378,2252,5512,912,69,415,9160
Ohio,Dillonvale,3441,712,1587,353,7,180,2839
Ohio,Craig Beach village,1318,248,572,131,33,75,1059
Ohio,Sugar Grove village,381,89,134,34,9,31,297
Ohio,Crestline,4478,954,1749,436,64,209,3412
Ohio,Byesville village,2360,598,776,330,58,162,1924
Ohio,Carroll village,415,114,161,57,3,22,357
Ohio,LaGrange village,2375,435,973,247,41,142,1838
Ohio,Newton Falls,4564,1209,1486,834,59,387,3975
Ohio,Ontario,6100,1061,3075,663,0,436,5235
Ohio,Powell,12909,1835,6725,560,65,248,9433
Ohio,Washington Court House,14135,2746,5198,1968,238,958,11108
Ohio,Chippewa Lake village,672,133,301,81,17,44,576
Ohio,New Lexington village,5189,1429,1883,567,88,200,4167
Ohio,Sherwood,3448,354,1835,330,31,76,2626
Ohio,Brilliant,1596,469,502,205,66,51,1293
Ohio,New Franklin,14178,2822,7043,1215,134,745,11959
Ohio,Austinburg,595,131,196,46,0,117,490
Ohio,Bannock,176,6,160,0,0,0,166
Ohio,Bascom,371,65,205,22,0,26,318
Ohio,Massillon,32366,8011,11682,4397,410,1711,26211
Ohio,Farmersville village,1105,170,581,76,24,42,893
Ohio,Gloria Glens Park village,472,92,215,39,4,35,385
Ohio,Kirby village,119,38,42,11,0,2,93
Ohio,Struthers,10325,2764,3817,904,218,833,8536
Ohio,Highland village,398,101,128,47,0,16,292
Ohio,Forest Park,18703,5267,6269,1682,241,802,14261
Ohio,Grandview,1149,181,582,121,23,40,947
Ohio,Pleasant Run,4460,1023,1916,419,25,244,3627
Ohio,Springdale,11228,2640,4034,1065,205,804,8748
Ohio,White Oak,19900,4693,8303,2069,163,940,16168
Ohio,Perrysville village,758,246,260,85,17,11,619
Ohio,New Bloomington village,473,91,125,90,15,20,341
Ohio,Ashland,20396,6030,7446,1944,277,1288,16985
Ohio,Bedford,12705,4022,3447,1788,338,786,10381
Ohio,Berlin,863,171,398,65,0,31,665
Ohio,Brecksville,13538,2534,6870,1126,95,538,11163
Ohio,East Cleveland,17321,7533,2892,2146,543,1174,14288
Ohio,Mayfield Heights,18766,5274,6466,2278,158,1508,15684
Ohio,Olmsted Falls,8912,1772,4047,1011,28,546,7404
Ohio,Parma Heights,20162,5712,7582,2242,133,1393,17062
Ohio,Union City village,1755,508,445,242,55,74,1324
Ohio,Buckland village,265,40,97,38,1,15,191
Ohio,Brewster village,2159,410,878,296,29,157,1770
Ohio,Antwerp village,1412,318,505,187,9,140,1159
Ohio,Bay Village,15391,2772,7618,1130,47,641,12208
Ohio,Hunting Valley village,740,114,416,22,9,43,604
Ohio,Arcadia village,548,128,247,54,1,17,447
Ohio,Oakwood village (Cuyahoga County),3692,1244,1210,385,54,308,3201
Ohio,Leetonia village,2118,506,816,244,50,99,1715
Ohio,Shawnee Hills village,785,102,395,40,12,14,563
Ohio,Powhatan Point village,1524,306,651,196,36,137,1326
Ohio,Sparta village,161,61,54,14,0,4,133
Ohio,Grand Rapids village,959,225,372,164,6,60,827
Ohio,Neffs,623,211,290,31,0,81,613
Ohio,Brimfield,3526,913,1348,393,27,171,2852
Ohio,Scott village,286,69,116,41,0,10,236
Ohio,McConnelsville village,1910,408,605,324,16,242,1595
Ohio,Green Camp village,355,78,108,54,25,26,291
Ohio,Holmesville village,301,57,139,24,0,17,237
Ohio,The Village of Indian Hill,5876,594,3792,186,29,80,4681
Ohio,Lynchburg village,1331,301,415,204,14,99,1033
Ohio,Dublin,45559,7232,23620,2475,161,1161,34649
Ohio,Thornville village,1083,235,423,120,11,60,849
Ohio,Stony Prairie,1307,431,424,150,9,92,1106
Ohio,Woodville village,2118,366,877,222,30,146,1641
Ohio,Northwood,5383,1077,2630,474,84,138,4403
Ohio,Butlerville village,172,47,63,21,0,8,139
Ohio,Risingsun village,635,146,287,36,23,16,508
Ohio,Catawba village,260,51,113,20,3,12,199
Ohio,Circleville,13853,3857,4740,1688,281,1063,11629
Ohio,Killbuck village,946,198,337,107,33,55,730
Ohio,Millersburg village,3165,885,1105,492,23,173,2678
Ohio,Fort Jennings village,444,108,190,33,0,42,373
Ohio,Glandorf village,998,129,559,29,0,50,767
Ohio,Pleasant Plain village,156,44,60,25,1,2,132
Ohio,Miamisburg,19974,3810,9072,1977,133,1281,16273
Ohio,Anna village,1487,300,676,83,3,36,1098
Ohio,Jackson Center village,1604,261,636,232,0,107,1236
Ohio,Fremont,16171,5045,4448,2279,265,886,12923
Ohio,Middle Point village,525,99,274,33,0,23,429
Ohio,Mendon village,671,145,292,47,0,33,517
Ohio,New Boston village,2375,687,601,417,35,294,2034
Ohio,Austintown,28386,7444,11166,3220,282,1815,23927
Ohio,Rochester village,168,34,82,11,0,14,141
Ohio,Lorain,63773,19604,19022,6689,1531,3796,50642
Ohio,North Ridgeville,32954,6221,15529,2406,312,1743,26211
Ohio,Oberlin,8299,4029,2183,511,133,471,7327
Ohio,Dresden village,1685,468,560,161,29,115,1333
Ohio,Maplewood Park,292,78,91,55,15,24,263
Ohio,Bowerston village,437,113,145,62,1,32,353
Ohio,Deersville village,41,9,27,0,0,5,41
Ohio,Freeport village,374,67,161,34,0,43,305
Ohio,Pleasantville village,1065,264,374,140,6,49,833
Ohio,Covington village,2653,540,1000,312,18,143,2013
Ohio,Ansonia village,1344,232,622,88,11,80,1033
Ohio,Forest village,1652,342,608,197,59,59,1265
Ohio,Casstown village,218,67,74,24,0,16,181
Ohio,Harpster village,186,23,98,30,4,8,163
Ohio,Marysville,23509,5753,8823,2647,490,979,18692
Oklahoma,Felt,149,23,83,4,0,6,116
Oklahoma,Weleetka,875,267,257,88,22,62,696
Oklahoma,Grandview,277,94,112,36,0,0,242
Oklahoma,Grant,335,90,110,54,0,10,264
Oklahoma,Indianola,29,0,29,0,0,0,29
Oklahoma,Isabella,241,14,101,0,0,21,136
Oklahoma,Lebanon,224,59,35,66,0,43,203
Oklahoma,Kenton,36,0,36,0,0,0,36
Oklahoma,Kenwood,1095,257,464,82,41,37,881
Oklahoma,Lane,268,28,135,25,2,15,205
Oklahoma,Lucien,146,13,67,3,0,9,92
Oklahoma,Mulberry,115,18,48,17,0,3,86
Oklahoma,Nardin,30,0,20,0,0,10,30
Oklahoma,Nescatunga,80,0,63,10,0,7,80
Oklahoma,Gideon,8,0,5,3,0,0,8
Oklahoma,Nicut,262,51,130,26,1,22,230
Oklahoma,Peggs,933,188,436,80,0,56,760
Oklahoma,Piney,33,0,21,0,0,12,33
Oklahoma,Proctor,235,57,71,52,13,0,193
Oklahoma,Rose,263,43,158,29,0,8,238
Oklahoma,Steely Hollow,169,39,36,23,21,25,144
Oklahoma,Swink,66,13,28,5,0,5,51
Oklahoma,Sycamore,165,14,72,29,0,0,115
Oklahoma,Teresita,144,24,72,14,0,6,116
Oklahoma,Titanic,350,79,140,35,3,4,261
Oklahoma,Turpin,388,51,162,62,0,17,292
Oklahoma,Tuskahoma,107,2,47,12,0,9,70
Oklahoma,Wauhillau,479,74,152,45,23,22,316
Oklahoma,Old Green,587,140,207,59,0,40,446
Oklahoma,Okarche,1445,396,556,105,9,87,1153
Oklahoma,Pawnee,2141,483,766,256,30,168,1703
Oklahoma,Idabel,6925,1650,2096,888,166,492,5292
Oklahoma,Ardmore,24892,5600,8503,3311,373,1853,19640
Oklahoma,Camargo,130,26,50,21,0,0,97
Oklahoma,Grainola,50,2,26,4,0,0,32
Oklahoma,Okemah,3191,722,1043,409,90,263,2527
Oklahoma,Scraper,250,38,126,52,16,18,250
Oklahoma,Kemp,126,16,49,21,0,23,109
Oklahoma,Mutual,101,20,55,5,2,0,82
Oklahoma,Bennington,296,44,127,25,5,21,222
Oklahoma,Justice,1407,255,769,121,17,62,1224
Oklahoma,Antlers,2594,565,828,335,25,273,2026
Oklahoma,Sperry,1201,259,425,193,22,55,954
Oklahoma,Mill Creek,334,60,123,30,0,24,237
Oklahoma,Mooreland,1537,304,598,209,9,72,1192
Oklahoma,Amber,423,60,165,66,5,11,307
Oklahoma,Holdenville,5611,2043,1554,678,126,363,4764
Oklahoma,Brush Creek,18,6,0,12,0,0,18
Oklahoma,Bull Hollow,64,0,31,9,0,0,40
Oklahoma,Leach,294,41,147,13,6,8,215
Oklahoma,Cleveland,3166,688,1225,357,63,249,2582
Oklahoma,Collinsville,6720,1219,2820,669,112,249,5069
Oklahoma,Briggs,355,64,119,60,0,11,254
Oklahoma,Dry Creek,180,40,82,19,0,32,173
Oklahoma,Hulbert,605,154,175,91,19,60,499
Oklahoma,Welling,638,117,279,66,22,48,532
Oklahoma,Stigler,2725,524,913,310,97,256,2100
Oklahoma,Broken Bow,4102,1169,1179,476,56,269,3149
Oklahoma,Haworth,311,47,126,52,0,24,249
Oklahoma,White Oak,269,40,132,37,8,18,235
Oklahoma,Fletcher,965,131,483,108,12,28,762
Oklahoma,Whitesboro,203,43,69,16,6,28,162
Oklahoma,Burneyville,627,63,350,64,0,37,514
Oklahoma,Chelsea,1990,392,726,233,58,132,1541
Oklahoma,Sweetwater,60,13,34,5,0,2,54
Oklahoma,Foster,145,26,65,19,5,9,124
Oklahoma,Katie,514,61,209,33,4,18,325
Oklahoma,Oologah,1241,187,584,104,3,35,913
Oklahoma,Verdigris,4372,829,1970,261,96,163,3319
Oklahoma,Beaver,1469,230,673,85,3,106,1097
Oklahoma,New Woodville,199,54,46,27,0,0,127
Oklahoma,Ringwood,594,123,254,48,10,25,460
Oklahoma,Tiawah,213,83,84,33,0,0,200
Oklahoma,Albany,113,13,80,0,0,14,107
Oklahoma,Arpelar,321,65,136,48,5,28,282
Oklahoma,Stoney Point,243,16,106,27,7,19,175
Oklahoma,Badger Lee,50,21,19,4,0,6,50
Oklahoma,Bison,32,0,20,12,0,0,32
Oklahoma,Blackgum,85,6,16,8,0,9,39
Oklahoma,Blue,272,62,130,7,0,17,216
Oklahoma,Box,187,32,66,42,0,35,175
Oklahoma,Butler,146,41,47,10,0,25,123
Oklahoma,Cartwright,577,110,182,137,0,104,533
Oklahoma,Chester,150,26,92,0,0,5,123
Oklahoma,Dale,222,53,33,62,14,0,162
Oklahoma,Deer Lick,0,0,0,0,0,0,0
Oklahoma,Drowning Creek,213,34,69,75,0,8,186
Oklahoma,Eagletown,597,129,225,41,43,50,488
Oklahoma,Elm Grove,265,43,106,0,0,12,161
Oklahoma,Bee,151,24,68,42,0,9,143
Oklahoma,Sand Hill,341,48,147,41,8,20,264
Oklahoma,Pinhook Corner,158,60,67,6,0,0,133
Oklahoma,Perkins,2866,610,1011,430,13,142,2206
Oklahoma,Clarita,110,29,29,10,0,23,91
Oklahoma,Coleman,256,27,138,35,4,17,221
Oklahoma,Connerville,152,47,34,7,0,26,114
Oklahoma,Gowen,366,67,150,19,0,0,236
Oklahoma,Latta,1227,218,423,161,25,60,887
Oklahoma,Lequire,184,15,98,23,4,11,151
Oklahoma,Monroe,208,50,83,19,3,12,167
Oklahoma,Panola,25,10,3,7,5,0,25
Oklahoma,Platter,198,63,53,16,16,15,163
Oklahoma,Wardville,30,3,18,3,0,6,30
Oklahoma,Skiatook,8047,1506,3211,668,220,489,6094
Oklahoma,Liberty,329,59,105,59,0,17,240
Oklahoma,McLoud,4649,1226,1717,566,61,271,3841
Oklahoma,Carlton Landing,13,5,4,0,0,0,9
Oklahoma,Blanco,91,20,33,10,0,9,72
Oklahoma,Mazie,130,20,82,12,16,0,130
Oklahoma,Wickliffe,7,0,0,7,0,0,7
Oklahoma,Earlsboro,549,87,221,84,19,38,449
Oklahoma,Johnson,222,31,113,24,0,9,177
Oklahoma,St. Louis,100,2,62,13,0,10,87
Oklahoma,Shawnee,31141,7499,10640,4325,586,1971,25021
Oklahoma,Calumet,611,114,204,133,0,22,473
Oklahoma,Bridge Creek,342,76,166,19,1,4,266
Oklahoma,Carlisle,580,52,245,59,11,62,429
Oklahoma,Friendship,43,5,29,0,0,4,38
Oklahoma,IXL,55,13,16,5,0,8,42
Oklahoma,Marietta,166,39,44,26,0,0,109
Oklahoma,White Water,65,0,17,11,0,10,38
Oklahoma,Talihina,1010,200,274,168,20,103,765
Oklahoma,Pond Creek,1039,169,410,98,20,55,752
Oklahoma,Dill City,503,72,231,40,10,21,374
Oklahoma,Warwick,202,41,99,16,0,24,180
Oklahoma,Lehigh,282,66,114,42,3,18,243
Oklahoma,Coyle,289,104,89,43,0,12,248
Oklahoma,Marshall,224,42,127,5,8,6,188
Oklahoma,Wellston,851,161,397,93,11,33,695
Oklahoma,Arcadia,252,109,51,37,4,26,227
Oklahoma,Del City,21874,4892,7419,3011,313,1418,17053
Oklahoma,Luther,1309,250,521,139,15,79,1004
Oklahoma,Loco,106,27,43,17,5,9,101
Oklahoma,Meridian,33,17,5,3,5,0,30
Oklahoma,Optima,432,79,165,57,15,4,320
Oklahoma,Alderson,205,28,73,45,5,13,164
Oklahoma,Watts,337,84,78,47,10,23,242
Oklahoma,Meno,175,39,76,16,3,10,144
Oklahoma,Longtown,2731,254,1668,219,12,275,2428
Oklahoma,Lenapah,257,58,89,32,3,11,193
Oklahoma,Deer Creek,177,63,42,16,2,9,132
Oklahoma,Lamont,342,130,118,30,2,7,287
Oklahoma,Medford,1179,286,432,132,15,97,962
Oklahoma,Bethany,19472,4976,6757,2059,200,1197,15189
Oklahoma,Choctaw,12367,2250,6006,1206,76,497,10035
Oklahoma,Edmond,91053,20016,40565,6539,1081,3332,71533
Oklahoma,Warr Acres,10360,2311,3652,1315,148,382,7808
Oklahoma,Peoria,123,18,47,23,0,13,101
Oklahoma,Dibble,990,182,442,82,19,44,769
Oklahoma,Afton,1189,192,430,123,36,53,834
Oklahoma,Crowder,407,90,159,66,12,17,344
Oklahoma,Winchester,570,105,236,61,24,23,449
Oklahoma,Henryetta,5671,1178,1935,885,134,404,4536
Oklahoma,Cedar Valley,482,83,301,22,0,36,442
Oklahoma,Depew,427,78,167,40,5,45,335
Oklahoma,Cherry Tree,1052,307,344,74,9,55,789
Oklahoma,Forgan,522,67,282,24,14,20,407
Oklahoma,Lawrence Creek,134,13,62,11,2,15,103
Oklahoma,Mounds,1061,262,407,135,11,50,865
Oklahoma,Burns Flat,2196,459,803,179,57,59,1557
Oklahoma,Cleo Springs,384,41,169,41,0,12,263
Oklahoma,East Duke,373,50,148,38,8,35,279
Oklahoma,Elmer,95,12,27,33,2,15,89
Oklahoma,Ames,264,46,115,16,0,17,194
Oklahoma,Canadian,162,33,79,13,5,6,136
Oklahoma,Cimarron City,167,36,63,23,11,8,141
Oklahoma,Beggs,1453,386,505,136,17,98,1142
Oklahoma,Grayson,135,27,58,17,2,8,112
Oklahoma,Okmulgee,12024,3711,2991,1749,265,969,9685
Oklahoma,Schulter,392,62,162,47,13,46,330
Oklahoma,Hooker,1740,336,618,119,30,144,1247
Oklahoma,Tyrone,716,205,302,70,14,17,608
Oklahoma,Wakita,295,31,140,20,2,51,244
Oklahoma,Fallis,47,0,43,0,0,4,47
Oklahoma,Spencer,4012,1105,1253,569,75,298,3300
Oklahoma,Prague,2042,386,803,278,38,204,1709
Oklahoma,Sparks,152,39,37,22,3,14,115
Oklahoma,Forest Park,1145,217,502,119,23,60,921
Oklahoma,Bray,1112,260,546,74,13,52,945
Oklahoma,Marlow,4512,740,1661,615,101,471,3588
Oklahoma,Meridian,1631,318,732,121,75,123,1369
Oklahoma,North Miami,351,83,141,35,14,20,293
Oklahoma,Elmore City,872,167,412,76,12,27,694
Oklahoma,Kremlin,265,32,110,37,0,19,198
Oklahoma,Claremore,18780,4287,6640,2545,414,1333,15219
Oklahoma,Blanchard,8573,1304,4292,863,30,303,6792
Oklahoma,Morrison,774,105,352,73,13,7,550
Oklahoma,Hardesty,334,91,111,9,15,1,227
Oklahoma,Christie,116,14,55,18,0,0,87
Oklahoma,Lyons Switch,335,69,154,19,6,21,269
Oklahoma,Knowles,14,7,0,7,0,0,14
Oklahoma,Sapulpa,20659,4246,7962,2457,302,1328,16295
Oklahoma,Shamrock,14,6,5,0,0,1,12
Oklahoma,Martha,133,27,47,27,5,3,109
Oklahoma,Corn,663,93,281,61,22,88,545
Oklahoma,Manchester,52,2,28,1,0,5,36
Oklahoma,Carney,646,128,263,78,17,33,519
Oklahoma,Buffalo,1175,182,533,60,27,67,869
Oklahoma,Stroud,2714,612,999,302,70,174,2157
Oklahoma,Nichols Hills,3891,606,2178,145,27,227,3183
Oklahoma,Velma,650,138,274,42,13,44,511
Oklahoma,Coalgate,1987,405,606,326,44,205,1586
Oklahoma,Tupelo,315,74,74,43,8,36,235
Oklahoma,Texhoma,782,219,282,60,5,36,602
Oklahoma,Fairfield,516,101,247,29,0,52,429
Oklahoma,Salem,54,0,54,0,0,0,54
Oklahoma,Gate,99,16,38,10,7,8,79
Oklahoma,Oilton,888,155,376,74,17,66,688
Oklahoma,Blair,801,129,309,86,15,36,575
Oklahoma,Eldorado,429,67,180,36,4,34,321
Oklahoma,Krebs,2049,423,798,279,52,118,1670
Oklahoma,Lake Aluma,77,5,52,6,0,1,64
Oklahoma,Norman,121090,43426,42845,10616,1380,3943,102210
Oklahoma,Moore,60807,13559,25216,6044,801,2379,47999
Oklahoma,Greenfield,132,37,53,11,3,3,107
Oklahoma,Foyil,311,75,108,39,19,5,246
Oklahoma,Remy,607,63,394,44,0,25,526
Oklahoma,Gould,131,21,64,14,5,3,107
Oklahoma,Marietta,2713,572,852,323,17,179,1943
Oklahoma,Foraker,12,0,7,3,0,2,12
Oklahoma,Brent,863,118,389,124,10,74,715
Oklahoma,Redbird Smith,447,101,152,83,31,30,397
Oklahoma,Manitou,156,35,44,20,0,16,115
Oklahoma,Porter,692,128,248,88,15,38,517
Oklahoma,Amorita,34,9,6,4,1,3,23
Oklahoma,Kaw City,329,48,165,35,2,29,279
Oklahoma,Leedey,531,90,204,52,12,9,367
Oklahoma,Oakwood,30,8,13,7,2,0,30
Oklahoma,Westville,1717,353,558,210,35,87,1243
Oklahoma,Ashland,35,7,12,4,0,5,28
Oklahoma,Kellyville,1233,200,436,162,38,55,891
Oklahoma,Clinton,9297,1677,3116,1274,73,567,6707
Oklahoma,Cromwell,242,52,88,33,4,16,193
Oklahoma,Sentinel,847,149,338,104,32,52,675
Oklahoma,Erin Springs,137,18,87,12,0,5,122
Oklahoma,Wilburton,2663,640,932,300,90,204,2166
Oklahoma,Waukomis,1462,260,739,114,10,59,1182
Oklahoma,Vinita,5478,1231,1766,808,152,414,4371
Oklahoma,Stidham,18,3,10,0,0,0,13
Oklahoma,Ochelata,433,67,209,43,3,26,348
Oklahoma,Stonewall,404,91,134,67,5,41,338
Oklahoma,Canton,480,62,209,75,0,40,386
Oklahoma,Cooperton,7,2,0,5,0,0,7
Oklahoma,Meeker,1236,240,391,216,22,99,968
Oklahoma,Rock Island,772,127,372,86,26,27,638
Oklahoma,Wynona,364,75,115,62,11,33,296
Oklahoma,Colony,136,10,72,12,2,6,102
Oklahoma,Dustin,457,145,81,92,23,46,387
Oklahoma,Shady Grove CDP (McIntosh County),235,56,144,27,0,0,227
Oklahoma,Bowlegs,378,71,155,46,4,22,298
Oklahoma,Pryor Creek,9402,1945,3751,1066,235,508,7505
Oklahoma,Caney,207,26,68,33,3,23,153
Oklahoma,Ralston,300,74,126,27,2,19,248
Oklahoma,Burlington,151,11,63,5,2,17,98
Oklahoma,Ninnekah,1166,190,548,69,13,64,884
Oklahoma,Seiling,893,207,337,75,5,41,665
Oklahoma,Tonkawa,3090,715,1158,338,41,183,2435
Oklahoma,Dacoma,89,27,27,12,0,12,78
Oklahoma,Soper,234,41,85,37,6,21,190
Oklahoma,Terral,422,88,164,51,7,34,344
Oklahoma,Bokoshe,448,69,182,56,4,48,359
Oklahoma,Union City,1532,359,683,196,14,72,1324
Oklahoma,Hinton,3232,765,1219,414,68,110,2576
Oklahoma,Jenks,21793,3800,9892,1554,120,743,16109
Oklahoma,Owasso,35646,7377,15035,3298,293,1388,27391
Oklahoma,Fort Towson,532,118,219,64,5,54,460
Oklahoma,Cayuga,146,24,80,8,1,23,136
Oklahoma,Cloud Creek,91,11,80,0,0,0,91
Oklahoma,Jay,2499,589,758,376,75,134,1932
Oklahoma,New Eucha,470,118,275,0,25,19,437
Oklahoma,Oaks,266,75,67,23,6,19,190
Oklahoma,West Siloam Springs,818,171,313,103,15,78,680
Oklahoma,Milburn,333,57,132,49,5,25,268
Oklahoma,Ada,17276,5459,5276,2104,221,973,14033
Oklahoma,Disney,204,24,86,29,10,37,186
Oklahoma,Boynton,196,40,51,30,4,14,139
Oklahoma,Olustee,678,105,264,73,0,6,448
Oklahoma,Sawyer,321,59,157,39,3,15,273
Oklahoma,Cornish,152,32,69,13,0,13,127
Oklahoma,Grandfield,864,145,335,73,35,72,660
Oklahoma,Webb City,47,12,15,14,2,1,44
Oklahoma,Hugo,5184,1327,1265,647,139,500,3878
Oklahoma,Fairfax,1384,226,561,134,35,143,1099
Oklahoma,Osage,135,20,60,21,2,16,119
Oklahoma,Salina,1210,225,438,167,23,135,988
Oklahoma,Arnett,585,128,258,71,4,57,518
Oklahoma,Braggs,271,31,112,23,13,11,190
Oklahoma,Hennessey,2584,404,1023,262,144,112,1945
Oklahoma,Loyal,111,14,62,3,0,5,84
Oklahoma,Tatums,126,60,22,16,5,8,111
Oklahoma,Wilson,1434,269,585,137,11,130,1132
Oklahoma,Iron Post,178,30,108,0,0,0,138
Oklahoma,Texola,62,26,17,5,0,14,62
Oklahoma,Big Cabin,213,29,104,21,5,19,178
Oklahoma,Breckenridge,209,23,115,19,3,7,167
Oklahoma,Strong City,40,0,15,13,0,2,30
Oklahoma,Kiefer,2462,386,1084,234,23,66,1793
Oklahoma,Dewey,3462,476,1217,651,72,262,2678
Oklahoma,Okeene,1152,171,410,207,9,118,915
Oklahoma,Laverne,1836,340,752,208,11,74,1385
Oklahoma,Vera,185,34,97,13,2,11,157
Oklahoma,Maysville,1196,228,457,121,29,90,925
Oklahoma,Hillsdale,95,20,46,12,3,5,86
Oklahoma,Fairmont,228,26,126,13,0,11,176
Oklahoma,Pink,2155,407,888,275,42,126,1738
Oklahoma,Muskogee,37900,8952,12720,4515,922,2670,29779
Oklahoma,Locust Grove,1541,323,420,266,28,93,1130
Oklahoma,Piedmont,7424,1452,3721,462,16,123,5774
Oklahoma,Dodge,96,7,69,0,0,0,76
Oklahoma,Grove,6862,1011,3144,1065,106,730,6056
Oklahoma,Ravia,528,56,200,91,18,33,398
Oklahoma,Ballou,295,43,181,22,0,0,246
Oklahoma,Panama,1244,195,443,178,39,103,958
Oklahoma,Warner,1493,479,441,183,15,120,1238
Oklahoma,Eakly,383,66,131,38,7,19,261
Oklahoma,Alex,546,120,204,74,6,38,442
Oklahoma,Chickasha,16297,3603,5685,2329,294,1027,12938
Oklahoma,Howe,941,287,301,91,15,58,752
Oklahoma,Brushy,1156,172,507,105,12,79,875
Oklahoma,Flute Springs,96,39,24,10,3,7,83
Oklahoma,Long,290,39,120,66,0,0,225
Oklahoma,Vian,1275,340,359,191,46,98,1034
Oklahoma,Cleora,1473,186,805,198,4,98,1291
Oklahoma,Colcord,991,219,363,88,35,48,753
Oklahoma,Dennis,165,17,89,0,8,9,123
Oklahoma,Tagg Flats,49,8,33,0,0,0,41
Oklahoma,Hollister,57,4,36,10,2,1,53
Oklahoma,Loveland,2,0,0,0,0,2,2
Oklahoma,Carmen,452,92,178,46,18,37,371
Oklahoma,Cherokee,1598,249,689,169,28,164,1299
Oklahoma,Freedom,331,48,150,18,4,13,233
Oklahoma,Tishomingo,3063,763,981,446,138,180,2508
Oklahoma,Old Eucha,25,5,16,3,0,0,24
Oklahoma,Rocky Ford,35,2,29,0,0,0,31
Oklahoma,Mannsville,955,142,382,127,10,49,710
Oklahoma,Mead,106,31,44,7,1,8,91
Oklahoma,Bokchito,691,120,257,80,25,57,539
Oklahoma,Achille,359,59,161,47,4,25,296
Oklahoma,Stringtown,406,55,174,46,2,46,323
Oklahoma,Fort Gibson,4063,763,1717,532,26,174,3212
Oklahoma,Oktaha,380,59,200,28,1,13,301
Oklahoma,River Bottom,260,21,138,39,4,15,217
Oklahoma,Sour John,88,11,54,5,0,3,73
Oklahoma,Devol,148,28,56,12,0,4,100
Oklahoma,Walters,2686,514,1128,252,79,168,2141
Oklahoma,Jennings,307,60,112,35,5,28,240
Oklahoma,Oak Grove,9,0,0,9,0,0,9
Oklahoma,Skedee,18,5,7,1,1,1,15
Oklahoma,Fair Oaks,95,25,39,6,0,15,85
Oklahoma,Okay,493,113,176,70,5,42,406
Oklahoma,Caddo,1221,270,512,87,35,121,1025
Oklahoma,Silo,426,74,191,48,1,15,329
Oklahoma,Colbert,1331,315,447,184,17,140,1103
Oklahoma,Allen,870,162,301,124,32,93,712
Oklahoma,Ryan,770,111,274,86,18,65,554
Oklahoma,Oakland,973,184,379,88,42,56,749
Oklahoma,El Reno,18714,4552,6383,2476,521,929,14861
Oklahoma,Cement,429,127,197,14,0,43,381
Oklahoma,Fort Coffee,435,102,153,54,17,27,353
Oklahoma,Poteau,8793,2092,3036,1151,172,632,7083
Oklahoma,Shady Point,1033,219,434,79,21,68,821
Oklahoma,Castle,123,27,45,20,0,2,94
Oklahoma,Gore,956,171,399,137,7,89,803
Oklahoma,Short,334,57,140,56,14,45,312
Oklahoma,Kingfisher,4861,970,1935,232,145,361,3643
Oklahoma,Ratliff City,116,34,48,6,0,4,92
Oklahoma,Rattan,309,45,121,36,8,29,239
Oklahoma,Carnegie,1875,439,582,236,61,136,1454
Oklahoma,Hoot Owl,0,0,0,0,0,0,0
Oklahoma,Armstrong,107,13,63,10,0,8,94
Oklahoma,Hammon,527,142,190,64,0,35,431
Oklahoma,Council Hill,124,16,56,11,2,13,98
Oklahoma,Porum,699,116,226,87,17,42,488
Oklahoma,Summit,113,31,46,8,6,8,99
Oklahoma,Cheyenne,835,86,260,127,18,46,537
Oklahoma,Lone Grove,5052,943,2113,598,11,174,3839
Oklahoma,Newkirk,2232,466,778,310,43,178,1775
Oklahoma,Tushka,289,68,120,33,5,9,235
Oklahoma,Thackerville,375,67,141,41,15,28,292
Oklahoma,Hartshorne,2087,432,727,284,64,133,1640
Oklahoma,Kiowa,657,138,223,76,19,49,505
Oklahoma,Bessie,159,32,69,30,0,13,144
Oklahoma,New Cordell,2851,585,1062,421,9,209,2286
Oklahoma,Douglas,20,10,2,3,0,3,18
Oklahoma,Renfrow,8,0,5,3,0,0,8
Oklahoma,Cashion,716,165,299,48,11,64,587
Oklahoma,McAlester,18095,3852,6320,2535,368,1302,14377
Oklahoma,Quinton,938,158,323,118,22,69,690
Oklahoma,Nicoma Park,2543,452,1142,342,5,113,2054
Oklahoma,Comanche,1565,266,563,250,27,148,1254
Oklahoma,Empire City,992,176,471,99,6,49,801
Oklahoma,Granite,1910,743,506,286,102,109,1746
Oklahoma,Seminole,7328,1792,2319,887,164,492,5654
Oklahoma,Canute,456,58,227,46,0,26,357
Oklahoma,Wann,110,20,57,12,2,1,92
Oklahoma,Maud,1143,229,418,139,11,52,849
Oklahoma,Wewoka,3367,813,868,488,79,346,2594
Oklahoma,Erick,962,202,387,122,0,78,789
Oklahoma,Copeland,1852,242,810,290,34,133,1509
Oklahoma,Horntown,124,14,54,12,4,5,89
Oklahoma,Wyandotte,370,83,122,46,11,19,281
Oklahoma,Inola,1894,390,735,228,25,87,1465
Oklahoma,Dotyville,134,14,74,0,0,25,113
Oklahoma,Stratford,1362,329,395,183,31,84,1022
Oklahoma,Hunter,219,28,105,16,2,14,165
Oklahoma,Cowlington,99,16,40,6,4,5,71
Oklahoma,Redbird,94,17,29,15,4,3,68
Oklahoma,Tipton,824,174,382,71,8,43,678
Oklahoma,Madill,3900,772,1369,632,46,215,3034
Oklahoma,Paden,481,78,200,45,16,34,373
Oklahoma,Taft,136,27,51,24,3,16,121
Oklahoma,Calera,2596,547,922,267,101,153,1990
Oklahoma,Harrah,6083,788,2974,569,72,469,4872
Oklahoma,Adair,873,154,373,58,15,35,635
Oklahoma,Foss,151,33,66,27,0,11,137
Oklahoma,Kendrick,100,20,36,15,0,12,83
Oklahoma,Peavine,431,95,199,65,0,11,370
Oklahoma,Chandler,3103,623,1075,379,68,216,2361
Oklahoma,Mangum,2837,539,987,445,85,179,2235
Oklahoma,Stilwell,4012,1041,1150,425,120,281,3017
Oklahoma,Haileyville,682,128,236,97,15,71,547
Oklahoma,Davenport,786,145,295,110,7,52,609
Oklahoma,Phillips,143,39,52,11,0,5,107
Oklahoma,Gene Autry,138,28,54,17,2,6,107
Oklahoma,Carrier,36,0,16,6,2,6,30
Oklahoma,Fargo,370,77,150,33,10,29,299
Oklahoma,Watonga,2900,846,1178,435,85,149,2693
Oklahoma,Rosedale,52,15,24,5,0,7,51
Oklahoma,Perry,4994,928,2238,388,101,337,3992
Oklahoma,Goldsby,2199,348,1094,175,24,109,1750
Oklahoma,Lamar,172,26,84,13,0,22,145
Oklahoma,Hitchita,81,23,25,10,0,5,63
Oklahoma,Rentiesville,131,23,57,28,2,12,122
Oklahoma,Heavener,3334,753,1261,351,90,150,2605
Oklahoma,Temple,983,150,445,116,15,68,794
Oklahoma,Hobart,3562,810,1275,371,86,272,2814
Oklahoma,Eldon,121,8,80,5,3,6,102
Oklahoma,Keys,442,60,225,59,0,14,358
Oklahoma,Zeb,583,104,236,68,19,41,468
Oklahoma,Coweta,9637,1857,3754,1111,100,499,7321
Oklahoma,Durant,17517,4862,5361,2310,447,1123,14103
Oklahoma,Francis,285,38,109,41,5,18,211
Oklahoma,Agra,294,60,131,25,3,20,239
Oklahoma,Midwest City,57292,14096,19806,6912,1349,3025,45188
Oklahoma,Central High,1106,163,623,83,11,74,954
Oklahoma,The Village,9385,3140,3144,1035,118,617,8054
Oklahoma,Duncan,22823,4458,8959,2617,444,1630,18108
Oklahoma,Willow,126,24,49,13,0,14,100
Oklahoma,Mulhall,237,42,105,26,8,13,194
Oklahoma,Orlando,112,16,49,9,7,2,83
Oklahoma,Le Flore,155,22,62,16,0,12,112
Oklahoma,Dwight Mission,53,0,35,0,0,0,35
Oklahoma,Wapanucka,407,97,105,69,9,22,302
Oklahoma,Oklahoma City,637284,164247,227971,65878,11333,26807,496236
Oklahoma,Fort Supply,427,90,149,57,15,29,340
Oklahoma,Wanette,281,62,95,42,8,20,227
Oklahoma,Ponca City,24424,5399,8651,3220,347,1604,19221
Oklahoma,Chattanooga,419,97,157,43,8,33,338
Oklahoma,Davidson,319,89,99,32,9,21,250
Oklahoma,Sharon,107,24,33,6,13,4,80
Oklahoma,Cameron,278,47,90,47,9,16,209
Oklahoma,Hydro,1041,194,419,104,5,88,810
Oklahoma,Bridgeport,83,18,37,10,2,9,76
Oklahoma,Binger,677,118,286,79,10,66,559
Oklahoma,Texanna,2400,358,1265,281,32,100,2036
Oklahoma,Drumright,2854,532,876,524,96,257,2285
Oklahoma,Longdale,389,71,127,37,9,27,271
Oklahoma,Paoli,664,129,245,73,24,45,516
Oklahoma,Sasakwa,107,28,32,13,1,6,80
Oklahoma,Geary,1245,214,455,131,24,67,891
Oklahoma,Norge,149,12,87,7,3,7,116
Oklahoma,Yukon,26317,5144,11204,2914,515,1248,21025
Oklahoma,Cyril,954,186,352,135,19,25,717
Oklahoma,Gracemont,258,71,84,31,7,18,211
Oklahoma,Wister,1031,184,410,147,29,88,858
Oklahoma,Belfonte,318,100,69,29,18,19,235
Oklahoma,Marble City,231,65,76,18,5,20,184
Oklahoma,Taloga,353,64,153,44,10,15,286
Oklahoma,Moffett,128,45,33,17,8,9,112
Oklahoma,Blackwell,6786,1204,2807,916,167,400,5494
Oklahoma,Davis,2808,586,1052,321,49,179,2187
Oklahoma,Dougherty,223,27,77,49,2,16,171
Oklahoma,Kansas,932,272,276,139,31,46,764
Oklahoma,Twin Oaks,244,60,114,26,28,8,236
Oklahoma,Bromide,109,14,62,13,2,12,103
Oklahoma,Chouteau,2124,306,978,141,52,150,1627
Oklahoma,Murphy,134,36,69,10,0,19,134
Oklahoma,Snake Creek,254,20,120,16,0,8,164
Oklahoma,Spavinaw,389,88,117,68,19,48,340
Oklahoma,Strang,85,18,29,14,1,7,69
Oklahoma,Asher,368,69,140,44,11,28,292
Oklahoma,Macomb,28,2,4,10,1,7,24
Oklahoma,Vici,710,127,294,144,25,52,642
Oklahoma,Langley,652,129,233,129,12,32,535
Oklahoma,Fitzhugh,263,27,97,10,49,15,198
Oklahoma,Bethel Acres,3136,463,1568,224,67,186,2508
Oklahoma,Dripping Springs,55,11,18,12,0,0,41
Oklahoma,Flint Creek,836,284,296,73,40,50,743
Oklahoma,Zena,130,14,53,27,0,0,94
Oklahoma,Cedar Crest,225,41,48,77,0,26,192
Oklahoma,Grand Lake Towne,81,6,51,10,2,4,73
Oklahoma,Wynnewood,2026,527,689,237,46,142,1641
Oklahoma,Red Oak,581,101,201,119,15,34,470
Oklahoma,Ketchum,426,93,162,51,6,42,354
Oklahoma,Welch,664,124,270,70,15,27,506
Oklahoma,Snyder,1467,243,510,194,35,153,1135
Oklahoma,Drummond,395,72,194,17,0,26,309
Oklahoma,North Enid,1059,173,532,81,3,55,844
Oklahoma,Gotebo,195,20,100,22,6,20,168
Oklahoma,Billings,598,243,147,46,13,21,470
Oklahoma,Calvin,316,61,81,36,0,38,216
Oklahoma,Gerty,59,6,36,2,1,4,49
Oklahoma,Wetumka,1325,363,271,214,50,133,1031
Oklahoma,Checotah,3188,733,1183,347,76,227,2566
Oklahoma,Valley Park,71,11,33,3,0,0,47
Oklahoma,Marland,316,76,90,47,3,9,225
Oklahoma,Sequoyah,893,204,403,60,25,25,717
Oklahoma,Eufaula,2886,499,1025,498,95,352,2469
Oklahoma,Cushing,7788,1960,2532,1022,198,524,6236
Oklahoma,Glencoe,521,88,272,59,3,29,451
Oklahoma,Stillwater,49527,24813,13413,2850,425,1487,42988
Oklahoma,Lindsay,2820,525,1130,383,55,301,2394
Oklahoma,Pauls Valley,6143,1527,2132,527,150,475,4811
Oklahoma,Quapaw,747,131,235,104,8,92,570
Oklahoma,New Alluwe,59,18,20,8,0,4,50
Oklahoma,Commerce,2293,516,805,241,65,159,1786
Oklahoma,Hitchcock,57,8,22,7,7,2,46
Oklahoma,Putnam,54,0,18,22,0,8,48
Oklahoma,Sulphur,5024,1229,1591,786,95,326,4027
Oklahoma,Addington,141,32,61,12,1,11,117
Oklahoma,Ringling,965,124,396,135,7,64,726
Oklahoma,Mustang,20735,3694,9022,2046,265,1218,16245
Oklahoma,Arkoma,1872,369,561,324,63,144,1461
Oklahoma,Cache,2886,592,1259,280,55,122,2308
Oklahoma,Webbers Falls,544,98,211,56,6,21,392
Oklahoma,Ramona,556,69,259,59,1,28,416
Oklahoma,Slaughterville,4294,783,1940,464,62,101,3350
Oklahoma,Elgin,3037,553,1395,165,50,65,2228
Oklahoma,Sterling,617,97,296,66,0,58,517
Oklahoma,May,58,23,18,7,0,0,48
Oklahoma,Newcastle,9657,1517,4993,641,39,467,7657
Oklahoma,Wayne,605,129,211,81,10,42,473
Oklahoma,Narcissa,126,14,96,7,0,0,117
Oklahoma,Lotsee,5,0,3,1,0,0,4
Oklahoma,Mannford,3184,546,1244,339,21,190,2340
Oklahoma,Haskell,2052,354,802,187,3,145,1491
Oklahoma,Reydon,140,43,40,16,4,16,119
Oklahoma,Healdton,2740,527,1085,279,15,317,2223
Oklahoma,Springer,622,117,230,69,15,62,493
Oklahoma,Braman,182,32,78,18,2,19,149
Oklahoma,Kildare,93,16,52,5,1,5,79
Oklahoma,Bartlesville,36448,6879,15496,4064,607,2158,29204
Oklahoma,Duchess Landing,65,0,49,0,0,16,65
Oklahoma,Yale,1176,278,444,149,13,67,951
Oklahoma,Lawton,94697,26422,31364,10329,1917,5117,75149
Oklahoma,South Coffeyville,781,105,365,86,12,46,614
Oklahoma,Konawa,1173,276,379,141,33,88,917
Oklahoma,Lima,67,4,39,4,0,5,52
Oklahoma,Carter,232,58,88,43,0,14,203
Oklahoma,Hickory,116,23,50,12,0,2,87
Oklahoma,Albion,93,26,31,9,2,8,76
Oklahoma,Clayton,676,146,215,108,4,66,539
Oklahoma,Woodward,12601,2484,5153,1317,115,599,9668
Oklahoma,Fairland,1139,260,366,160,26,68,880
Oklahoma,Tulsa,402223,108604,135262,47377,7972,18624,317839
Oklahoma,Guymon,11679,2920,4309,715,256,450,8650
Oklahoma,Atoka,3059,506,1090,383,79,216,2274
Oklahoma,Hendrix,70,16,28,4,3,11,62
Oklahoma,Leon,109,38,34,23,0,8,103
Oklahoma,Avant,269,35,124,29,9,22,219
Oklahoma,Frederick,3685,685,1448,368,70,243,2814
Oklahoma,Catoosa,7640,1770,3004,892,142,409,6217
Oklahoma,Keyes,248,39,113,16,4,18,190
Oklahoma,Alva,5154,1738,1841,487,112,207,4385
Oklahoma,Fort Cobb,627,104,261,76,20,37,498
Oklahoma,Lookeba,162,33,52,25,2,14,126
Oklahoma,Boley,1207,583,202,286,24,67,1162
Oklahoma,Rush Springs,1264,207,481,202,20,96,1006
Oklahoma,Verden,669,105,232,117,25,40,519
Oklahoma,Pocola,4066,641,1745,415,117,235,3153
Oklahoma,Anadarko,6664,1965,1510,855,119,497,4946
Oklahoma,Bradley,121,16,68,12,3,2,101
Oklahoma,Sportsmen Acres,351,90,117,28,9,13,257
Oklahoma,Hominy,3457,1215,844,609,87,231,2986
Oklahoma,Prue,410,61,157,45,10,42,315
Oklahoma,Limestone,879,153,504,19,0,65,741
Oklahoma,Gregory,169,44,77,7,0,0,128
Oklahoma,Talala,363,54,129,34,5,9,231
Oklahoma,Custer City,448,75,187,32,14,26,334
Oklahoma,Elk City,12046,2420,4685,1475,140,652,9372
Oklahoma,Spaulding,134,32,32,8,7,30,109
Oklahoma,Yeager,72,14,25,11,0,4,54
Oklahoma,Hanna,100,42,21,2,4,8,77
Oklahoma,Ripley,288,58,114,29,1,13,215
Oklahoma,Copan,804,123,302,107,49,44,625
Oklahoma,Etowah,137,32,63,11,3,6,115
Oklahoma,Lexington,2413,527,833,395,22,150,1927
Oklahoma,Noble,6718,1173,2767,692,222,318,5172
Oklahoma,Faxon,72,4,43,2,0,6,55
Oklahoma,Geronimo,1006,196,444,108,12,64,824
Oklahoma,Medicine Park,291,47,128,82,2,17,276
Oklahoma,Rosston,55,7,18,5,9,2,41
Oklahoma,Dickson,1333,217,600,77,15,100,1009
Oklahoma,Byars,171,28,85,17,1,12,143
Oklahoma,Minco,1603,321,723,117,57,88,1306
Oklahoma,Tuttle,6982,1369,3454,402,108,253,5586
Oklahoma,Bearden,138,14,72,2,2,2,92
Oklahoma,Clearview,27,5,7,2,2,8,24
Oklahoma,Akins,558,147,226,36,0,25,434
Oklahoma,Evening Shade,305,10,178,16,37,38,279
Oklahoma,Notchietown,184,57,82,26,0,10,175
Oklahoma,Kinta,290,57,83,33,2,30,205
Oklahoma,Woodall,835,181,401,73,21,26,702
Oklahoma,Butler,242,36,116,39,5,15,211
Oklahoma,Pin Oak Acres,484,54,255,55,0,9,373
Oklahoma,Sams Corner,160,24,114,0,0,9,147
Oklahoma,Brooksville,50,10,25,11,0,1,47
Oklahoma,Purcell,6380,1197,2602,729,100,422,5050
Oklahoma,Wainwright,142,23,59,17,0,5,104
Oklahoma,Roff,678,73,326,32,5,41,477
Oklahoma,Gage,533,76,166,86,27,49,404
Oklahoma,Burbank,84,13,29,24,2,7,75
Oklahoma,Pawhuska,3516,780,1242,516,15,286,2839
Oklahoma,Shattuck,1291,209,550,106,11,70,946
Oklahoma,Dover,324,82,102,55,18,16,273
Oklahoma,Cole,761,122,366,50,6,26,570
Oklahoma,Miami,13335,3387,4206,1707,241,906,10447
Oklahoma,Headrick,96,29,36,3,4,5,77
Oklahoma,Fairview,2620,332,1189,200,41,246,2008
Oklahoma,Pocasset,164,27,65,27,1,11,131
Oklahoma,Boise City,1076,178,442,90,7,122,839
Oklahoma,Byron,39,2,32,0,0,0,34
Oklahoma,Lambert,5,1,4,0,0,0,5
Oklahoma,Fanshawe,402,58,161,44,8,37,308
Oklahoma,Spiro,2604,483,988,328,32,229,2060
Oklahoma,Roland,3646,825,1230,467,88,193,2803
Oklahoma,Goltry,233,22,137,17,0,9,185
Oklahoma,Muldrow,3276,920,939,463,66,290,2678
Oklahoma,Paradise Hill,79,7,48,0,0,3,58
Oklahoma,Park Hill,3969,1047,1419,280,43,222,3011
Oklahoma,Wright City,730,157,228,111,13,34,543
Oklahoma,Pettit,829,157,409,81,0,15,662
Oklahoma,Shady Grove CDP (Cherokee County),467,87,180,57,12,25,361
Oklahoma,Whitefield,457,81,178,51,4,23,337
Oklahoma,Blackburn,83,10,45,5,2,3,65
Oklahoma,Hallett,117,15,63,11,0,2,91
Oklahoma,Terlton,93,20,43,2,1,5,71
Oklahoma,Wagoner,8808,1779,3319,1017,127,632,6874
Oklahoma,Byng,1269,225,630,99,9,23,986
Oklahoma,Helena,1508,407,380,493,37,70,1387
Oklahoma,Broken Arrow,107500,20919,48204,9767,1159,3954,84003
Oklahoma,Valliant,790,190,269,87,14,84,644
Oklahoma,Simms,244,23,154,19,3,9,208
Oklahoma,Weatherford,11973,4607,4112,663,84,524,9990
Oklahoma,Waurika,2148,456,769,284,63,157,1729
Oklahoma,Kingston,1714,309,637,247,20,148,1361
Oklahoma,Apache,1415,264,511,230,49,77,1131
Oklahoma,Sayre,4598,1416,1231,913,126,131,3817
Oklahoma,Bluejacket,300,95,117,34,3,15,264
Oklahoma,Atwood,58,14,18,6,0,4,42
Oklahoma,Stuart,181,54,67,11,0,17,149
Oklahoma,Pensacola,109,32,48,13,0,0,93
Oklahoma,Pump Back,178,39,98,13,0,16,166
Oklahoma,Tecumseh,6625,1229,2692,781,86,342,5130
Oklahoma,Lost City,894,185,364,101,12,57,719
Oklahoma,Keota,534,97,162,53,26,46,384
Oklahoma,Tamaha,114,14,68,11,0,20,113
Oklahoma,Garvin,286,53,105,32,0,9,199
Oklahoma,Bixby,25818,4412,11991,2033,194,962,19592
Oklahoma,Tullahassee,157,8,78,13,3,5,107
Oklahoma,Liberty,195,43,97,14,3,6,163
Oklahoma,Oakhurst,2364,415,962,326,65,148,1916
Oklahoma,Sand Springs,19864,3851,8374,2051,323,1224,15823
Oklahoma,Boswell,636,164,162,74,11,56,467
Oklahoma,Sugden,36,7,18,5,0,2,32
Oklahoma,Tahlequah,16592,5887,4706,1984,209,844,13630
Oklahoma,Tenkiller,673,216,230,59,0,28,533
Oklahoma,Randlett,376,97,136,60,7,17,317
Oklahoma,McCurtain,449,66,208,33,2,18,327
Oklahoma,Maramec,120,15,53,6,0,15,89
Oklahoma,Jet,242,38,127,13,0,20,198
Oklahoma,Tribbey,335,59,165,44,1,26,295
Oklahoma,Waynoka,1093,239,321,84,69,99,812
Oklahoma,Dewar,852,165,342,68,21,46,642
Oklahoma,Morris,1413,333,514,155,7,85,1094
Oklahoma,Goodwell,1353,768,270,87,25,16,1166
Oklahoma,Indiahoma,355,62,134,37,2,31,266
Oklahoma,Washington,735,172,284,76,9,16,557
Oklahoma,Glenpool,13313,2677,5701,1148,125,442,10093
Oklahoma,Indianola,137,26,54,18,1,11,110
Oklahoma,Pittsburg,208,58,84,23,0,12,177
Oklahoma,Savanna,686,132,302,65,25,27,551
Oklahoma,Rocky,181,35,110,15,5,5,170
Oklahoma,Delaware,438,92,165,55,10,32,354
Oklahoma,Nowata,3674,763,1256,464,167,304,2954
Oklahoma,Enid,50612,10400,19856,5155,718,2957,39086
Oklahoma,Garber,848,170,302,88,6,52,618
Oklahoma,Turley,2615,677,876,383,159,132,2227
Oklahoma,Lone Wolf,409,40,185,54,2,23,304
Oklahoma,Mountain View,674,85,343,80,10,50,568
Oklahoma,Mountain Park,500,108,182,62,8,15,375
Oklahoma,Covington,512,67,217,57,5,28,374
Oklahoma,Lahoma,518,109,233,55,0,29,426
Oklahoma,Roosevelt,331,91,91,38,3,34,257
Oklahoma,Red Rock,380,60,152,43,10,24,289
Oklahoma,Bushyhead,1169,237,524,122,27,86,996
Oklahoma,Arapaho,897,134,373,50,24,56,637
Oklahoma,Thomas,1280,223,540,176,15,94,1048
Oklahoma,Hastings,73,7,27,20,5,8,67
Oklahoma,Capron,0,0,0,0,0,0,0
Oklahoma,Guthrie,11165,2955,3604,1544,278,866,9247
Oklahoma,Centrahoma,68,8,20,7,1,11,47
Oklahoma,Bernice,513,59,235,98,12,48,452
Oklahoma,Valley Brook,936,250,277,90,10,89,716
Oklahoma,Gans,267,51,82,38,8,28,207
Oklahoma,Sallisaw,8547,1514,3059,1291,219,612,6695
Oklahoma,Millerton,295,67,133,22,3,14,239
Oklahoma,Smithville,85,7,32,11,0,5,55
Oklahoma,Westport,484,69,255,31,12,44,411
Oklahoma,Kenefic,169,34,62,12,3,14,125
Oklahoma,Hollis,1921,338,835,199,54,91,1517
Oklahoma,Barnsdall,1140,176,509,102,21,92,900
Oklahoma,Woodlawn Park,171,33,88,23,0,9,153
Oklahoma,Shidler,328,53,130,40,15,27,265
Oklahoma,Aline,149,27,67,10,4,15,123
Oklahoma,Greasy,267,79,113,36,6,25,259
Oklahoma,Crescent,1325,342,407,157,36,165,1107
Oklahoma,Langston,1238,1039,89,37,0,25,1190
Oklahoma,McCord,1570,251,780,114,28,116,1289
Oklahoma,Bell,424,89,150,42,3,26,310
Oklahoma,Hoffman,106,18,41,15,6,9,89
Oklahoma,Jones,3024,539,1211,361,54,146,2311
Oklahoma,Tryon,540,157,192,49,0,34,432
Oklahoma,Nash,221,14,130,7,0,28,179
Oklahoma,Jefferson,8,0,6,0,0,0,6
Oklahoma,Altus,19034,4399,7562,1594,487,992,15034
Oklahoma,Smith Village,79,25,39,4,0,6,74
Oklahoma,Bristow,4194,829,1156,615,187,343,3130
Oklahoma,Zion,24,7,13,0,0,0,20
Oklahoma,West Peavine,399,112,112,70,9,19,322
Oklahoma,Rocky Mountain,447,105,183,49,8,39,384
Oklahoma,Chewey,66,6,52,4,0,0,62
Oklahoma,Slick,163,38,60,25,1,5,129
Oregon,Gresham,110770,29298,40738,11079,1797,4858,87770
Oregon,Wilsonville,23418,5580,9464,2915,339,957,19255
Oregon,Sherwood,19337,3359,8648,1520,133,510,14170
Oregon,Hillsboro,104730,24926,44938,9070,1210,2716,82860
Oregon,Gaston,546,105,209,82,9,39,444
Oregon,Mehama,192,33,79,9,0,8,129
Oregon,Sublimity,2899,328,1427,310,14,253,2332
Oregon,Donald,1287,204,572,169,28,52,1025
Oregon,Deschutes River Woods,5775,1488,2546,635,0,155,4824
Oregon,Sandy,10834,2348,4147,1062,272,647,8476
Oregon,Woodburn,25417,5512,8815,2882,450,1027,18686
Oregon,Dallas,15805,3686,6636,1859,242,833,13256
Oregon,Scio,766,183,294,93,38,13,621
Oregon,Wood Village,4036,1361,1014,306,61,90,2832
Oregon,Haines,357,69,168,58,0,25,320
Oregon,Eagle Point,9015,1634,3899,1122,78,472,7205
Oregon,Nyssa,3175,656,1078,286,36,133,2189
Oregon,Mount Vernon,472,135,163,101,2,31,432
Oregon,North Powder,490,66,199,24,28,29,346
Oregon,Winston,5406,1143,1725,652,223,427,4170
Oregon,Clatskanie,1668,356,624,211,8,121,1320
Oregon,Depoe Bay,1772,374,1014,218,0,58,1664
Oregon,Barview,2066,422,981,223,62,145,1833
Oregon,Coos Bay,16176,3639,5595,2247,410,1334,13225
Oregon,Harrisburg,3741,700,1427,301,98,88,2614
Oregon,Monmouth,10131,4745,2922,514,131,161,8473
Oregon,Eola,0,0,0,0,0,0,0
Oregon,Raleigh Hills,5892,1319,2710,473,103,567,5172
Oregon,Sisters,2555,529,1088,357,27,73,2074
Oregon,Sweet Home,9435,1902,3065,1245,318,780,7310
Oregon,Amity,1782,335,610,244,34,98,1321
Oregon,Klamath Falls,21138,5590,7257,3080,364,988,17279
Oregon,Port Orford,950,268,376,158,13,108,923
Oregon,Huntington,361,83,126,60,10,45,324
Oregon,Jacksonville,2873,425,1495,397,0,232,2549
Oregon,Shady Cove,3041,323,1693,315,21,237,2589
Oregon,White City,8953,2370,3294,982,139,283,7068
Oregon,Astoria,9747,2422,3815,1361,121,573,8292
Oregon,Cannon Beach,1489,423,513,248,28,81,1293
Oregon,Fairview,9303,1940,4036,1075,231,329,7611
Oregon,Maywood Park,998,208,469,100,0,37,814
Oregon,Rufus,193,46,70,19,13,30,178
Oregon,Grants Pass,37201,8393,13896,4612,600,2160,29661
Oregon,Portland,639387,220992,222452,67085,9293,21149,540971
Oregon,Terrebonne,1626,196,923,132,0,105,1356
Oregon,Four Corners,16045,4138,5798,1653,109,887,12585
Oregon,Hubbard,3399,545,1378,305,33,80,2341
Oregon,Jefferson,3270,737,1478,245,11,96,2567
Oregon,Mill City,1691,352,671,283,38,95,1439
Oregon,Butte Falls,412,142,114,43,24,30,353
Oregon,Arlington,508,149,168,69,14,18,418
Oregon,Rockcreek,9898,2080,4876,965,34,219,8174
Oregon,West Haven-Sylvan,8434,2231,3755,1006,45,301,7338
Oregon,Idanha,161,43,60,29,0,12,144
Oregon,Halfway,319,40,134,73,0,34,281
Oregon,Lonerock,10,2,3,4,0,1,10
Oregon,Keizer,38479,9681,14491,4162,555,1716,30605
Oregon,Tygh Valley,201,58,61,43,14,4,180
Oregon,Gardiner,382,116,89,39,0,37,281
Oregon,Warrenton,5453,972,2273,776,118,193,4332
Oregon,Idaville,356,57,224,22,0,24,327
Oregon,Juntura,35,6,15,8,2,0,31
Oregon,Kerby,1075,505,160,252,0,0,917
Oregon,Kings Valley,161,55,47,10,0,49,161
Oregon,Lacomb,820,80,429,24,0,25,558
Oregon,Langlois,89,32,50,0,0,7,89
Oregon,Lookingglass,910,129,443,180,9,40,801
Oregon,Melrose,679,182,379,30,0,51,642
Oregon,Merlin,1856,339,991,208,30,72,1640
Oregon,Mount Hood,409,71,158,10,0,0,239
Oregon,Mulino,2413,508,1130,213,0,65,1916
Oregon,Nesika Beach,352,93,230,29,0,0,352
Oregon,New Hope,1317,157,854,141,10,31,1193
Oregon,New Pine Creek,67,0,30,18,0,19,67
Oregon,O'Brien,406,122,109,125,0,50,406
Oregon,Peoria,184,49,101,13,0,0,163
Oregon,Pistol River,115,0,38,33,0,44,115
Oregon,Plush,66,8,38,8,0,4,58
Oregon,Pronghorn,50,0,50,0,0,0,50
Oregon,Prospect,409,88,245,19,11,26,389
Oregon,Ruch,721,117,453,60,0,13,643
Oregon,Selma,658,90,357,88,0,62,597
Oregon,Seventh Mountain,348,30,283,12,0,16,341
Oregon,Shedd,563,303,95,0,0,10,408
Oregon,Silver Lake,83,11,59,6,0,0,76
Oregon,Stafford,1807,297,980,124,0,81,1482
Oregon,Imbler,361,77,167,24,0,24,292
Oregon,Holley,333,66,133,57,0,20,276
Oregon,Gold Beach,2208,395,883,451,37,167,1933
Oregon,Harper,118,6,58,10,0,9,83
Oregon,Glasgow,809,95,426,112,0,53,686
Oregon,Troutdale,16559,4188,6638,1667,143,374,13010
Oregon,Umatilla,7114,2328,1795,1251,141,111,5626
Oregon,Redmond,29234,6642,11824,3657,405,1246,23774
Oregon,Three Rivers,3593,873,1554,562,17,145,3151
Oregon,Gates,542,92,241,76,18,51,478
Oregon,Labish Village,466,117,159,84,0,0,360
Oregon,Scotts Mills,462,94,169,60,11,15,349
Oregon,King City,3807,524,1463,782,32,424,3225
Oregon,Grand Ronde,1745,257,862,212,17,102,1450
Oregon,Metzger,3477,769,1314,587,30,68,2768
Oregon,West Slope,7498,1937,3187,948,94,225,6391
Oregon,Falls City,1162,284,447,153,25,38,947
Oregon,Central Point,18130,3325,7699,1989,206,883,14102
Oregon,Cascade Locks,1109,189,454,124,2,68,837
Oregon,Milwaukie,20955,5801,7644,2940,254,1228,17867
Oregon,Biggs Junction,26,26,0,0,0,0,26
Oregon,Moro,324,44,125,52,2,23,246
Oregon,La Pine,2188,647,745,232,88,126,1838
Oregon,The Dalles,15320,3311,5888,1698,256,1132,12285
Oregon,Crawfordsville,431,132,213,31,0,26,402
Oregon,Days Creek,296,44,133,46,11,19,253
Oregon,Deer Island,196,55,80,39,0,16,190
Oregon,Dillard,371,18,202,0,71,16,307
Oregon,Fort Hill,81,0,68,0,0,13,81
Oregon,Eagle Crest,2191,188,1736,141,9,83,2157
Oregon,Fair Oaks,254,39,172,8,9,14,242
Oregon,Foots Creek,610,150,219,81,38,48,536
Oregon,Government Camp,166,26,75,16,15,15,147
Oregon,Medford,80051,17909,30042,9667,1445,4329,63392
Oregon,Warm Springs,3311,1286,455,383,61,161,2346
Oregon,Hayesville,22272,5876,7658,1944,424,1015,16917
Oregon,Philomath,4702,973,2037,453,54,125,3642
Oregon,Canyon City,848,135,368,61,27,68,659
Oregon,Lakeview,2765,599,980,338,92,180,2189
Oregon,Paisley,338,45,162,43,0,23,273
Oregon,La Grande,13103,3800,4440,1534,297,693,10764
Oregon,Granite,12,0,0,12,0,0,12
Oregon,Monument,90,13,38,11,0,17,79
Oregon,Rainier,2109,413,772,386,79,100,1750
Oregon,Rose Lodge,1359,233,543,237,88,118,1219
Oregon,Bunker Hill,1986,576,614,238,0,86,1514
Oregon,Powers,1048,191,376,141,26,110,844
Oregon,Lowell,1173,182,548,117,25,64,936
Oregon,Chenoweth,2053,430,863,176,29,67,1565
Oregon,Springfield,61525,17025,20755,8192,1171,2738,49881
Oregon,Waterloo,265,60,117,23,12,8,220
Oregon,Wallowa,853,158,364,81,23,44,670
Oregon,Mosier,431,85,171,52,7,20,335
Oregon,Wamic,62,22,25,5,10,0,62
Oregon,Lafayette,4105,961,1976,218,34,96,3285
Oregon,Yamhill,1353,323,598,115,6,27,1069
Oregon,Adair Village,1189,278,512,64,7,21,882
Oregon,Corvallis,57213,26979,18059,3423,456,1723,50640
Oregon,Glide,1235,244,572,211,39,39,1105
Oregon,Elkton,226,15,110,29,7,33,194
Oregon,Willamina,2412,577,823,294,43,138,1875
Oregon,Gladstone,12045,3051,4109,1564,89,788,9601
Oregon,Sodaville,481,136,185,57,12,15,405
Oregon,Joseph,1005,216,486,89,14,101,906
Oregon,Lebanon,16599,3392,6804,1575,150,1247,13168
Oregon,Pine Grove,102,0,58,37,0,0,95
Oregon,Enterprise,1990,318,863,219,39,147,1586
Oregon,Maupin,535,102,269,61,3,49,484
Oregon,Dundee,3219,692,1551,183,22,84,2532
Oregon,Island City,1028,170,545,68,3,75,861
Oregon,Union,2066,467,879,203,47,183,1779
Oregon,Oakland,829,180,325,131,14,39,689
Oregon,Riddle,1331,296,497,151,20,77,1041
Oregon,Summit,128,45,38,30,0,0,113
Oregon,Milton-Freewater,7035,1353,2723,616,150,223,5065
Oregon,Pilot Rock,1445,309,618,113,18,103,1161
Oregon,Weston,748,153,301,47,14,47,562
Oregon,Johnson City,500,80,211,111,14,34,450
Oregon,Toledo,3540,790,1562,294,34,198,2878
Oregon,Waldport,2043,477,862,217,64,99,1719
Oregon,Yachats,669,116,293,109,15,69,602
Oregon,Bandon,3072,553,1329,338,1,338,2559
Oregon,Oakridge,3261,1221,959,422,96,151,2849
Oregon,Dufur,576,82,272,66,0,36,456
Oregon,Newberg,23167,6461,8729,2669,229,733,18821
Oregon,Chiloquin,980,277,270,130,31,52,760
Oregon,Elgin,1382,232,540,211,24,150,1157
Oregon,Seneca,233,39,104,29,6,20,198
Oregon,Canby,17527,3475,7723,1692,145,713,13748
Oregon,Prineville,9748,2327,3516,1295,87,764,7989
Oregon,Irrigon,2095,469,857,197,31,51,1605
Oregon,Cape Meares,88,12,56,0,0,11,79
Oregon,Netarts,792,130,328,119,40,45,662
Oregon,Canyonville,1787,360,701,137,62,183,1443
Oregon,Parkdale,407,137,145,60,0,8,350
Oregon,Hebo,159,13,146,0,0,0,159
Oregon,Stanfield,2751,647,1107,269,13,119,2155
Oregon,Shaniko,14,2,0,8,0,0,10
Oregon,Rowena,301,45,121,21,0,0,187
Oregon,Yoncalla,1121,200,430,135,40,122,927
Oregon,Altamont,18987,3836,7277,2442,238,1240,15033
Oregon,Summerville,173,30,94,6,1,9,140
Oregon,Ione,332,60,148,42,10,12,272
Oregon,Scappoose,7125,1522,2667,872,82,376,5519
Oregon,Millersburg,1646,304,810,113,32,74,1333
Oregon,Dayville,127,17,66,26,1,6,116
Oregon,Boardman,3340,862,1335,120,36,114,2467
Oregon,Condon,655,55,339,106,0,89,589
Oregon,Salem,166756,44990,59309,18751,2808,7132,132990
Oregon,Antelope,74,9,31,12,2,8,62
Oregon,Mount Angel,3502,1069,1325,389,53,188,3024
Oregon,Independence,9556,2246,3470,811,225,312,7064
Oregon,Gearhart,1531,226,778,179,3,90,1276
Oregon,Prairie City,636,98,294,80,21,39,532
Oregon,McMinnville,33662,7993,12648,3516,539,1987,26683
Oregon,Madras,6674,2165,1859,742,146,234,5146
Oregon,Coburg,1144,235,527,116,32,40,950
Oregon,Brownsville,1867,400,787,200,22,78,1487
Oregon,Stayton,8025,1308,3295,948,93,274,5918
Oregon,Aurora,1254,243,566,118,16,24,967
Oregon,Wasco,371,72,185,69,2,11,339
Oregon,Tangent,1137,203,550,113,11,35,912
Oregon,Forest Grove,23923,6444,9369,1844,472,1115,19244
Oregon,Rivergrove,509,59,281,38,0,16,394
Oregon,Columbia City,2065,437,1017,232,19,123,1828
Oregon,Metolius,1038,178,414,69,8,32,701
Oregon,Lyons,1141,190,544,89,13,70,906
Oregon,Sheridan,6106,1577,2323,1019,140,259,5318
Oregon,Cove,728,78,342,88,0,53,561
Oregon,Monroe,715,165,311,63,13,21,573
Oregon,Culver,1838,436,570,205,35,47,1293
Oregon,Greenhorn,8,0,8,0,0,0,8
Oregon,John Day,2251,529,765,273,61,159,1787
Oregon,Long Creek,166,18,83,14,1,8,124
Oregon,Cottage Grove,10083,2275,3620,1391,235,627,8148
Oregon,Creswell,5291,1056,2119,902,61,112,4250
Oregon,Junction City,5946,1210,2132,913,47,269,4571
Oregon,Westfir,252,75,106,41,4,15,241
Oregon,Halsey,919,156,456,75,12,32,731
Oregon,Aumsville,4058,1077,1243,429,31,150,2930
Oregon,Brooks,570,145,249,21,0,34,449
Oregon,Detroit,79,7,59,9,0,4,79
Oregon,Marion,485,111,293,0,0,0,404
Oregon,Richland,228,16,122,14,5,17,174
Oregon,Unity,67,9,29,23,2,2,65
Oregon,Gold Hill,1343,270,525,239,13,72,1119
Oregon,Oatfield,13531,2557,7087,1111,111,852,11718
Oregon,Silverton,10028,1962,3891,1107,219,576,7755
Oregon,Oak Hills,11962,2747,5093,913,49,366,9168
Oregon,Tigard,52368,12826,22175,5050,680,2013,42744
Oregon,Tualatin,27338,6631,12138,2510,287,667,22233
Oregon,Phoenix,4536,1051,1614,861,61,503,4090
Oregon,Rogue River,2563,406,1038,423,35,242,2144
Oregon,Seaside,6643,1736,2235,1013,161,547,5692
Oregon,Adams,429,93,169,44,2,24,332
Oregon,Sunriver,1302,67,771,161,13,58,1070
Oregon,Tri-City,4090,862,1566,618,75,223,3344
Oregon,Tetherow,534,26,317,22,0,0,365
Oregon,Glendale,826,162,277,133,24,41,637
Oregon,Roseburg North,5207,912,1977,909,116,431,4345
Oregon,North Plains,2427,577,1138,258,17,74,2064
Oregon,Cornelius,12575,3428,4519,914,221,444,9526
Oregon,Cedar Mill,17897,3518,8060,1610,122,505,13815
Oregon,Aloha,55492,13482,22043,5252,622,1797,43196
Oregon,Fossil,503,76,221,60,14,51,422
Oregon,Ukiah,255,96,79,63,0,4,242
Oregon,Tutuilla,447,123,191,41,4,35,394
Oregon,Riverside,202,56,57,27,0,8,148
Oregon,Pendleton,16713,4905,5640,2144,243,720,13652
Oregon,Kirkpatrick,159,47,59,12,0,10,128
Oregon,Cave Junction,2323,446,809,386,107,134,1882
Oregon,Garden Home-Whitford,6666,1394,3270,634,46,292,5636
Oregon,Myrtle Creek,3435,565,1436,468,75,197,2741
Oregon,Cedar Hills,8480,2259,3581,858,40,255,6993
Oregon,Turner,2284,405,1023,212,35,128,1803
Oregon,Gervais,2666,889,782,145,115,72,2003
Oregon,Butteville,241,42,105,0,0,31,178
Oregon,West Linn,26511,5034,12995,2386,181,709,21305
Oregon,St. Paul,449,80,199,26,2,12,319
Oregon,Oak Grove,17183,4585,6744,2171,249,1027,14776
Oregon,Molalla,9082,1835,3509,1009,39,255,6647
Oregon,Mitchell,75,9,33,14,3,15,74
Oregon,Mission,924,291,233,101,16,39,680
Oregon,Neskowin,187,0,140,0,18,29,187
Oregon,Beaver,110,0,30,73,0,7,110
Oregon,Roseburg,22988,5063,8599,3221,398,1731,19012
Oregon,Reedsport,4072,787,1614,622,121,260,3404
Oregon,Green,7695,1736,3252,912,136,484,6520
Oregon,Banks,1811,411,772,144,10,24,1361
Oregon,Lexington,195,36,83,17,0,10,146
Oregon,Sutherlin,7941,1770,3310,888,168,334,6470
Oregon,Heppner,1093,196,542,79,4,97,918
Oregon,Takilma,367,99,194,0,0,47,340
Oregon,Siletz,1497,412,541,168,17,102,1240
Oregon,Prescott,82,12,55,5,0,8,80
Oregon,Ontario,10997,2925,3265,1276,270,609,8345
Oregon,Florence,8815,1646,4226,985,169,864,7890
Oregon,Malin,970,205,428,73,2,42,750
Oregon,Bay City,1514,282,637,204,31,120,1274
Oregon,Jennings Lodge,8138,1984,3072,703,153,513,6425
Oregon,Happy Valley,19471,3902,9458,1291,214,433,15298
Oregon,Cloverdale,396,75,200,12,0,22,309
Oregon,Albany,52736,13014,20488,5983,670,2338,42493
Oregon,Eugene,165997,60939,55031,17655,1872,6327,141824
Oregon,North Bend,9615,1897,3870,1104,156,573,7600
Oregon,Lakeside,1766,157,1015,257,8,131,1568
Oregon,Winchester Bay,378,112,209,31,0,26,378
Oregon,Coquille,3856,919,1620,486,69,340,3434
Oregon,Vernonia,1851,320,873,267,13,99,1572
Oregon,St. Helens,13446,3366,4391,1973,187,812,10729
Oregon,Cayuse,71,16,22,4,6,7,55
Oregon,Lincoln City,8684,1980,3399,1214,135,574,7302
Oregon,Lostine,326,19,174,26,3,23,245
Oregon,Vale,2016,486,612,238,22,145,1503
Oregon,Jordan Valley,155,14,82,20,0,16,132
Oregon,Dayton,2643,541,1169,160,21,73,1964
Oregon,Echo,693,134,320,75,9,20,558
Oregon,Tillamook,5176,1251,1510,856,153,382,4152
Oregon,Rockaway Beach,1213,254,465,200,33,104,1056
Oregon,Pacific City,1037,237,478,96,0,10,821
Oregon,Manzanita,333,15,227,46,14,22,324
Oregon,Garibaldi,864,193,415,95,5,75,783
Oregon,Bonanza,439,129,165,40,10,26,370
Oregon,Carlton,2032,501,748,157,25,158,1589
Oregon,Myrtle Point,2506,473,1024,396,53,207,2153
Oregon,Merrill,745,126,403,53,6,13,601
Oregon,Talent,6424,1754,2224,925,67,328,5298
Oregon,Beatty,0,0,0,0,0,0,0
Oregon,Neahkahnie,85,28,31,18,0,8,85
Oregon,Jeffers Gardens,305,49,103,76,0,33,261
Oregon,Wimer,369,32,208,51,0,78,369
Oregon,Williams,1126,142,643,138,0,50,973
Oregon,Westport,200,0,156,34,0,10,200
Oregon,Warren,2053,319,1094,135,16,103,1667
Oregon,Wallowa Lake,15,0,15,0,0,0,15
Oregon,West Scio,175,0,58,35,0,0,93
Oregon,Umapine,313,66,183,34,0,7,290
Oregon,Tumalo,615,93,353,57,12,13,528
Oregon,Damascus,12024,2640,6025,947,62,528,10202
Oregon,Crooked River Ranch,4051,671,2118,669,56,179,3693
Oregon,Barlow,119,26,57,13,0,4,100
Oregon,Crane,99,12,36,10,0,3,61
Oregon,Cascadia,192,41,62,23,6,0,132
Oregon,Camp Sherman,228,6,166,24,0,2,198
Oregon,Bull Mountain,9591,1919,4833,660,28,205,7645
Oregon,Brogan,137,8,69,0,0,8,85
Oregon,Blodgett,60,0,60,0,0,0,60
Oregon,Black Butte Ranch,217,48,79,0,0,90,217
Oregon,Bellfountain,8,0,0,0,0,8,8
Oregon,Beavercreek,4322,701,2414,311,6,206,3638
Oregon,Bayside Gardens,785,113,324,116,36,91,680
Oregon,Annex,288,69,98,34,2,13,216
Oregon,Alsea,256,42,49,37,9,3,140
Oregon,Alpine,180,0,108,19,0,0,127
Oregon,Trail,594,75,387,90,0,0,552
Oregon,Pine Hollow,509,53,274,73,18,55,473
Oregon,Crabtree,778,147,321,57,0,0,525
Oregon,Estacada,3270,561,1358,302,105,206,2532
Oregon,Bethany,24396,3478,12357,1292,115,782,18024
Oregon,Oregon City,36040,7791,14908,4198,495,1292,28684
Oregon,Adrian,218,46,70,36,0,21,173
Oregon,Mount Hood Village,4587,769,2368,676,60,93,3966
Oregon,Harbor,2044,329,702,573,46,384,2034
Oregon,Brookings,6413,1400,2837,952,61,345,5595
Oregon,South Lebanon,777,176,420,80,11,18,705
Oregon,Veneta,4891,897,2002,474,66,235,3674
Oregon,Newport,10381,2445,4109,1405,154,609,8722
Oregon,Lincoln Beach,1810,235,887,267,2,251,1642
Oregon,Bend,90500,19774,38690,10199,882,3851,73396
Oregon,Lake Oswego,38705,6911,19884,3581,270,1637,32283
Oregon,Durham,1724,402,707,195,11,34,1349
Oregon,Odell,2194,585,952,86,0,8,1631
Oregon,Hood River,7688,2216,2863,763,117,373,6332
Oregon,Burns,2756,640,1155,345,68,129,2337
Oregon,Hermiston,17346,4050,6416,1266,179,723,12634
Oregon,Dunes City,1178,203,698,107,3,106,1117
Oregon,Gopher Flats,400,88,178,51,6,30,353
Oregon,Helix,129,23,50,14,0,7,94
Oregon,Baker City,9738,1970,3981,1287,121,708,8067
Oregon,Sumpter,187,14,100,48,2,23,187
Oregon,Redwood,2707,266,1350,282,74,250,2222
Oregon,Rickreall,70,0,40,0,0,0,40
Oregon,Ashland,20912,7051,7361,2769,278,938,18397
Oregon,Oceanside,352,0,126,137,0,74,337
Oregon,Drain,945,238,371,110,41,75,835
Oregon,Grass Valley,199,62,74,15,3,14,168
Oregon,Spray,204,37,108,3,6,17,171
Oregon,Hines,1451,232,657,207,22,92,1210
Oregon,Beaverton,97012,25623,39354,10131,1457,3429,79994
Oregon,Nehalem,481,174,169,29,6,12,390
Oregon,Wheeler,327,69,136,48,12,34,299
Oregon,Athena,1323,279,658,70,18,61,1086
Pennsylvania,Evansburg,2272,466,1180,110,31,41,1828
Pennsylvania,Halfway House,2810,605,1279,222,45,48,2199
Pennsylvania,Plymouth Meeting,6557,1435,2920,457,126,481,5419
Pennsylvania,Rockledge borough,2537,672,948,315,60,118,2113
Pennsylvania,Doylestown borough,8307,2226,3086,988,156,829,7285
Pennsylvania,New Hope borough,2513,670,1198,287,24,100,2279
Pennsylvania,Perkasie borough,8502,2268,3437,905,128,311,7049
Pennsylvania,Langhorne borough,1553,485,621,110,3,174,1393
Pennsylvania,Newtown borough,1953,418,1020,172,44,72,1726
Pennsylvania,Churchville,4011,821,2170,174,5,174,3344
Pennsylvania,Vanderbilt borough,331,96,126,32,5,23,282
Pennsylvania,McAdoo borough,2380,638,746,264,92,126,1866
Pennsylvania,Republic,1230,314,523,109,68,43,1057
Pennsylvania,Leith-Hatfield,2472,472,1463,122,39,164,2260
Pennsylvania,Marlin,438,23,252,68,0,26,369
Pennsylvania,Mahanoy City borough,4018,1448,796,311,86,396,3037
Pennsylvania,Donaldson,245,74,104,14,6,10,208
Pennsylvania,Mill Village borough,363,69,161,42,7,30,309
Pennsylvania,Sand Hill,2253,352,1069,349,66,37,1873
Pennsylvania,Fredericksburg CDP (Lebanon County),1644,313,626,143,23,87,1192
Pennsylvania,Silverdale borough,751,188,335,60,16,32,631
Pennsylvania,Weissport borough,448,138,114,54,10,30,346
Pennsylvania,East Side borough,297,66,133,30,2,23,254
Pennsylvania,Smithfield borough,795,139,358,50,14,39,600
Pennsylvania,Burnham borough,1997,397,777,228,34,161,1597
Pennsylvania,Meadville,12949,4665,3663,1576,207,828,10939
Pennsylvania,Monument,197,15,55,66,0,25,161
Pennsylvania,Portersville borough,277,60,144,32,1,5,242
Pennsylvania,Mercersburg borough,1695,481,567,226,88,85,1447
Pennsylvania,Sugar Grove borough,641,127,314,50,0,21,512
Pennsylvania,Bear Lake borough,192,83,81,6,0,7,177
Pennsylvania,Woodland Heights,1239,221,572,89,33,56,971
Pennsylvania,Pleasantville borough (Venango County),833,168,364,75,8,65,680
Pennsylvania,Clintonville borough,438,81,172,50,4,43,350
Pennsylvania,Barkeyville borough,352,62,152,34,6,9,263
Pennsylvania,Montrose borough,1710,474,492,324,11,187,1488
Pennsylvania,Titusville,5337,1490,1937,503,145,402,4477
Pennsylvania,Spartansburg borough,283,53,134,28,11,11,237
Pennsylvania,Milesburg borough,964,204,400,130,0,37,771
Pennsylvania,Fredericksburg CDP (Crawford County),1038,61,473,114,0,75,723
Pennsylvania,Blooming Valley borough,269,44,140,19,7,22,232
Pennsylvania,Harmony borough,995,216,445,74,5,44,784
Pennsylvania,Lower Allen,6937,1541,3007,943,11,447,5949
Pennsylvania,Wheatland borough,664,176,246,91,11,66,590
Pennsylvania,New Lebanon borough,216,27,100,22,0,8,157
Pennsylvania,Mercer borough,1698,388,650,217,49,129,1433
Pennsylvania,Goldsboro borough,1205,250,445,58,28,59,840
Pennsylvania,East York,8459,1697,3687,1061,113,514,7072
Pennsylvania,Deemston borough,812,157,337,93,17,67,671
Pennsylvania,Montgomery borough,1564,332,664,118,31,50,1195
Pennsylvania,Pine Glen,177,50,56,20,8,8,142
Pennsylvania,Conneaut Lakeshore,2457,461,1248,292,17,154,2172
Pennsylvania,Colwyn borough,2554,995,533,211,93,127,1959
Pennsylvania,Union City borough,3213,519,1292,276,38,361,2486
Pennsylvania,Franklin borough,225,57,78,37,2,26,200
Pennsylvania,Girard borough,3003,852,1011,284,144,185,2476
Pennsylvania,Valley Green,4220,942,1660,447,146,112,3307
Pennsylvania,Stewartstown borough,1994,277,910,256,22,125,1590
Pennsylvania,Red Lion borough,6320,1359,2036,804,143,451,4793
Pennsylvania,Hanover borough,15563,3463,5802,1791,395,1122,12573
Pennsylvania,Roseville borough,114,18,59,9,3,15,104
Pennsylvania,Elkland borough,1903,465,652,263,115,81,1576
Pennsylvania,Newmanstown,2443,617,805,213,40,139,1814
Pennsylvania,Jonestown borough,1935,497,721,152,21,71,1462
Pennsylvania,Fort Indiantown Gap,87,17,55,0,0,0,72
Pennsylvania,Avon,1488,323,676,159,7,90,1255
Pennsylvania,Annville,4903,2329,1343,402,25,287,4386
Pennsylvania,Tresckow,1017,334,412,77,7,57,887
Pennsylvania,Pottstown borough,22694,5930,7831,2452,481,1087,17781
Pennsylvania,Pottsgrove,3268,512,1827,134,37,217,2727
Pennsylvania,Narberth borough,4350,1026,1954,394,75,109,3558
Pennsylvania,East Greenville borough,2958,769,1187,183,62,88,2289
Pennsylvania,Tremont borough,1801,430,652,157,17,218,1474
Pennsylvania,Rouseville borough,487,150,162,41,0,38,391
Pennsylvania,Village Shires,3796,819,1664,263,18,438,3202
Pennsylvania,Penndel borough,3013,955,1067,188,76,157,2443
Pennsylvania,Loretto borough,1195,1072,90,14,0,10,1186
Pennsylvania,Slippery Rock borough,3567,2463,525,141,29,193,3351
Pennsylvania,Lawrence Park,3839,968,1445,394,91,204,3102
Pennsylvania,Wesleyville borough,3204,771,1245,395,36,126,2573
Pennsylvania,Mechanicsville borough,462,119,180,49,2,26,376
Pennsylvania,Mount Carbon borough,67,27,28,4,3,3,65
Pennsylvania,Clarion borough,5436,2503,1432,506,63,266,4770
Pennsylvania,Leetsdale borough,1237,330,441,121,33,77,1002
Pennsylvania,Everett borough,1872,526,538,275,95,164,1598
Pennsylvania,Tarentum borough,4441,1355,1562,428,127,144,3616
Pennsylvania,Houtzdale borough,684,177,297,57,15,34,580
Pennsylvania,Warminster Heights,3948,1403,1169,361,93,175,3201
Pennsylvania,Spring Hill,801,137,356,22,35,73,623
Pennsylvania,Factoryville borough,1232,572,355,109,15,31,1082
Pennsylvania,Clearfield borough,5970,1394,2285,753,93,472,4997
Pennsylvania,Millersburg borough,2546,539,1086,181,31,204,2041
Pennsylvania,Jerseytown,82,3,64,3,0,3,73
Pennsylvania,Collingdale borough,8790,3063,2415,840,188,473,6979
Pennsylvania,Manns Choice borough,245,70,85,26,4,7,192
Pennsylvania,Avis borough,1353,337,570,114,29,99,1149
Pennsylvania,Wilkinsburg borough,15637,6414,3645,2085,376,1085,13605
Pennsylvania,Grantley,3901,2122,918,214,39,220,3513
Pennsylvania,Felton borough,519,105,232,40,7,18,402
Pennsylvania,Cross Roads borough,503,109,259,46,5,14,433
Pennsylvania,Liberty borough (Tioga County),269,44,96,24,3,18,185
Pennsylvania,Riverside borough,2093,312,1054,183,32,91,1672
Pennsylvania,Valley View CDP (Schuylkill County),1562,466,587,194,33,74,1354
Pennsylvania,Schuylkill Haven borough,5211,1082,2311,515,159,145,4212
Pennsylvania,Ravine,625,124,293,58,0,52,527
Pennsylvania,Orwigsburg borough,2990,476,1413,302,38,231,2460
Pennsylvania,Ulysses borough,728,149,261,61,7,66,544
Pennsylvania,Cochranton borough,1189,237,474,135,6,45,897
Pennsylvania,West Conshohocken borough,1349,451,574,122,19,61,1227
Pennsylvania,Conneautville borough,721,152,254,99,4,64,573
Pennsylvania,New Alexandria borough,603,136,362,28,4,48,578
Pennsylvania,Herminie,474,125,158,61,0,45,389
Pennsylvania,Monessen,7397,2077,2689,660,229,595,6250
Pennsylvania,New Britain borough,2977,1215,1018,229,36,115,2613
Pennsylvania,Troutville borough,244,39,105,26,0,17,187
Pennsylvania,Grampian borough,396,97,174,24,1,31,327
Pennsylvania,Irvona borough,627,122,316,48,8,37,531
Pennsylvania,Sankertown borough,637,126,260,63,6,44,499
Pennsylvania,Bristol borough,9614,3034,3020,1091,279,477,7901
Pennsylvania,Rainsburg borough,66,19,27,5,0,7,58
Pennsylvania,Bedford borough,2734,659,1046,267,53,266,2291
Pennsylvania,Hampton,667,106,177,112,0,0,395
Pennsylvania,Bendersville borough,802,195,304,51,5,37,592
Pennsylvania,Schellsburg borough,325,105,141,21,2,18,287
Pennsylvania,Carrolltown borough,857,227,350,70,20,65,732
Pennsylvania,Ashville borough,173,44,91,13,1,9,158
Pennsylvania,Renovo borough,1089,287,365,115,51,101,919
Pennsylvania,Loganton borough,491,110,217,32,1,31,391
Pennsylvania,Paint borough,902,240,303,73,13,185,814
Pennsylvania,Meyersdale borough,1958,514,680,206,30,231,1661
Pennsylvania,Iola,212,61,108,4,3,7,183
Pennsylvania,Aristes,337,70,173,29,18,27,317
Pennsylvania,Sylvania borough,222,66,81,36,4,10,197
Pennsylvania,Scottdale borough,4191,902,1743,488,141,273,3547
Pennsylvania,Slickville,233,14,173,17,11,0,215
Pennsylvania,Economy borough,9207,1342,5263,648,68,604,7925
Pennsylvania,Industry borough,1759,359,846,136,17,121,1479
Pennsylvania,Hallam borough,2660,704,976,264,17,144,2105
Pennsylvania,Lykens borough,1673,345,668,177,62,84,1336
Pennsylvania,Rupert,203,43,95,18,6,0,162
Pennsylvania,Millville borough,899,186,341,118,15,59,719
Pennsylvania,Lime Ridge,822,138,336,126,7,65,672
Pennsylvania,New Centerville borough,135,21,68,11,6,9,115
Pennsylvania,Jerome,757,146,416,38,0,98,698
Pennsylvania,Wilmerding borough,1949,772,263,275,71,84,1465
Pennsylvania,Salisbury borough,808,143,394,79,15,54,685
Pennsylvania,Georgetown borough,138,22,65,15,0,11,113
Pennsylvania,East Rochester borough,491,136,187,69,4,32,428
Pennsylvania,South Waverly borough,1062,235,556,82,15,40,928
Pennsylvania,Ambridge borough,6787,2487,1896,771,182,353,5689
Pennsylvania,Enola,6574,2147,1997,664,129,415,5352
Pennsylvania,Conway borough,2141,427,966,173,30,185,1781
Pennsylvania,Camp Hill borough,7911,1384,3727,663,58,433,6265
Pennsylvania,Sheakleyville borough,212,51,76,17,8,9,161
Pennsylvania,Fredonia borough,465,114,159,56,14,26,369
Pennsylvania,West Middletown borough,108,20,44,18,0,10,92
Pennsylvania,Marianna borough,483,158,162,26,19,21,386
Pennsylvania,Donora borough,4635,1467,1455,380,101,324,3727
Pennsylvania,Baidland,1360,232,774,106,0,58,1170
Pennsylvania,Kulpmont borough,2816,747,1146,226,75,273,2467
Pennsylvania,Green Hills borough,27,6,14,0,0,2,22
Pennsylvania,Newville borough,1276,388,389,156,44,70,1047
Pennsylvania,Conneaut Lake borough,731,148,298,91,10,42,589
Pennsylvania,Rome borough,500,134,136,45,13,31,359
Pennsylvania,Saxton borough,729,198,226,95,6,37,562
Pennsylvania,Waynesburg borough,4057,1853,1257,173,97,160,3540
Pennsylvania,Wilburton Number Two,81,19,36,7,0,4,66
Pennsylvania,Slabtown,115,23,44,14,3,17,101
Pennsylvania,Youngsville borough,1798,417,752,160,38,123,1490
Pennsylvania,Freeport borough,1841,422,626,231,111,93,1483
Pennsylvania,Jeddo borough,293,107,127,1,5,25,265
Pennsylvania,Shelocta borough,86,23,11,20,3,5,62
Pennsylvania,Marion Center borough,449,92,189,73,15,15,384
Pennsylvania,Homer City borough,1755,393,731,174,21,148,1467
Pennsylvania,Port Royal borough,830,161,355,106,29,71,722
Pennsylvania,Woodside,2468,393,1514,40,12,35,1994
Pennsylvania,Trainer borough,1704,561,375,112,54,132,1234
Pennsylvania,Millbourne borough,1287,394,558,25,11,25,1013
Pennsylvania,Beech Creek borough,775,199,328,88,0,55,670
Pennsylvania,Shrewsbury borough,3838,812,1840,227,30,327,3236
Pennsylvania,Shiloh,11206,2455,5143,763,84,1131,9576
Pennsylvania,New Freedom borough,4618,860,2095,314,105,293,3667
Pennsylvania,Loganville borough,1329,263,631,77,12,37,1020
Pennsylvania,Franklintown borough,423,133,120,74,18,21,366
Pennsylvania,Fawn Grove borough,458,83,188,56,12,28,367
Pennsylvania,Emmaus borough,11361,2633,4779,1285,232,522,9451
Pennsylvania,Tidioute borough,747,128,331,77,18,85,639
Pennsylvania,Worthington borough,676,217,243,101,2,52,615
Pennsylvania,Throop borough,3967,983,1683,333,35,230,3264
Pennsylvania,Moosic borough,5744,1544,2360,452,64,408,4828
Pennsylvania,Mount Cobb,1913,284,937,18,0,141,1380
Pennsylvania,Clairton,6640,2728,1756,575,132,407,5598
Pennsylvania,Cooperstown borough,411,101,176,30,10,24,341
Pennsylvania,Le Raysville borough,292,66,121,18,10,3,218
Pennsylvania,Roscoe borough,801,195,365,69,14,46,689
Pennsylvania,Finleyville borough,305,112,94,20,7,21,254
Pennsylvania,Sheffield,1211,294,427,76,6,117,920
Pennsylvania,Plainfield,390,67,169,94,0,37,367
Pennsylvania,Sewickley Heights borough,770,118,440,33,0,28,619
Pennsylvania,Rosslyn Farms borough,436,68,257,22,2,19,368
Pennsylvania,North Braddock borough,4758,1683,1072,485,74,351,3665
Pennsylvania,Elizabeth borough,1477,418,502,162,21,109,1212
Pennsylvania,East Pittsburgh borough,1755,704,172,186,42,100,1204
Pennsylvania,Woodbury borough,270,59,123,23,5,12,222
Pennsylvania,Dormont borough,8438,3242,3056,612,106,332,7348
Pennsylvania,Rheems,1349,149,729,100,14,174,1166
Pennsylvania,Elizabethtown borough,11492,4278,4190,917,94,417,9896
Pennsylvania,Big Run borough,451,92,225,32,7,23,379
Pennsylvania,Mill Creek borough,356,74,160,43,8,23,308
Pennsylvania,White Oak borough,7621,1651,3443,597,82,800,6573
Pennsylvania,West Mifflin borough,19946,5582,8262,1493,236,1491,17064
Pennsylvania,New Holland borough,5455,1303,2432,515,142,179,4571
Pennsylvania,McKees Rocks borough,5966,2504,1064,616,190,324,4698
Pennsylvania,Homestead borough,3153,1343,595,211,27,246,2422
Pennsylvania,Emsworth borough,2541,811,956,237,31,130,2165
Pennsylvania,Duquesne,5544,2115,889,556,92,370,4022
Pennsylvania,Willow Street,8360,1408,4543,594,24,855,7424
Pennsylvania,St. Clairsville borough,62,10,27,15,7,2,61
Pennsylvania,Hatboro borough,7428,2225,2898,543,75,438,6179
Pennsylvania,Stroudsburg borough,5501,1818,1385,780,258,314,4555
Pennsylvania,Armagh borough,110,17,50,16,0,12,95
Pennsylvania,Mifflintown borough,1080,297,388,114,25,35,859
Pennsylvania,Tullytown borough,1922,595,702,189,24,145,1655
Pennsylvania,Espy,1658,426,791,126,0,69,1412
Pennsylvania,Bloomsburg,14275,8289,2457,1333,222,531,12832
Pennsylvania,Waymart borough,1318,315,431,140,4,190,1080
Pennsylvania,New Baltimore borough,185,32,107,11,0,13,163
Pennsylvania,Hooversville borough,621,99,305,39,15,53,511
Pennsylvania,Boswell borough,1345,296,595,141,43,70,1145
Pennsylvania,Russellton,1447,272,734,197,0,87,1290
Pennsylvania,Oakmont borough,6450,1611,2695,748,95,496,5645
Pennsylvania,Laporte borough,314,90,104,26,7,68,295
Pennsylvania,Springdale borough,3353,859,1347,347,47,227,2827
Pennsylvania,Sharpsburg borough,3374,1288,778,621,100,178,2965
Pennsylvania,Sewickley Hills borough,701,102,377,43,4,31,557
Pennsylvania,Aldan borough,4156,1246,1739,339,21,311,3656
Pennsylvania,Martinsburg borough,1756,268,814,223,0,188,1493
Pennsylvania,Duncansville borough,1244,269,499,192,14,94,1068
Pennsylvania,Courtdale borough,635,147,319,27,2,61,556
Pennsylvania,Smicksburg borough,43,7,22,4,0,3,36
Pennsylvania,Plumville borough,289,56,140,27,7,15,245
Pennsylvania,Ernest borough,514,77,235,40,10,11,373
Pennsylvania,Creekside borough,318,90,133,12,8,19,262
Pennsylvania,Black Lick,1718,426,558,300,20,114,1418
Pennsylvania,Commodore,429,119,105,69,0,44,337
Pennsylvania,Shamokin Dam borough,1926,423,686,184,53,190,1536
Pennsylvania,Heilwood,571,124,303,26,15,12,480
Pennsylvania,Freeland borough,3451,792,1029,334,101,404,2660
Pennsylvania,Benton borough,746,171,311,35,7,75,599
Pennsylvania,Yorkana borough,237,57,104,18,2,5,186
Pennsylvania,York,44044,17402,9877,3998,1293,1519,34089
Pennsylvania,Eagles Mere borough,140,14,93,13,0,6,126
Pennsylvania,Whitehall borough,13759,3118,6166,1048,128,1024,11484
Pennsylvania,Whitaker borough,1135,458,356,95,18,48,975
Pennsylvania,Berlin borough,1995,403,926,172,33,219,1753
Pennsylvania,Trappe borough,3583,845,1700,259,5,158,2967
Pennsylvania,New Berlin borough,938,158,495,43,10,33,739
Pennsylvania,Yeadon borough,11487,4295,3183,867,382,837,9564
Pennsylvania,Morrisville borough,8588,2478,3196,879,114,352,7019
Pennsylvania,Hermitage,15812,3049,7256,1553,133,1543,13534
Pennsylvania,Coal Center borough,76,30,14,14,0,2,60
Pennsylvania,Claysville borough,929,174,397,95,31,70,767
Pennsylvania,Sligo borough,493,84,208,44,18,41,395
Pennsylvania,Callensburg borough,109,24,36,15,0,10,85
Pennsylvania,Tatamy borough,969,196,475,56,0,34,761
Pennsylvania,Glendon borough,475,123,167,27,5,22,344
Pennsylvania,Freemansburg borough,2621,771,807,342,66,152,2138
Pennsylvania,East Bangor borough,1003,244,342,67,25,53,731
Pennsylvania,Chapman borough,192,35,97,15,7,7,161
Pennsylvania,Paxtonville,267,25,166,15,0,5,211
Pennsylvania,Lucerne Mines,798,267,330,185,0,16,798
Pennsylvania,Elco borough,272,77,95,27,5,25,229
Pennsylvania,Hazleton,24812,7494,7741,2231,717,1376,19559
Pennsylvania,Levittown,51726,14064,21850,3393,793,2966,43066
Pennsylvania,Plymptonville,1194,332,533,108,16,101,1090
Pennsylvania,Worthville borough,71,11,47,3,0,2,63
Pennsylvania,Reynoldsville borough,2692,684,884,354,134,163,2219
Pennsylvania,Shirleysburg borough,150,32,56,14,4,10,116
Pennsylvania,Mapleton borough,417,79,184,19,6,27,315
Pennsylvania,Dudley borough,208,58,91,12,8,12,181
Pennsylvania,Coalmont borough,92,17,51,5,0,5,78
Pennsylvania,Mount Union borough,2401,667,765,317,66,167,1982
Pennsylvania,Export borough,906,190,356,110,13,49,718
Pennsylvania,Derry borough,2572,566,1065,313,58,155,2157
Pennsylvania,Perryopolis borough,1880,340,898,160,48,163,1609
Pennsylvania,Ohiopyle borough,25,0,15,0,0,0,15
Pennsylvania,Hopwood,1958,545,807,135,6,129,1622
Pennsylvania,Tionesta borough,326,46,161,31,5,50,293
Pennsylvania,Bryn Mawr,3740,2137,792,276,58,160,3423
Pennsylvania,Blue Bell,6212,1194,3288,334,91,286,5193
Pennsylvania,West Mayfield borough,1150,256,494,91,29,51,921
Pennsylvania,South Heights borough,369,95,165,50,8,14,332
Pennsylvania,Sutersville borough,471,107,167,46,16,40,376
Pennsylvania,Centerville borough (Washington County),3189,765,1304,326,29,214,2638
Pennsylvania,California borough,6441,3241,1853,404,159,269,5926
Pennsylvania,Allenport borough,505,103,220,61,16,48,448
Pennsylvania,Laceyville borough,447,146,152,42,11,17,368
Pennsylvania,West York borough,4571,1663,881,523,298,198,3563
Pennsylvania,Christiana borough,1007,256,404,55,17,94,826
Pennsylvania,Columbia borough,10389,2718,3410,1087,215,890,8320
Pennsylvania,Pine Ridge,2560,708,1146,212,28,117,2211
Pennsylvania,Manheim borough,4878,942,1945,786,98,194,3965
Pennsylvania,Brisbin borough,343,69,166,32,8,29,304
Pennsylvania,Dublin borough,2123,599,836,221,30,74,1760
Pennsylvania,East McKeesport borough,2106,544,828,198,24,160,1754
Pennsylvania,Lancaster,59503,23076,16241,4917,1628,1784,47646
Pennsylvania,Brickerville,1491,381,843,38,0,36,1298
Pennsylvania,Saltillo borough,302,81,125,29,0,11,246
Pennsylvania,Wernersville borough,2759,610,1105,268,21,325,2329
Pennsylvania,Reading,88211,31307,20296,7390,3859,2965,65817
Pennsylvania,Lenhartsville borough,156,31,51,18,5,8,113
Pennsylvania,Muncy borough,2320,514,927,208,75,136,1860
Pennsylvania,Belleville,1726,312,767,118,30,315,1542
Pennsylvania,Hyde,1334,256,616,103,21,125,1121
Pennsylvania,Zion,2092,409,1121,40,0,132,1702
Pennsylvania,Blanchard,587,137,265,77,12,34,525
Pennsylvania,Bellefonte borough,6289,1529,2548,638,47,498,5260
Pennsylvania,Laurel Run borough,566,172,239,82,13,22,528
Pennsylvania,Laflin borough,1566,384,724,99,7,121,1335
Pennsylvania,Avoca borough,2620,764,1024,246,39,191,2264
Pennsylvania,Ashley borough,2733,841,860,381,83,102,2267
Pennsylvania,Rossiter,657,242,251,33,4,40,570
Pennsylvania,Glen Campbell borough,259,21,110,19,2,14,166
Pennsylvania,Plains,3997,1116,1555,432,5,364,3472
Pennsylvania,Pikes Creek,445,166,147,19,6,25,363
Pennsylvania,Penryn,940,232,460,56,0,15,763
Pennsylvania,Madisonburg,233,30,111,14,0,0,155
Pennsylvania,Pringle borough,907,296,342,83,8,42,771
Pennsylvania,Lansdale borough,16579,4806,6594,1458,187,768,13813
Pennsylvania,Central City borough,1073,243,521,110,13,82,969
Pennsylvania,Homewood borough,106,37,40,18,1,7,103
Pennsylvania,Darlington borough,211,63,66,15,2,16,162
Pennsylvania,Tuscarora,958,215,410,85,5,57,772
Pennsylvania,Minersville borough,4227,1079,1651,403,51,216,3400
Pennsylvania,Friedensburg,904,89,444,108,45,62,748
Pennsylvania,Coaldale borough (Schuylkill County),2162,596,690,225,49,198,1758
Pennsylvania,Beurys Lake,133,16,69,6,2,6,99
Pennsylvania,Wattsburg borough,498,86,230,31,6,32,385
Pennsylvania,Stowe,3699,1054,1342,343,75,266,3080
Pennsylvania,Pennsburg borough,3882,963,1496,415,75,201,3150
Pennsylvania,Oreland,5827,1682,2414,377,54,239,4766
Pennsylvania,North Wales borough,3260,801,1381,310,23,160,2675
Pennsylvania,Montgomeryville,13271,3060,6276,905,95,514,10850
Pennsylvania,Glenside,7558,2127,3120,545,64,342,6198
Pennsylvania,Fort Washington,5559,1188,2778,356,37,162,4521
Pennsylvania,Flourtown,4524,813,2166,244,61,234,3518
Pennsylvania,Cheswick borough,1715,370,865,123,38,130,1526
Pennsylvania,Brackenridge borough,3203,967,854,418,59,303,2601
Pennsylvania,Jenkintown borough,4442,874,1937,363,85,296,3555
Pennsylvania,Pennville,1937,337,702,285,20,229,1573
Pennsylvania,Jacobus borough,1853,411,851,128,18,46,1454
Pennsylvania,Dallastown borough,3822,648,1522,585,109,235,3099
Pennsylvania,Blossburg borough,1909,353,806,213,26,73,1471
Pennsylvania,Eastvale borough,210,47,84,12,2,23,168
Pennsylvania,Ellwood City borough,7972,1885,3194,754,167,529,6529
Pennsylvania,Freedom borough,1537,365,537,180,34,74,1190
Pennsylvania,Midland borough,3003,1108,726,174,85,309,2402
Pennsylvania,Mountainhome,1073,276,393,144,36,169,1018
Pennsylvania,East Stroudsburg borough,10279,3980,2990,737,535,404,8646
Pennsylvania,Wellersburg borough,210,29,106,7,2,15,159
Pennsylvania,Seven Springs borough,20,5,4,5,1,5,20
Pennsylvania,Belmont,2452,548,1017,182,29,403,2179
Pennsylvania,Mill Hall borough,1642,374,668,173,17,89,1321
Pennsylvania,Lock Haven,9345,4432,2123,759,103,493,7910
Pennsylvania,Orangeville borough,433,80,172,41,0,70,363
Pennsylvania,Lightstreet,914,172,382,118,8,94,774
Pennsylvania,Jamison City,138,24,51,23,0,17,115
Pennsylvania,Foundryville,96,15,54,10,0,17,96
Pennsylvania,Williamstown borough,1187,298,419,164,31,90,1002
Pennsylvania,Centralia borough,7,2,4,1,0,0,7
Pennsylvania,Sayre borough,5491,1611,1859,586,141,365,4562
Pennsylvania,Pleasantville borough (Bedford County),144,28,67,16,1,10,122
Pennsylvania,Pocono Pines,972,143,485,38,25,127,818
Pennsylvania,Prompton borough,273,70,131,27,2,15,245
Pennsylvania,Bethany borough,217,68,95,19,0,11,193
Pennsylvania,Casselman borough,76,18,42,3,0,4,67
Pennsylvania,Callimont borough,67,5,46,1,0,2,54
Pennsylvania,Addison borough,258,53,123,16,2,8,202
Pennsylvania,Troy borough,1534,480,539,177,13,90,1299
Pennsylvania,Monroe borough,576,137,211,44,8,50,450
Pennsylvania,Ambler borough,6488,1944,2468,512,101,338,5363
Pennsylvania,Almedia,999,194,441,148,5,75,863
Pennsylvania,Delaware Water Gap borough,636,135,275,78,0,37,525
Pennsylvania,Honesdale borough,4308,871,1317,677,218,432,3515
Pennsylvania,Etna borough,3388,1190,1088,303,78,124,2783
Pennsylvania,Bradford,8424,2553,2323,887,323,639,6725
Pennsylvania,Richland borough,1544,310,734,150,5,74,1273
Pennsylvania,Quentin,620,135,220,76,22,14,467
Pennsylvania,Pleasant Hill,2825,790,795,287,99,137,2108
Pennsylvania,Palmyra borough,7498,1855,2549,1049,176,444,6073
Pennsylvania,Myerstown borough,3178,898,1104,370,41,221,2634
Pennsylvania,Mount Gretna borough,225,20,177,6,0,1,204
Pennsylvania,Lebanon South,2317,403,947,327,23,167,1867
Pennsylvania,North East borough,4138,1118,1536,394,35,252,3335
Pennsylvania,Erie,98156,34260,27388,9797,2480,5393,79318
Pennsylvania,Skippack,4116,702,1803,460,49,94,3108
Pennsylvania,King of Prussia,20428,5070,9560,1385,189,1054,17258
Pennsylvania,Red Hill borough,2498,551,1022,307,43,175,2098
Pennsylvania,Spring Mount,2338,508,1091,173,32,16,1820
Pennsylvania,Aliquippa,9066,3035,2309,1270,371,664,7649
Pennsylvania,West Leechburg borough,1428,319,684,120,20,92,1235
Pennsylvania,Trafford borough,3039,642,1294,251,85,192,2464
Pennsylvania,Smithton borough,460,105,175,64,3,18,365
Pennsylvania,Seward borough,393,112,169,36,3,28,348
Pennsylvania,North Irwin borough,911,199,379,86,20,49,733
Pennsylvania,New Stanton borough,2351,490,1081,171,48,108,1898
Pennsylvania,New Florence borough,660,111,288,65,13,48,525
Pennsylvania,Lawson Heights,2245,381,1176,165,1,141,1864
Pennsylvania,Grapeville,284,91,36,122,0,17,266
Pennsylvania,Penn Wynne,5758,1069,2792,388,0,459,4708
Pennsylvania,Hopewell borough,303,88,88,14,10,25,225
Pennsylvania,Eldred borough,649,127,272,78,2,64,543
Pennsylvania,Lewis Run borough,666,158,333,40,8,42,581
Pennsylvania,Curtisville,1097,381,399,152,0,61,993
Pennsylvania,Coraopolis borough,5587,1759,2013,448,153,317,4690
Pennsylvania,Churchill borough,2963,500,1543,237,39,155,2474
Pennsylvania,Castle Shannon borough,8229,2178,3243,895,162,514,6992
Pennsylvania,Bellevue borough,8196,3343,2643,746,174,440,7346
Pennsylvania,Paradise,1201,341,522,79,22,23,987
Pennsylvania,Brodheadsville,1459,459,578,197,10,99,1343
Pennsylvania,Swissvale borough,8808,3190,2551,1111,228,442,7522
Pennsylvania,Mayfield borough,1753,388,778,156,38,97,1457
Pennsylvania,Hatfield borough,3332,970,1291,218,63,138,2680
Pennsylvania,Mount Wolf borough,1720,403,656,212,17,74,1362
Pennsylvania,Kane borough,3557,802,1196,523,74,296,2891
Pennsylvania,Tyrone borough,5281,1461,1708,470,62,581,4282
Pennsylvania,Confluence borough,583,141,226,68,7,57,499
Pennsylvania,West Homestead borough,1778,571,665,139,22,126,1523
Pennsylvania,Versailles borough,1631,604,454,168,41,196,1463
Pennsylvania,Pine Grove Mills,1168,191,583,156,0,117,1047
Pennsylvania,North Philipsburg,613,81,233,50,0,190,554
Pennsylvania,Spring Mills,419,186,113,21,17,24,361
Pennsylvania,Rebersburg,708,226,227,34,9,20,516
Pennsylvania,Pleasant Gap,2917,606,1400,286,15,92,2399
Pennsylvania,Houserville,2013,489,929,185,0,68,1671
Pennsylvania,Maple Glen,6614,1170,3427,279,115,169,5160
Pennsylvania,Kulpsville,8208,1565,3711,653,168,695,6792
Pennsylvania,Indian Lake borough,437,64,302,19,2,27,414
Pennsylvania,Railroad borough,274,88,110,25,0,15,238
Pennsylvania,McClure borough,1278,313,555,97,13,45,1023
Pennsylvania,Susquehanna Trails,1891,447,863,71,0,118,1499
Pennsylvania,Koppel borough,668,175,229,103,16,60,583
Pennsylvania,Bridgeport borough,4578,1888,1117,482,73,205,3765
Pennsylvania,Audubon,9195,1796,4384,273,56,862,7371
Pennsylvania,McVeytown borough,334,76,144,34,13,22,289
Pennsylvania,Kistler borough,321,84,89,46,12,17,248
Pennsylvania,Unionville borough,238,76,102,27,0,9,214
Pennsylvania,State College borough,42256,31787,6432,1048,258,708,40233
Pennsylvania,Port Matilda borough,596,156,253,77,8,27,521
Pennsylvania,West Grove borough,2846,672,1264,185,70,47,2238
Pennsylvania,Royalton borough,1259,238,525,126,40,36,965
Pennsylvania,Progress,9750,3179,3202,887,229,657,8154
Pennsylvania,Bear Creek Village borough,252,37,130,26,1,10,204
Pennsylvania,Chevy Chase Heights,1732,306,892,138,0,112,1448
Pennsylvania,Cherry Tree borough,371,98,159,22,7,19,305
Pennsylvania,Strattanville borough,621,202,205,101,2,24,534
Pennsylvania,Blawnox borough,1543,445,451,213,50,100,1259
Pennsylvania,Terre Hill borough,1263,289,580,38,0,46,953
Pennsylvania,Mountville borough,2856,604,1068,281,90,122,2165
Pennsylvania,Millersville borough,8344,4467,2302,432,92,405,7698
Pennsylvania,Denver borough,3870,808,1583,356,51,235,3033
Pennsylvania,Punxsutawney borough,5808,1493,2048,744,124,404,4813
Pennsylvania,Corsica borough,352,80,142,23,15,15,275
Pennsylvania,Brockway borough,2022,375,726,333,32,222,1688
Pennsylvania,Green Lane borough,454,83,197,56,14,31,381
Pennsylvania,Souderton borough,6910,1867,2785,681,55,203,5591
Pennsylvania,Youngstown borough,320,73,166,17,6,12,274
Pennsylvania,Chambersburg borough,20734,5942,6739,2481,348,1206,16716
Pennsylvania,Snow Shoe borough,876,262,326,54,14,65,721
Pennsylvania,Mount Carmel borough,5668,1305,2283,627,80,563,4858
Pennsylvania,McEwensville borough,375,99,146,68,0,6,319
Pennsylvania,Summit Station,191,27,144,0,0,0,171
Pennsylvania,Renningers,493,80,270,28,0,27,405
Pennsylvania,Pine Grove borough,1999,421,849,180,32,94,1576
Pennsylvania,Lake Wynonah,2483,429,1380,169,48,96,2122
Pennsylvania,Gordon borough,859,215,269,56,11,84,635
Pennsylvania,Frackville borough,3668,944,1422,277,113,268,3024
Pennsylvania,Cressona borough,1618,339,612,197,27,109,1284
Pennsylvania,Platea borough,406,100,192,26,3,32,353
Pennsylvania,Three Springs borough,672,84,383,38,5,17,527
Pennsylvania,Avonia,1156,188,607,118,7,48,968
Pennsylvania,Campbelltown,4561,708,2252,339,152,180,3631
Pennsylvania,Lansford borough,3808,1178,1140,469,87,241,3115
Pennsylvania,Waynesboro borough,10842,2862,3515,1130,331,727,8565
Pennsylvania,Schwenksville borough,1483,364,478,233,38,65,1178
Pennsylvania,Horsham,14641,3756,6176,1092,169,596,11789
Pennsylvania,Gilbertsville,5408,884,2693,350,27,277,4231
Pennsylvania,Phoenixville borough,16815,5561,5574,1608,307,671,13721
Pennsylvania,Downingtown borough,7929,2226,2697,1073,158,387,6541
Pennsylvania,Coatesville,13147,4911,3128,947,229,533,9748
Pennsylvania,Chesterbrook,4714,926,2113,564,96,162,3861
Pennsylvania,Guilford,2691,444,1523,168,0,99,2234
Pennsylvania,Albion borough,1571,326,654,156,46,88,1270
Pennsylvania,Reamstown,3438,469,1617,247,54,362,2749
Pennsylvania,Marklesburg borough,250,63,125,6,0,18,212
Pennsylvania,Alexandria borough,332,65,137,41,2,15,260
Pennsylvania,Shanor-Northvue,5107,950,2341,418,39,570,4318
Pennsylvania,Seven Fields borough,2791,573,1368,163,34,86,2224
Pennsylvania,Sunbury,9581,2923,2872,1075,204,666,7740
Pennsylvania,Oakland borough,601,117,246,55,15,64,497
Pennsylvania,Lanesboro borough,411,63,174,42,8,42,329
Pennsylvania,Friendsville borough,116,29,57,14,0,8,108
Pennsylvania,Forest City borough,2131,518,694,254,36,283,1785
Pennsylvania,Wyoming borough,3022,665,1331,302,44,304,2646
Pennsylvania,Wilkes-Barre,40847,15766,10654,3336,833,2709,33298
Pennsylvania,Tunnelhill borough,330,87,147,35,8,11,288
Pennsylvania,Southmont borough,2128,516,970,149,11,135,1781
Pennsylvania,South Fork borough,903,234,282,123,20,83,742
Pennsylvania,Hastings borough,1191,210,467,169,11,95,952
Pennsylvania,East Conemaugh borough,1027,303,279,107,7,109,805
Pennsylvania,Castanea,1150,248,513,135,16,58,970
Pennsylvania,Nicholson borough,769,192,301,72,15,59,639
Pennsylvania,Meshoppen borough,464,113,172,30,21,23,359
Pennsylvania,Emporium borough,2006,660,572,344,50,177,1803
Pennsylvania,Fullerton,15578,4582,5478,1228,339,874,12501
Pennsylvania,Dickson City borough,5868,1739,2096,654,72,363,4924
Pennsylvania,Dalton borough,1292,183,765,85,3,38,1074
Pennsylvania,Fairdale,2282,549,784,222,50,195,1800
Pennsylvania,Kittanning borough,3838,970,1273,543,95,303,3184
Pennsylvania,West Sunbury borough,178,53,63,24,4,13,157
Pennsylvania,Atlantic,72,12,23,3,0,3,41
Pennsylvania,Cambridge Springs borough,2619,917,760,298,145,189,2309
Pennsylvania,Guys Mills,104,47,36,0,0,5,88
Pennsylvania,Whitfield,4813,831,2530,235,27,263,3886
Pennsylvania,Shoemakersville borough,1373,314,555,156,3,133,1161
Pennsylvania,Laureldale borough,3903,1098,1527,329,95,189,3238
Pennsylvania,Bernville borough,919,204,352,86,19,50,711
Pennsylvania,Akron borough,3989,938,1806,247,23,156,3170
Pennsylvania,St. Lawrence borough,2060,535,785,186,58,109,1673
Pennsylvania,North Apollo borough,1328,274,634,115,19,109,1151
Pennsylvania,Leechburg borough,2119,515,738,242,77,165,1737
Pennsylvania,Apollo borough,1409,459,482,146,23,116,1226
Pennsylvania,Paxtang borough,1650,344,691,193,24,86,1338
Pennsylvania,Harrisburg,49230,19613,10153,4861,1387,2150,38164
Pennsylvania,Huntingdon borough,6987,2713,2157,555,82,545,6052
Pennsylvania,Pen Argyl borough,3562,856,1409,299,137,125,2826
Pennsylvania,Bethlehem,75296,28343,23030,6752,1492,3851,63468
Pennsylvania,Slatington borough,4277,1069,1523,474,204,255,3525
Pennsylvania,Troxelville,293,19,164,8,3,12,206
Pennsylvania,Selinsgrove borough,5897,2727,1540,463,53,468,5251
Pennsylvania,Beaver Springs,640,87,276,30,36,43,472
Pennsylvania,Clarks Green borough,1532,244,782,99,5,134,1264
Pennsylvania,Carmichaels borough,408,108,121,55,20,44,348
Pennsylvania,Landisburg borough,217,54,76,21,1,14,166
Pennsylvania,Oakwood,2250,459,1040,159,83,186,1927
Pennsylvania,Jefferson borough (Greene County),265,63,100,26,2,29,220
Pennsylvania,Saegertown borough,956,336,324,114,14,50,838
Pennsylvania,Northampton borough,9873,2309,3691,892,302,661,7855
Pennsylvania,Paxtonia,5670,1519,2416,454,65,275,4729
Pennsylvania,Rothsville,2531,549,1237,211,11,73,2081
Pennsylvania,Braddock borough,1729,760,211,278,55,175,1479
Pennsylvania,Skyline View,4118,615,2164,401,94,249,3523
Pennsylvania,Halifax borough,954,250,312,90,51,51,754
Pennsylvania,Rohrsburg,144,38,61,13,4,10,126
Pennsylvania,York Springs borough,876,234,345,51,13,13,656
Pennsylvania,Lake Meade,2653,351,1596,94,32,111,2184
Pennsylvania,Gettysburg borough,7646,4076,1413,855,138,260,6742
Pennsylvania,Bonneauville borough,1772,415,698,211,20,53,1397
Pennsylvania,Abbottstown borough,911,225,386,73,16,25,725
Pennsylvania,Glenolden borough,7147,2275,2262,853,143,445,5978
Pennsylvania,Boothwyn,5596,1686,2298,459,121,205,4769
Pennsylvania,Claysburg,1369,326,606,141,51,85,1209
Pennsylvania,Milford borough,1179,258,441,171,18,148,1036
Pennsylvania,Lewisburg borough,5740,3066,1348,376,36,388,5214
Pennsylvania,Cassandra borough,206,55,74,4,8,12,153
Pennsylvania,Wind Gap borough,2706,715,1064,342,26,210,2357
Pennsylvania,Walnutport borough,2093,511,883,198,12,153,1757
Pennsylvania,Portland borough,428,161,177,10,0,22,370
Pennsylvania,Palmer Heights,3700,637,1809,331,17,307,3101
Pennsylvania,Easton,27100,10446,7798,2466,853,1022,22585
Pennsylvania,Quarryville borough,2749,591,1102,176,30,93,1992
Pennsylvania,Mount Joy borough,8106,2134,3198,802,220,299,6653
Pennsylvania,Lititz borough,9288,1759,4382,720,32,856,7749
Pennsylvania,Gap,2146,342,1061,118,0,39,1560
Pennsylvania,Applewold borough,310,83,115,40,11,15,264
Pennsylvania,Beavertown borough,1085,230,439,88,32,60,849
Pennsylvania,Alburtis borough,2528,732,1045,206,42,30,2055
Pennsylvania,Chicora borough,1017,176,404,113,43,76,812
Pennsylvania,Ashland borough,2704,754,904,341,56,181,2236
Pennsylvania,Nesquehoning borough,3251,903,1183,388,78,254,2806
Pennsylvania,Littlestown borough,4468,956,1925,426,81,232,3620
Pennsylvania,Bolivar borough,424,87,183,41,7,37,355
Pennsylvania,Rankin borough,2100,936,426,184,34,59,1639
Pennsylvania,Orrstown borough,277,75,92,17,6,39,229
Pennsylvania,Arlington Heights,5439,1443,2186,554,72,263,4518
Pennsylvania,Chalfant borough,735,244,287,53,7,47,638
Pennsylvania,East Washington borough,2041,638,783,253,27,106,1807
Pennsylvania,Philipsburg borough,2731,789,989,376,65,160,2379
Pennsylvania,New Salem borough,777,129,420,52,4,41,646
Pennsylvania,Petersburg borough,458,92,176,55,17,28,368
Pennsylvania,Trevorton,1658,431,650,150,30,83,1344
Pennsylvania,Point Marion borough,1280,414,564,101,15,50,1144
Pennsylvania,Connellsville,7427,1941,2551,758,217,476,5943
Pennsylvania,North Belle Vernon borough,1754,517,640,231,55,100,1543
Pennsylvania,South New Castle borough,745,216,286,79,11,30,622
Pennsylvania,Wyncote,3014,718,1251,179,35,380,2563
Pennsylvania,Wolfdale,2808,540,1311,452,10,250,2563
Pennsylvania,New Bethlehem borough,938,179,374,102,9,101,765
Pennsylvania,Bath borough,2670,777,867,221,72,194,2131
Pennsylvania,Beaver Falls,8547,3523,1974,880,284,434,7095
Pennsylvania,Edinboro borough,5964,3113,1452,178,191,250,5184
Pennsylvania,Karns City borough,190,40,81,11,5,16,153
Pennsylvania,Port Clinton borough,264,74,87,43,2,13,219
Pennsylvania,Ben Avon borough,1865,390,895,104,24,70,1483
Pennsylvania,Robesonia borough,2027,568,788,209,43,120,1728
Pennsylvania,Amity Gardens,3094,672,1495,381,0,151,2699
Pennsylvania,Lower Burrell,11321,2420,5548,950,138,694,9750
Pennsylvania,Delmont borough,2605,471,1372,247,43,81,2214
Pennsylvania,Adamsburg borough,129,38,52,11,4,12,117
Pennsylvania,Centre Hall borough,1244,193,621,70,9,72,965
Pennsylvania,Jessup borough,4496,1298,1695,265,73,433,3764
Pennsylvania,Morrisville,1082,191,413,166,9,165,944
Pennsylvania,Julian,154,45,42,36,0,10,133
Pennsylvania,Clarksville borough,163,42,70,13,7,22,154
Pennsylvania,Fayetteville,3122,591,1580,243,96,197,2707
Pennsylvania,Timblin borough,226,62,77,14,5,6,164
Pennsylvania,Sykesville borough,1020,236,413,124,16,76,865
Pennsylvania,Summerville borough,477,119,215,29,7,22,392
Pennsylvania,Cassville borough,120,16,59,4,1,21,101
Pennsylvania,Broad Top City borough,482,113,246,20,10,34,423
Pennsylvania,Wyomissing borough,10452,1883,4940,847,185,815,8670
Pennsylvania,Sinking Spring borough,4092,1301,1383,371,97,118,3270
Pennsylvania,Shillington borough,5300,1120,2037,588,14,390,4149
Pennsylvania,Bechtelsville borough,999,249,445,70,26,42,832
Pennsylvania,Valley-Hi borough,3,0,3,0,0,0,3
Pennsylvania,McConnellsburg borough,1104,282,348,140,8,85,863
Pennsylvania,Orchard Hills,2468,542,1030,155,38,156,1921
Pennsylvania,Rutherford,4838,1444,1662,359,52,294,3811
Pennsylvania,Braddock Hills borough,1710,563,423,314,30,176,1506
Pennsylvania,Oklahoma borough,787,130,423,93,0,62,708
Pennsylvania,Vandergrift borough,4987,1291,1740,418,147,365,3961
Pennsylvania,West Newton borough,2671,545,1141,230,43,314,2273
Pennsylvania,Philadelphia,1575522,651908,386723,119548,44036,80021,1282236
Pennsylvania,Fernville,414,91,218,36,0,32,377
Pennsylvania,Briar Creek borough,767,218,210,87,36,103,654
Pennsylvania,New Albany borough,282,88,79,34,6,37,244
Pennsylvania,Fleetwood borough,4103,1015,1718,334,56,216,3339
Pennsylvania,Carnot-Moon,11982,4378,4507,717,155,534,10291
Pennsylvania,Brentwood borough,9453,3043,3332,742,79,538,7734
Pennsylvania,Cranesville borough,558,106,254,36,11,30,437
Pennsylvania,Hughesville borough,2071,459,811,259,22,147,1698
Pennsylvania,Yeagertown,892,200,381,126,0,108,815
Pennsylvania,Newton Hamilton borough,131,29,66,12,0,5,112
Pennsylvania,Sandy Ridge,263,83,124,25,0,31,263
Pennsylvania,Birdsboro borough,5139,1312,2180,508,87,168,4255
Pennsylvania,Ligonier borough,1407,329,619,160,51,122,1281
Pennsylvania,Greensburg,14377,4893,4158,1856,306,1013,12226
Pennsylvania,Ramblewood,994,374,447,18,25,42,906
Pennsylvania,South Connellsville borough,1958,517,781,171,14,160,1643
Pennsylvania,Oliver,2857,577,1100,334,7,138,2156
Pennsylvania,Hiller,1074,258,509,77,0,157,1001
Pennsylvania,Everson borough,911,224,353,106,10,41,734
Pennsylvania,Dawson borough,506,94,224,44,5,28,395
Pennsylvania,New Galilee borough,365,91,152,22,4,23,292
Pennsylvania,New Brighton borough,5827,1661,1578,877,90,472,4678
Pennsylvania,Frankfort Springs borough,144,30,71,4,0,12,117
Pennsylvania,Bridgewater borough,845,210,298,99,13,56,676
Pennsylvania,Hunker borough,299,72,144,20,1,27,264
Pennsylvania,Arendtsville borough,906,178,362,80,2,38,660
Pennsylvania,Gratz borough,805,211,366,41,8,43,669
Pennsylvania,Elizabethville borough,1609,401,552,174,43,117,1287
Pennsylvania,Conashaugh Lakes,1518,115,922,67,0,26,1130
Pennsylvania,Columbus,788,155,395,73,3,48,674
Pennsylvania,Colony Park,1265,226,681,32,36,57,1032
Pennsylvania,Hydetown borough,816,191,277,71,7,42,588
Pennsylvania,Saxonburg borough,1531,230,678,191,13,251,1363
Pennsylvania,Fairview borough,186,56,62,13,2,12,145
Pennsylvania,Connoquenessing borough,549,82,312,33,8,30,465
Pennsylvania,Geneva,138,17,50,22,2,17,108
Pennsylvania,New Cumberland borough,7298,1692,3110,829,278,366,6275
Pennsylvania,Sharon,13378,4426,3718,1565,407,990,11106
Pennsylvania,Fountain Hill borough,4675,1324,1482,663,60,439,3968
Pennsylvania,Coplay borough,3216,818,1335,383,27,160,2723
Pennsylvania,Middleburg borough,1444,263,525,157,18,153,1116
Pennsylvania,Dover borough,2084,562,801,166,36,57,1622
Pennsylvania,Vandling borough,670,170,295,39,2,44,550
Pennsylvania,Taylor borough,6007,1853,1977,763,107,404,5104
Pennsylvania,Olyphant borough,5090,1209,2103,358,99,392,4161
Pennsylvania,Landingville borough,139,18,80,9,0,4,111
Pennsylvania,Klingerstown,98,29,52,4,2,2,89
Pennsylvania,Fountain Springs,419,98,135,61,4,57,355
Pennsylvania,Brandonville,267,67,100,31,0,18,216
Pennsylvania,Branchdale,418,123,183,28,0,15,349
Pennsylvania,Auburn borough,682,157,338,47,8,32,582
Pennsylvania,Conestoga,1129,222,580,100,12,53,967
Pennsylvania,Coral,423,38,385,0,0,0,423
Pennsylvania,Cornwells Heights,1148,451,452,109,0,49,1061
Pennsylvania,Crenshaw,388,120,128,52,4,33,337
Pennsylvania,Newell borough,524,127,220,58,3,16,424
Pennsylvania,Ringtown borough,766,226,337,57,9,60,689
Pennsylvania,West Wyomissing,3578,856,1625,261,80,145,2967
Pennsylvania,Ben Avon Heights borough,343,41,198,22,3,10,274
Pennsylvania,Park Forest Village,10610,4162,3986,377,12,316,8853
Pennsylvania,McKeansburg,176,41,74,17,0,10,142
Pennsylvania,Eagleview,1715,261,826,185,25,205,1502
Pennsylvania,Eagle Lake,0,0,0,0,0,0,0
Pennsylvania,Dunlo,151,13,81,15,0,0,109
Pennsylvania,Dryville,287,89,94,16,0,21,220
Pennsylvania,Dry Tavern,598,81,355,55,11,15,517
Pennsylvania,Altamont,726,128,390,11,0,85,614
Pennsylvania,Douglassville,668,95,204,82,0,172,553
Pennsylvania,Dewart,1289,176,643,147,16,57,1039
Pennsylvania,Devon,2008,588,824,65,2,11,1490
Pennsylvania,DeSales University,932,929,3,0,0,0,932
Pennsylvania,Defiance,389,89,141,4,15,12,261
Pennsylvania,Deer Lake,521,23,309,16,0,0,348
Pennsylvania,Dauberville,791,197,412,0,21,37,667
Pennsylvania,Dalmatia,404,80,194,44,12,29,359
Pennsylvania,Cumbola,396,116,149,39,9,25,338
Pennsylvania,Crucible,603,50,330,74,0,25,479
Pennsylvania,Crown,195,56,49,15,0,16,136
Pennsylvania,Cross Creek,161,43,90,3,4,0,140
Pennsylvania,Dorneyville,4226,803,2243,291,36,255,3628
Pennsylvania,Penn borough,419,112,152,37,7,15,323
Pennsylvania,Lake City borough,2944,737,1077,292,39,151,2296
Pennsylvania,Mount Pocono borough,3079,757,982,327,113,180,2359
Pennsylvania,Gold Key Lake,1622,408,732,99,15,61,1315
Pennsylvania,Glenshaw,8714,1537,4821,598,10,502,7468
Pennsylvania,Gibsonia,2050,288,1039,211,10,99,1647
Pennsylvania,Georgetown CDP (Luzerne County),1957,595,656,160,25,102,1538
Pennsylvania,Georgetown CDP (Lancaster County),1193,207,541,12,5,64,829
Pennsylvania,Canton borough,1747,355,616,177,21,209,1378
Pennsylvania,Gibraltar,518,78,208,55,0,17,358
Pennsylvania,Buckhorn,394,120,176,15,0,9,320
Pennsylvania,Newry borough,216,71,71,19,0,7,168
Pennsylvania,Warren,9250,2249,3466,1206,327,546,7794
Pennsylvania,Rural Valley borough,892,161,433,65,15,83,757
Pennsylvania,Lenape Heights,1216,464,387,134,28,73,1086
Pennsylvania,Ford Cliff borough,474,110,246,24,10,27,417
Pennsylvania,Elderton borough,362,78,172,32,9,23,314
Pennsylvania,Atwood borough,110,26,52,15,0,0,93
Pennsylvania,Penbrook borough,2981,1014,777,344,43,98,2276
Pennsylvania,Hershey,14542,4464,6340,928,103,730,12565
Pennsylvania,Waller,67,0,47,2,0,9,58
Pennsylvania,Mainville,84,11,54,3,0,16,84
Pennsylvania,Catawissa borough,1552,421,466,155,43,165,1250
Pennsylvania,Windsor borough,1245,351,340,148,23,74,936
Pennsylvania,Wellsville borough,209,45,98,27,6,6,182
Pennsylvania,Weigelstown,12879,2955,5895,1144,150,647,10791
Pennsylvania,Goodville,847,186,327,0,0,0,513
Pennsylvania,Gordonville,499,99,284,7,0,23,413
Pennsylvania,Gouglersville,420,146,199,47,6,6,404
Pennsylvania,Gouldsboro,719,184,363,29,3,54,633
Pennsylvania,McKean borough,457,89,187,71,2,31,380
Pennsylvania,Jennerstown borough,665,137,324,62,4,28,555
Pennsylvania,Catasauqua borough,6550,1993,2265,664,73,405,5400
Pennsylvania,Ancient Oaks,7554,1094,4100,276,97,339,5906
Pennsylvania,Port Trevorton,896,188,378,52,26,25,669
Pennsylvania,Penns Creek,583,231,201,52,29,21,534
Pennsylvania,Hummels Wharf,1512,387,711,199,27,56,1380
Pennsylvania,Hebron,1023,206,261,181,28,194,870
Pennsylvania,Hawk Run,591,176,260,55,0,0,491
Pennsylvania,Haverford College,1309,1168,120,4,0,0,1292
Pennsylvania,Harwick,905,272,327,111,16,114,840
Pennsylvania,Elgin borough,192,32,106,7,0,18,163
Pennsylvania,Harleigh,1501,281,810,77,0,76,1244
Pennsylvania,Grindstone,464,66,139,21,32,71,329
Pennsylvania,Grill,1650,363,618,162,21,169,1333
Pennsylvania,Grier City,326,55,232,0,0,30,317
Pennsylvania,Greenwood,2537,714,1131,182,60,100,2187
Pennsylvania,Greens Landing,680,196,169,136,16,44,561
Pennsylvania,Greenock,1916,446,941,134,15,167,1703
Pennsylvania,Greenfields,980,247,418,42,44,65,816
Pennsylvania,Grazierville,711,174,241,46,24,9,494
Pennsylvania,Grassflat,762,196,284,75,0,26,581
Pennsylvania,Granville,295,15,134,54,0,49,252
Pennsylvania,Graceton,83,35,32,0,0,16,83
Pennsylvania,Hannasville,183,51,33,24,0,22,130
Pennsylvania,Hookstown borough,146,35,59,19,0,3,116
Pennsylvania,Picture Rocks borough,748,123,390,19,14,29,575
Pennsylvania,Conshohocken borough,8010,3578,2767,606,37,252,7240
Pennsylvania,Highspire borough,2667,639,871,329,65,94,1998
Pennsylvania,Mifflinville,1218,198,603,149,0,89,1039
Pennsylvania,Eyers Grove,73,16,26,16,0,11,69
Pennsylvania,Wyalusing borough,639,112,278,45,16,55,506
Pennsylvania,Alba borough,115,15,33,39,7,9,103
Pennsylvania,Locustdale,166,17,114,13,2,2,148
Pennsylvania,Roseto borough,1882,463,771,111,43,98,1486
Pennsylvania,Nazareth borough,5698,1602,1985,515,93,559,4754
Pennsylvania,Hellertown borough,5848,1539,2143,647,72,422,4823
Pennsylvania,Wickerham Manor-Fisher,2142,566,935,240,21,185,1947
Pennsylvania,Stockdale borough,430,115,215,34,5,29,398
Pennsylvania,Speers borough,1198,281,571,117,22,78,1069
Pennsylvania,Monongahela,4173,1016,1442,529,92,302,3381
Pennsylvania,Long Branch borough,432,128,169,45,7,26,375
Pennsylvania,Cecil-Bishop,2184,458,1121,147,26,86,1838
Pennsylvania,Trooper,5936,1570,2938,289,21,269,5087
Pennsylvania,Dunmore borough,13282,4427,5122,946,203,760,11458
Pennsylvania,Carbondale,8565,2179,2704,996,188,785,6852
Pennsylvania,Bentleyville borough,2515,610,825,365,48,215,2063
Pennsylvania,Milroy,1504,380,651,177,25,87,1320
Pennsylvania,Paoli,5864,1246,2434,623,85,434,4822
Pennsylvania,Elverson borough,1405,218,731,146,30,180,1305
Pennsylvania,Avondale borough,1295,374,478,53,21,43,969
Pennsylvania,Middletown borough,9176,2851,2711,768,425,616,7371
Pennsylvania,Birmingham borough,139,10,95,6,0,4,115
Pennsylvania,Pitcairn borough,3230,1048,833,375,58,316,2630
Pennsylvania,Haysville borough,83,19,38,8,0,2,67
Pennsylvania,Dauphin borough,855,161,366,70,8,43,648
Pennsylvania,Stillwater borough,232,42,94,24,12,10,182
Pennsylvania,Kingston borough,12935,3921,4294,1374,238,1072,10899
Pennsylvania,Hughestown borough,1480,371,683,91,8,141,1294
Pennsylvania,Harveys Lake borough,2764,634,1274,255,12,247,2422
Pennsylvania,Edwardsville borough,4726,1474,1422,326,38,381,3641
Pennsylvania,Marietta borough,2611,661,990,312,44,105,2112
Pennsylvania,Adamstown borough,2228,449,1062,153,46,65,1775
Pennsylvania,Maytown,3815,826,1735,190,10,137,2898
Pennsylvania,Nuremberg,425,133,117,63,6,54,373
Pennsylvania,New Ringgold borough,275,50,126,21,7,10,214
Pennsylvania,Atglen borough,1459,398,527,86,23,61,1095
Pennsylvania,Hometown,1268,169,623,93,61,159,1105
Pennsylvania,Gilberton borough,772,244,259,107,6,51,667
Pennsylvania,Patton borough,1714,405,720,181,49,105,1460
Pennsylvania,Windber borough,3932,802,1553,488,130,280,3253
Pennsylvania,Girardville borough,1411,367,582,116,5,108,1178
Pennsylvania,Ursina borough,293,74,86,37,2,17,216
Pennsylvania,Stoystown borough,358,55,179,38,0,51,323
Pennsylvania,Somerset borough,5977,1494,2050,760,117,657,5078
Pennsylvania,Rockwood borough,745,174,292,65,15,62,608
Pennsylvania,Friedens,1774,470,645,162,20,83,1380
Pennsylvania,Davidsville,750,65,466,31,0,121,683
Pennsylvania,West View borough,6640,1968,2400,693,90,373,5524
Pennsylvania,Heckscherville,121,28,27,35,4,9,103
Pennsylvania,St. Clair borough,2891,694,1047,357,121,227,2446
Pennsylvania,Pottsville,13728,3793,5033,1399,317,1127,11669
Pennsylvania,Port Carbon borough,1855,492,712,128,44,111,1487
Pennsylvania,Hallstead borough,1299,275,533,175,33,67,1083
Pennsylvania,West Pittston borough,4772,1351,1657,519,83,414,4024
Pennsylvania,Sugar Notch borough,941,271,357,63,22,80,793
Pennsylvania,Shickshinny borough,664,164,267,77,9,57,574
Pennsylvania,Mountain Top,11319,2411,5712,712,103,453,9391
Pennsylvania,Larksville borough,4417,1137,2098,354,65,232,3886
Pennsylvania,Dallas borough,2779,848,1159,208,63,141,2419
Pennsylvania,Plymouth borough,5832,1747,1643,590,180,442,4602
Pennsylvania,Marshallton,1312,378,408,80,107,74,1047
Pennsylvania,Fairview-Ferndale,2009,515,821,177,82,130,1725
Pennsylvania,Latrobe borough,8014,1920,3246,936,144,485,6731
Pennsylvania,Union Dale borough,238,73,138,8,3,13,235
Pennsylvania,East Waterford,254,59,112,18,5,16,210
Pennsylvania,Strasburg borough,2917,583,1262,241,39,139,2264
Pennsylvania,Pomeroy,436,139,190,19,0,27,375
Pennsylvania,Pocono Woodland Lakes,3314,623,1785,207,12,98,2725
Pennsylvania,Pocono Springs,1285,191,742,116,24,78,1151
Pennsylvania,Pocono Ranch Lands,1297,317,537,67,34,85,1040
Pennsylvania,Pocono Mountain Lake Estates,375,99,148,73,0,55,375
Pennsylvania,Plumsteadville,2522,638,1062,250,0,57,2007
Pennsylvania,Pleasant View,696,171,339,85,0,47,642
Pennsylvania,Newtown,251,38,136,34,2,18,228
Pennsylvania,Deer Lake borough,759,143,414,58,9,30,654
Pennsylvania,Spring House,3865,810,1827,241,6,341,3225
Pennsylvania,Potlicker Flats,252,89,76,0,39,37,241
Pennsylvania,Spring Grove borough,2094,447,894,170,43,96,1650
Pennsylvania,Willow Grove,14800,3894,6114,1069,256,811,12144
Pennsylvania,Shanksville borough,229,34,103,31,8,7,183
Pennsylvania,Seltzer,244,107,68,43,0,26,244
Pennsylvania,West Hazleton borough,4496,1787,1396,284,148,177,3792
Pennsylvania,Englewood,449,166,82,45,23,107,423
Pennsylvania,Mount Pleasant Mills,461,75,179,64,0,46,364
Pennsylvania,Kreamer,681,61,469,29,0,22,581
Pennsylvania,Freeburg borough,562,168,196,68,3,47,482
Pennsylvania,Scranton,76869,26828,23459,6853,1450,4943,63533
Pennsylvania,East Vandergrift borough,798,289,219,90,10,51,659
Pennsylvania,Avonmore borough,1099,239,428,105,29,93,894
Pennsylvania,Turtle Creek borough,5244,1956,930,720,225,471,4302
Pennsylvania,Thornburg borough,454,64,271,22,6,24,387
Pennsylvania,Wyndmoor,5795,1462,2424,533,162,414,4995
Pennsylvania,Pennsbury Village borough,747,279,207,112,31,32,661
Pennsylvania,Ingram borough,3271,1148,1111,298,52,201,2810
Pennsylvania,Numidia,251,58,119,18,3,7,205
Pennsylvania,McKeesport,19365,7396,4415,2386,471,1565,16233
Pennsylvania,Nixon,1206,205,728,135,9,53,1130
Pennsylvania,Lewisberry borough,484,85,226,42,15,20,388
Pennsylvania,Glen Rock borough,2105,365,884,159,54,60,1522
Pennsylvania,East Prospect borough,1012,208,362,107,34,40,751
Pennsylvania,Wellsboro borough,3267,689,1397,322,70,320,2798
Pennsylvania,Tioga borough,777,164,249,94,38,47,592
Pennsylvania,Starrucca borough,213,45,122,3,0,12,182
Pennsylvania,Hawley borough,1331,444,481,114,26,81,1146
Pennsylvania,Lincoln borough,1057,223,510,109,15,64,921
Pennsylvania,Lawrenceville borough,543,143,159,77,18,34,431
Pennsylvania,Athens borough,3237,676,1347,275,50,293,2641
Pennsylvania,Valley View CDP (York County),2455,504,1058,205,48,223,2038
Pennsylvania,Village Green-Green Ridge,8187,1862,3655,687,24,590,6818
Pennsylvania,Bridgeville borough,5066,1468,1754,707,102,375,4406
Pennsylvania,Dravosburg borough,1779,590,605,222,40,139,1596
Pennsylvania,Edgeworth borough,1596,232,861,71,9,59,1232
Pennsylvania,Glassport borough,4391,1206,1294,513,240,376,3629
Pennsylvania,Heidelberg borough,1285,395,465,129,52,77,1118
Pennsylvania,Liberty borough (Allegheny County),2488,740,928,265,83,186,2202
Pennsylvania,Verona borough,2736,873,776,398,70,203,2320
Pennsylvania,West Elizabeth borough,501,106,171,33,11,12,333
Pennsylvania,Benson borough,208,62,75,35,0,8,180
Pennsylvania,Blain borough,255,57,95,26,3,11,192
Pennsylvania,Bloomfield borough,1487,350,526,158,35,102,1171
Pennsylvania,New Buffalo borough,128,12,60,9,2,11,94
Pennsylvania,Westover borough,353,92,139,28,14,28,301
Pennsylvania,West Hamburg,1983,293,868,291,42,254,1748
Pennsylvania,Westland,142,67,0,37,0,10,114
Pennsylvania,West Milton,1458,388,629,173,10,38,1238
Pennsylvania,West Nanticoke,531,118,262,45,13,65,503
Pennsylvania,Weston,336,163,48,87,0,5,303
Pennsylvania,West Pittsburg,728,110,400,85,0,54,649
Pennsylvania,West Waynesburg,356,170,65,58,0,31,324
Pennsylvania,Westwood,1011,305,333,100,16,18,772
Pennsylvania,White Mills,911,293,248,138,13,28,720
Pennsylvania,Rose Valley borough,932,120,573,44,6,37,780
Pennsylvania,Prospect Park borough,6475,2285,1893,496,124,455,5253
Pennsylvania,Shinglehouse borough,1029,196,386,181,0,74,837
Pennsylvania,Eddystone borough,2552,916,613,231,80,51,1891
Pennsylvania,Sandy,1650,324,682,152,30,124,1312
Pennsylvania,Chalfont borough,4125,996,1825,291,86,134,3332
Pennsylvania,Hulmeville borough,965,234,408,80,16,49,787
Pennsylvania,Ivyland borough,1179,177,498,75,19,123,892
Pennsylvania,Richboro,6364,1261,3676,142,0,295,5374
Pennsylvania,Thompsontown borough,786,244,272,123,6,39,684
Pennsylvania,Indiana borough,13512,9240,2270,578,108,209,12405
Pennsylvania,Duryea borough,4875,987,2216,341,154,259,3957
Pennsylvania,East Berwick,2217,306,1179,241,20,165,1911
Pennsylvania,Exeter borough,5603,1372,2261,579,34,338,4584
Pennsylvania,Glen Lyon,1860,651,726,134,50,80,1641
Pennsylvania,Wiconsico,842,134,376,70,16,29,625
Pennsylvania,Pittston,7697,2531,2207,862,108,496,6204
Pennsylvania,White Haven borough,1203,288,494,128,26,63,999
Pennsylvania,Little Meadows borough,175,32,93,26,2,14,167
Pennsylvania,Thompson borough,342,73,173,24,2,11,283
Pennsylvania,Oil City,9982,2655,3185,1415,287,622,8164
Pennsylvania,Sugarcreek borough,5065,873,2492,544,92,453,4454
Pennsylvania,Utica borough,177,46,76,26,5,10,163
Pennsylvania,Schlusser,4857,750,2467,613,48,236,4114
Pennsylvania,Butler,13182,4260,3398,2040,297,743,10738
Pennsylvania,Callery borough,437,73,231,41,6,16,367
Pennsylvania,East Butler borough,801,209,336,93,8,35,681
Pennsylvania,Mars borough,1450,343,477,252,11,164,1247
Pennsylvania,Swoyersville borough,4972,1291,2131,599,36,313,4370
Pennsylvania,Dicksonville,645,136,171,63,50,8,428
Pennsylvania,Wilcox,318,33,143,57,3,19,255
Pennsylvania,Winfield,808,130,387,96,7,46,666
Pennsylvania,Folcroft borough,6630,1903,1807,729,216,477,5132
Pennsylvania,Media borough,5423,1938,1729,663,123,334,4787
Pennsylvania,Forest Hills borough,6401,2007,2559,516,124,385,5591
Pennsylvania,Fox Chapel borough,5331,715,3160,86,35,171,4167
Pennsylvania,Green Tree borough,4913,1069,2537,235,47,316,4204
Pennsylvania,Munhall borough,11229,3393,3839,1194,176,858,9460
Pennsylvania,Oakdale borough,1548,328,734,136,45,83,1326
Pennsylvania,Pleasant Hills borough,8184,1752,4017,339,72,752,6932
Pennsylvania,Port Vue borough,3724,922,1436,337,56,363,3114
Pennsylvania,Sewickley borough,3838,810,1684,255,53,240,3042
Pennsylvania,Delano,309,86,118,36,11,35,286
Pennsylvania,Upper St. Clair,19592,3125,10231,956,129,980,15421
Pennsylvania,New Philadelphia borough,1021,324,351,87,29,73,864
Pennsylvania,Shenandoah Heights,1287,238,584,99,18,66,1005
Pennsylvania,Elysburg,1908,264,1080,70,10,239,1663
Pennsylvania,Milton borough,6838,1464,3157,502,184,479,5786
Pennsylvania,Turbotville borough,657,133,333,61,17,22,566
Pennsylvania,Boyertown borough,4058,873,1435,494,97,414,3313
Pennsylvania,Hamburg borough,4353,1213,1653,342,52,446,3706
Pennsylvania,Leesport borough,1967,462,733,222,41,52,1510
Pennsylvania,Mount Penn borough,3134,1004,966,382,65,116,2533
Pennsylvania,Reiffton,4576,828,2324,314,50,286,3802
Pennsylvania,West Reading borough,4215,1347,1417,601,66,275,3706
Pennsylvania,Yoe borough,1052,290,394,102,4,10,800
Pennsylvania,Greenville borough,5572,1935,1637,599,166,202,4539
Pennsylvania,Thompsonville,3412,501,1869,218,8,303,2899
Pennsylvania,Roaring Spring borough,2623,571,1130,127,81,122,2031
Pennsylvania,Witmer,407,154,128,22,0,31,335
Pennsylvania,Wyano,622,195,223,37,0,33,488
Pennsylvania,Wylandville,253,91,94,33,0,17,235
Pennsylvania,Yorklyn,1888,458,850,62,23,113,1506
Pennsylvania,Yukon,463,49,318,28,7,52,454
Pennsylvania,Blue Ball,745,136,443,34,0,0,613
Pennsylvania,Blue Ridge Summit,818,219,416,70,0,18,723
Pennsylvania,Bobtown,573,111,283,32,5,30,461
Pennsylvania,Boston,336,104,118,77,0,20,319
Pennsylvania,Bowers,173,32,87,8,0,23,150
Pennsylvania,Bowmansville,2123,461,1007,163,0,91,1722
Pennsylvania,Wind Ridge,199,52,76,26,2,7,163
Pennsylvania,Bradenville,396,69,170,103,10,0,352
Pennsylvania,Breinigsville,5975,1008,2784,336,27,198,4353
Pennsylvania,Bressler,1547,332,531,165,25,43,1096
Pennsylvania,Brittany Farms-The Highlands,3656,672,1710,300,64,256,3002
Pennsylvania,Brownstown,2290,528,1234,86,15,156,2019
Pennsylvania,Browntown,1342,304,647,135,38,134,1258
Pennsylvania,Ardmore,13083,3477,5410,1201,141,551,10780
Pennsylvania,Harleysville,9553,1942,4728,515,31,818,8034
Pennsylvania,Drexel Hill,28188,8189,11027,1928,366,1248,22758
Pennsylvania,Jefferson borough (York County),594,88,314,32,17,34,485
Pennsylvania,Parkville,7162,1805,2637,864,55,363,5724
Pennsylvania,Seven Valleys borough,475,74,203,50,8,32,367
Pennsylvania,Brave,196,21,118,15,3,0,157
Pennsylvania,Womelsdorf borough,2887,885,961,167,17,256,2286
Pennsylvania,Blairsville borough,3281,903,1134,351,103,193,2684
Pennsylvania,Stormstown,2422,373,1327,138,12,44,1894
Pennsylvania,Beech Mountain Lakes,1913,439,1045,113,0,106,1703
Pennsylvania,Bethel,583,180,227,44,0,16,467
Pennsylvania,Big Bass Lake,1236,300,617,70,12,50,1049
Pennsylvania,Bigler,320,50,178,29,0,23,280
Pennsylvania,Birchwood Lakes,1178,324,329,177,32,108,970
Pennsylvania,Bird-in-Hand,508,138,213,0,16,0,367
Pennsylvania,Blandburg,348,88,128,26,2,36,280
Pennsylvania,Blandon,7837,1839,3635,585,165,313,6537
Pennsylvania,Wagner,162,27,65,14,0,14,120
Pennsylvania,Wakefield,522,97,242,29,4,17,389
Pennsylvania,Wallenpaupack Lake Estates,1154,228,685,43,33,98,1087
Pennsylvania,Walnuttown,710,151,386,39,36,11,623
Pennsylvania,Wanamie,512,132,217,44,0,56,449
Pennsylvania,Washington Boro,881,144,459,33,25,34,695
Pennsylvania,Waverly,639,93,353,38,0,40,524
Pennsylvania,Webster,152,24,98,0,0,0,122
Pennsylvania,Weedville,472,73,246,55,24,37,435
Pennsylvania,Wescosville,6213,1257,3148,246,110,291,5052
Pennsylvania,West Alexander,398,80,185,24,0,54,343
Pennsylvania,West Decatur,452,87,217,27,9,40,380
Pennsylvania,West Falls,359,84,154,47,2,27,314
Pennsylvania,Great Bend borough,923,221,378,75,27,59,760
Pennsylvania,Stockertown borough,1212,249,543,86,18,48,944
Pennsylvania,Beaverdale,830,186,357,33,45,55,676
Pennsylvania,Bear Rocks,961,126,649,39,0,17,831
Pennsylvania,Berwyn,3268,696,1526,147,15,216,2600
Pennsylvania,Baumstown,646,146,258,25,0,15,444
Pennsylvania,Aaronsburg CDP (Washington County),123,47,47,6,0,23,123
Pennsylvania,Ackermanville,724,95,410,17,0,27,549
Pennsylvania,Albrightsville,173,88,54,0,0,7,149
Pennsylvania,Alfarata,209,49,155,5,0,0,209
Pennsylvania,Alleghenyville,1090,261,653,7,12,19,952
Pennsylvania,Allenport,687,134,313,49,8,53,557
Pennsylvania,Allensville,460,111,233,12,2,9,367
Pennsylvania,Allenwood,306,66,158,26,1,34,285
Pennsylvania,Allison,563,66,327,30,22,24,469
Pennsylvania,Allison Park,22855,4909,11147,1339,203,1238,18836
Pennsylvania,Allport,478,73,345,15,0,0,433
Pennsylvania,East Brady borough,948,226,351,131,3,86,797
Pennsylvania,Alsace Manor,488,87,248,56,0,58,449
Pennsylvania,Arnold City,391,185,88,82,0,25,380
Pennsylvania,Arnot,407,60,181,36,0,34,311
Pennsylvania,Atkinson Mills,113,34,40,14,0,5,93
Pennsylvania,Atlas,900,288,346,178,45,34,891
Pennsylvania,Atlasburg,497,88,204,36,8,0,336
Pennsylvania,Avella,922,230,339,99,6,39,713
Pennsylvania,Baileyville,112,0,81,16,0,15,112
Pennsylvania,Bainbridge,1639,277,740,89,38,99,1243
Pennsylvania,Bairdford,1054,137,589,135,0,32,893
Pennsylvania,Bakerstown,2558,234,1333,27,0,359,1953
Pennsylvania,Barrville,324,47,149,0,0,0,196
Pennsylvania,Arcadia University,614,611,0,0,0,3,614
Pennsylvania,Mexico,366,63,159,61,0,18,301
Pennsylvania,Flemington borough,1442,378,563,162,0,95,1198
Pennsylvania,Ferndale borough,1576,367,610,130,32,109,1248
Pennsylvania,Cherryville,1767,496,880,67,0,119,1562
Pennsylvania,Cheyney University,438,413,25,0,0,0,438
Pennsylvania,Chinchilla,2192,513,902,241,0,116,1772
Pennsylvania,Church Hill,1597,278,892,77,13,114,1374
Pennsylvania,Churchtown,489,72,242,11,0,36,361
Pennsylvania,Clay,2235,366,1117,76,0,75,1634
Pennsylvania,Clinton,595,177,114,171,0,82,544
Pennsylvania,Cochranville,740,149,383,59,0,37,628
Pennsylvania,Collinsburg,1006,386,376,74,22,64,922
Pennsylvania,Riceville,35,3,23,3,0,3,32
Pennsylvania,Susquehanna Depot borough,1692,425,547,199,56,105,1332
Pennsylvania,Clarendon borough,393,83,119,60,14,40,316
Pennsylvania,Canadohta Lake,461,72,199,77,10,47,405
Pennsylvania,Meadowood,2846,480,1306,295,19,266,2366
Pennsylvania,Greensboro borough,326,75,130,31,12,31,279
Pennsylvania,Kratzerville,369,88,189,25,0,21,323
Pennsylvania,Sandy Lake borough,627,180,205,87,17,41,530
Pennsylvania,New Castle,22188,6717,6836,2699,563,1585,18400
Pennsylvania,Chest Springs borough,156,28,58,12,7,5,110
Pennsylvania,St. Marys,12535,2714,5647,1036,106,1011,10514
Pennsylvania,South Park Township,13363,2862,6541,1023,186,700,11312
Pennsylvania,Tipton,1464,333,786,35,0,46,1200
Pennsylvania,Norristown borough,34490,12593,8916,2640,1045,1342,26536
Pennsylvania,Chase,855,146,525,20,21,43,755
Pennsylvania,Chalkhill,127,23,52,9,0,43,127
Pennsylvania,Chewton,389,114,172,62,4,21,373
Pennsylvania,Cementon,1703,528,657,200,32,37,1454
Pennsylvania,Scalp Level borough,722,146,311,54,23,68,602
Pennsylvania,Burnside borough,215,56,75,26,8,18,183
Pennsylvania,Curwensville borough,2467,586,831,378,42,174,2011
Pennsylvania,Newburg borough (Clearfield County),56,0,33,10,0,7,50
Pennsylvania,Ramey borough,418,116,180,33,0,25,354
Pennsylvania,Royersford borough,4773,1418,1365,749,116,188,3836
Pennsylvania,Sanatoga,8564,2102,3528,771,105,462,6968
Pennsylvania,Malvern borough,3440,871,1304,421,55,197,2848
Pennsylvania,Modena borough,873,198,280,66,10,30,584
Pennsylvania,Patterson Heights borough,547,124,261,26,15,36,462
Pennsylvania,Shippingport borough,158,48,65,20,0,8,141
Pennsylvania,Brownstown borough,863,191,390,66,29,46,722
Pennsylvania,Dunbar borough,1162,243,436,163,27,68,937
Pennsylvania,Waterford borough,1330,287,560,146,52,100,1145
Pennsylvania,Exton,5332,1072,2769,338,33,148,4360
Pennsylvania,Schaefferstown,1105,116,560,38,70,56,840
Pennsylvania,Buffington,71,42,2,18,0,9,71
Pennsylvania,Bulger,387,164,73,7,0,8,252
Pennsylvania,Byrnedale,599,113,277,35,12,13,450
Pennsylvania,Cairnbrook,593,64,307,12,0,45,428
Pennsylvania,Caln,1231,403,474,106,42,30,1055
Pennsylvania,Calumet,1698,414,768,134,19,97,1432
Pennsylvania,Cashtown,199,23,85,30,0,37,175
Pennsylvania,Cedar Crest,284,74,79,37,3,21,214
Pennsylvania,Corry,6396,1619,2446,532,225,389,5211
Pennsylvania,Tower City borough,1299,289,458,143,20,93,1003
Pennsylvania,Coalport borough,417,115,173,33,6,30,357
Pennsylvania,DuBois,7530,1986,2628,909,192,575,6290
Pennsylvania,Hyde Park,2945,768,873,280,18,197,2136
Pennsylvania,Hunterstown,569,170,282,20,30,0,502
Pennsylvania,Hudson,1362,206,601,165,15,124,1111
Pennsylvania,Hublersburg,71,8,31,0,16,0,55
Pennsylvania,Hostetter,513,94,278,36,0,17,425
Pennsylvania,Hopeland,459,50,341,19,0,20,430
Pennsylvania,Holiday Pocono,461,119,155,41,25,65,405
Pennsylvania,Hilldale,1495,333,828,119,24,81,1385
Pennsylvania,Hickory Hills,538,157,234,37,0,15,443
Pennsylvania,Hickory,752,165,323,38,0,47,573
Pennsylvania,Hereford,731,161,374,93,0,11,639
Pennsylvania,Hendersonville,205,16,124,25,0,9,174
Pennsylvania,Hemlock Farms,3387,995,1412,227,22,298,2954
Pennsylvania,Heidlersburg,760,132,312,42,31,43,560
Pennsylvania,Hegins,954,149,398,54,8,82,691
Pennsylvania,Frystown,385,87,193,0,0,66,346
Pennsylvania,Frizzleburg,420,118,145,84,34,21,402
Pennsylvania,Fredericktown,475,122,111,47,6,18,304
Pennsylvania,Gardners,147,87,56,0,0,0,143
Pennsylvania,Fox Chase,1694,194,1088,61,0,83,1426
Pennsylvania,Foster Brook,1058,308,414,139,9,78,948
Pennsylvania,Woxall,1499,238,664,66,0,51,1019
Pennsylvania,Snydertown,367,56,195,8,0,3,262
Pennsylvania,Idaville,191,52,91,15,0,9,167
Pennsylvania,Imperial,2620,822,966,276,38,96,2198
Pennsylvania,Indian Mountain Lake,4158,1113,1637,358,53,232,3393
Pennsylvania,Inkerman,1950,498,443,301,81,498,1821
Pennsylvania,Langeloth,714,183,174,37,37,100,531
Pennsylvania,Landisville,1954,404,1143,42,0,80,1669
Pennsylvania,Lampeter,1276,313,627,40,0,70,1050
Pennsylvania,Lamar,567,177,265,64,0,24,530
Pennsylvania,Lake Winola,626,180,290,72,0,45,587
Pennsylvania,Lakemont,2091,552,895,215,30,113,1805
Pennsylvania,Lake Latonka,816,114,503,63,11,23,714
Pennsylvania,Lake Arthur Estates,606,162,167,99,7,52,487
Pennsylvania,Kylertown,272,36,102,35,0,89,262
Pennsylvania,Kutztown University,3686,3620,64,0,2,0,3686
Pennsylvania,Kiskimere,130,29,79,0,0,11,119
Pennsylvania,Lionville,6323,1451,2891,468,36,345,5191
Pennsylvania,Kirkwood,355,60,173,6,0,0,239
Pennsylvania,Kerrtown,239,138,0,18,0,14,170
Pennsylvania,Kennerdell,169,28,96,18,3,13,158
Pennsylvania,Kenmar,4203,883,1710,331,162,319,3405
Pennsylvania,Kempton,83,26,36,0,0,10,72
Pennsylvania,Kelayres,439,64,186,40,9,46,345
Pennsylvania,Kapp Heights,877,137,338,150,14,51,690
Pennsylvania,Joffre,603,139,259,53,6,38,495
Pennsylvania,James City,270,61,131,27,1,15,235
Pennsylvania,Jacksonwald,2961,663,1465,280,0,239,2647
Pennsylvania,Jacksonville CDP (Indiana County),653,153,237,76,3,45,514
Pennsylvania,Intercourse,1815,411,783,51,0,186,1431
Pennsylvania,Kersey,1229,266,528,82,44,62,982
Pennsylvania,Lattimer,391,134,74,67,0,47,322
Pennsylvania,Leola,7352,1546,3531,487,56,282,5902
Pennsylvania,Cetronia,2558,575,1044,204,88,138,2049
Pennsylvania,Eagleville CDP (Montgomery County),4934,2396,1481,306,57,181,4421
Pennsylvania,Eagleville CDP (Centre County),487,201,193,16,0,14,424
Pennsylvania,Salladasburg borough,234,48,102,24,1,8,183
Pennsylvania,Jersey Shore borough,4237,785,1638,557,116,201,3297
Pennsylvania,Duboistown borough,1146,232,578,104,12,64,990
Pennsylvania,Lewistown borough,8228,2400,2228,1179,275,463,6545
Pennsylvania,Lemont,2439,656,1171,218,0,39,2084
Pennsylvania,Clarence,620,87,315,33,17,41,493
Pennsylvania,Reedsville,640,200,219,80,7,37,543
Pennsylvania,Shiremanstown borough,1576,482,660,109,7,68,1326
Pennsylvania,Newburg borough (Cumberland County),318,85,134,26,4,10,259
Pennsylvania,Mount Holly Springs borough,1932,415,724,244,43,108,1534
Pennsylvania,Clark borough,602,134,322,46,1,15,518
Pennsylvania,West Brownsville borough,935,160,376,122,43,76,777
Pennsylvania,Bellwood borough,1699,387,685,167,40,117,1396
Pennsylvania,York Haven borough,766,229,275,65,12,28,609
Pennsylvania,Chester,33977,17116,4354,2567,894,1933,26864
Pennsylvania,Winterstown borough,567,97,317,64,9,35,522
Pennsylvania,Dunnstown,1528,309,762,94,22,100,1287
Pennsylvania,Spry,4745,910,2437,425,35,225,4032
Pennsylvania,North York borough,1957,636,411,316,68,93,1524
Pennsylvania,Steelton borough,5954,2134,1484,465,39,252,4374
Pennsylvania,Manchester borough,2748,725,794,370,216,183,2288
Pennsylvania,Earlston,1096,166,420,181,38,91,896
Pennsylvania,East Earl,1269,206,609,80,0,0,895
Pennsylvania,East Freedom,944,177,321,152,0,82,732
Pennsylvania,East Salem,205,30,102,6,0,10,148
Pennsylvania,Fort Loudon,802,47,457,110,33,14,661
Pennsylvania,Force,189,39,65,14,0,11,129
Pennsylvania,Foot of Ten,715,204,358,57,10,17,646
Pennsylvania,Flora Dale,0,0,0,0,0,0,0
Pennsylvania,Fivepointville,1550,518,735,74,0,45,1372
Pennsylvania,Fellsburg,1351,295,685,79,16,133,1208
Pennsylvania,Feasterville,2879,712,1090,339,83,61,2285
Pennsylvania,Faxon,1360,323,639,50,26,72,1110
Pennsylvania,Fawn Lake Forest,502,20,353,18,0,16,407
Pennsylvania,Farmington,851,253,381,28,0,7,669
Pennsylvania,Farmersville,1017,102,396,42,0,253,793
Pennsylvania,Jacksonville CDP (Centre County),77,32,21,6,0,7,66
Pennsylvania,Falmouth,446,137,120,58,9,54,378
Pennsylvania,Enlow,1107,229,440,164,15,70,918
Pennsylvania,Enhaut,912,126,407,79,26,69,707
Pennsylvania,Emerald Lakes,3954,969,1631,120,107,349,3176
Pennsylvania,Elrama,353,27,162,51,0,13,253
Pennsylvania,Eighty Four,483,88,233,49,8,41,419
Pennsylvania,Egypt,2102,307,1095,166,20,154,1742
Pennsylvania,Effort,2350,677,1166,96,41,92,2072
Pennsylvania,Edie,60,4,17,26,0,13,60
Pennsylvania,Edenburg,763,167,332,94,5,49,647
Pennsylvania,Edenborn,255,23,113,0,33,20,189
Pennsylvania,Eddington,2047,386,909,166,19,101,1581
Pennsylvania,Fairhope,1062,316,324,150,42,68,900
Pennsylvania,Laurelton,373,83,120,56,0,7,266
Pennsylvania,Laurys Station,1119,284,610,84,22,18,1018
Pennsylvania,Lavelle,552,36,330,131,0,27,524
Pennsylvania,Pennside,4323,1045,1804,429,48,284,3610
Pennsylvania,Penn Estates,5708,1943,1981,424,48,128,4524
Pennsylvania,Pen Mar,1046,93,574,33,40,37,777
Pennsylvania,Park Crest,666,166,299,43,4,61,573
Pennsylvania,Paris,866,187,418,122,23,70,820
Pennsylvania,Pardeesville,512,148,217,72,0,57,494
Pennsylvania,Palmdale,1137,335,477,105,26,43,986
Pennsylvania,Oval,414,32,220,32,0,9,293
Pennsylvania,Orwin,325,87,148,28,15,0,278
Pennsylvania,Orviston,121,39,54,12,0,10,115
Pennsylvania,Oley,1148,144,533,52,0,182,911
Pennsylvania,Oklahoma,817,183,422,66,0,0,671
Pennsylvania,Oberlin,400,185,15,12,35,42,289
Pennsylvania,Oakland CDP (Lawrence County),1469,382,463,265,27,83,1220
Pennsylvania,Oakland CDP (Cambria County),1377,311,654,136,31,178,1310
Pennsylvania,Noxen,567,177,218,56,9,47,507
Pennsylvania,Northwood,161,18,43,53,0,27,141
Pennsylvania,North Warren,1821,569,824,134,10,152,1689
Pennsylvania,North Vandergrift,401,162,83,39,36,35,355
Pennsylvania,Norvelt,779,74,488,16,7,109,694
Pennsylvania,Noblestown,497,77,196,20,14,21,328
Pennsylvania,Nittany,905,238,381,41,46,82,788
Pennsylvania,New Tripoli,1022,175,372,103,0,22,672
Pennsylvania,Penn State Erie (Behrend),1644,1636,8,0,0,0,1644
Pennsylvania,Pennwyn,612,126,273,63,0,71,533
Pennsylvania,Arona borough,342,78,132,48,4,32,294
Pennsylvania,Irwin borough,3829,918,1546,365,76,355,3260
Pennsylvania,Fairless Hills,8376,2426,3208,764,82,509,6989
Pennsylvania,Newtown Grant,3636,801,1716,351,47,148,3063
Pennsylvania,Riegelsville borough,752,205,317,109,11,28,670
Pennsylvania,Trumbauersville borough,950,207,439,83,16,32,777
Pennsylvania,Parkside borough,2291,620,818,144,57,62,1701
Pennsylvania,Morton borough,2666,837,979,214,47,172,2249
Pennsylvania,Marcus Hook borough,2393,958,594,252,62,89,1955
Pennsylvania,Broomall,11154,2614,5196,727,134,760,9431
Pennsylvania,Hollidaysburg borough,5705,1071,2226,566,219,773,4855
Pennsylvania,Dunlevy borough,380,67,146,52,5,35,305
Pennsylvania,Cokeburg borough,543,125,200,75,18,62,480
Pennsylvania,New Schaefferstown,150,11,78,23,15,11,138
Pennsylvania,Arnold,4930,1554,1228,673,156,232,3843
Pennsylvania,Brookhaven borough,8043,2152,3238,714,59,574,6737
Pennsylvania,Sheppton,236,103,76,19,1,12,211
Pennsylvania,Shenandoah borough,4853,1548,1400,419,136,404,3907
Pennsylvania,Buck Run,248,65,105,18,3,7,198
Pennsylvania,Northwest Harborcreek,9034,1705,4159,576,161,768,7369
Pennsylvania,Emigsville,3063,774,1114,211,182,109,2390
Pennsylvania,Dillsburg borough,2546,481,1081,281,61,145,2049
Pennsylvania,Delta borough,591,152,247,51,16,10,476
Pennsylvania,Mansfield borough,3174,1220,891,205,91,209,2616
Pennsylvania,Knoxville borough,703,201,305,49,8,36,599
Pennsylvania,New Kensington,12568,3437,4996,1332,188,817,10770
Pennsylvania,Big Beaver borough,1829,384,916,126,36,91,1553
Pennsylvania,New Salem,584,223,219,69,0,8,519
Pennsylvania,New Market,775,261,217,78,0,82,638
Pennsylvania,New Jerusalem,469,42,261,37,0,46,386
Pennsylvania,Mattawana,541,164,244,12,0,27,447
Pennsylvania,Mather,422,103,160,57,7,64,391
Pennsylvania,Masthope,691,148,388,37,0,75,648
Pennsylvania,Martins Creek,578,130,245,85,0,57,517
Pennsylvania,Marion,1222,180,669,0,15,0,864
Pennsylvania,Marienville,4367,2868,680,508,72,140,4268
Pennsylvania,Marianne,1127,321,478,103,0,84,986
Pennsylvania,Mapletown,96,2,56,13,7,15,93
Pennsylvania,Mammoth,419,91,208,22,0,36,357
Pennsylvania,Maitland,282,54,157,71,0,0,282
Pennsylvania,McKnightstown,151,0,132,19,0,0,151
Pennsylvania,Meadowlands,1152,385,358,45,40,69,897
Pennsylvania,McElhattan,550,156,253,43,0,69,521
Pennsylvania,Lumber City,173,41,100,7,25,0,173
Pennsylvania,Loyalhanna,3487,798,1612,272,70,230,2982
Pennsylvania,Longfellow,141,5,107,13,2,10,137
Pennsylvania,Lincoln University,1861,1804,43,0,14,0,1861
Pennsylvania,Lincoln Park,1519,378,625,128,15,164,1310
Pennsylvania,Level Green,3939,660,2060,352,9,164,3245
Pennsylvania,Little Britain,487,126,205,54,0,34,419
Pennsylvania,Lenkerville,527,165,220,29,10,0,424
Pennsylvania,Lemont Furnace,901,213,319,43,14,47,636
Pennsylvania,Leeper,173,18,106,0,18,17,159
Pennsylvania,Lawrence,438,83,159,94,14,32,382
Pennsylvania,McConnellstown,1501,269,765,72,4,97,1207
Pennsylvania,Aaronsburg CDP (Centre County),494,102,231,58,4,36,431
Pennsylvania,Mertztown,788,220,242,87,99,32,680
Pennsylvania,Milford Square,973,167,484,50,0,35,736
Pennsylvania,New Freeport,52,19,17,8,2,3,49
Pennsylvania,New Columbia,836,108,416,50,9,101,684
Pennsylvania,New Berlinville,1513,448,689,87,0,124,1348
Pennsylvania,New Bedford,920,237,483,63,0,44,827
Pennsylvania,Needmore,99,19,58,4,0,9,90
Pennsylvania,Naomi,111,0,37,57,17,0,111
Pennsylvania,Muse,2720,674,1306,103,22,103,2208
Pennsylvania,Mundys Corner,1529,266,846,83,16,119,1330
Pennsylvania,Muir,459,84,257,26,0,39,406
Pennsylvania,Muhlenberg Park,1780,380,900,18,0,148,1446
Pennsylvania,Mount Morris,711,131,315,72,24,57,599
Pennsylvania,Messiah College,2278,2228,50,0,0,0,2278
Pennsylvania,Mount Eagle,52,18,26,4,0,2,50
Pennsylvania,Moshannon,314,65,165,40,0,10,280
Pennsylvania,Morrisdale,624,181,328,33,0,18,560
Pennsylvania,Morgantown,705,200,265,59,52,41,617
Pennsylvania,Montrose Manor,479,79,272,25,0,41,417
Pennsylvania,Montandon,1069,265,387,178,0,45,875
Pennsylvania,Mohrsville,674,111,301,27,15,67,521
Pennsylvania,Mocanaqua,733,177,263,76,47,25,588
Pennsylvania,Mingoville,627,116,327,62,0,16,521
Pennsylvania,Millwood,611,129,170,87,13,68,467
Pennsylvania,Millsboro,567,176,181,51,30,15,453
Pennsylvania,Millerton,325,83,155,10,19,22,289
Pennsylvania,Mount Aetna,366,88,169,23,0,16,296
Pennsylvania,Strausstown,396,79,171,23,4,7,284
Pennsylvania,Jeannette,9280,2387,3341,1095,323,533,7679
Pennsylvania,Virginville,249,7,160,11,0,23,201
Pennsylvania,Beaver Meadows borough,756,226,258,117,10,55,666
Pennsylvania,Upland borough,3304,1267,735,224,47,162,2435
Pennsylvania,Mifflinburg borough,3526,711,1439,403,55,279,2887
Pennsylvania,Mount Gretna Heights,393,77,232,42,0,13,364
Pennsylvania,Millheim borough,606,107,256,89,14,47,513
Pennsylvania,Uniontown,9908,3671,2559,1182,145,842,8399
Pennsylvania,South Temple,1738,397,815,77,42,51,1382
Pennsylvania,Woodlyn,9326,2367,3495,793,203,604,7462
Pennsylvania,Lilly borough,854,181,378,60,10,75,704
Pennsylvania,Vintondale borough,400,85,176,36,1,32,330
Pennsylvania,Parkesburg borough,3781,835,1519,354,59,165,2932
Pennsylvania,Spring City borough,3320,1144,850,546,59,214,2813
Pennsylvania,Weissport East,1431,325,770,159,0,76,1330
Pennsylvania,Toughkenamon,1345,260,702,19,17,32,1030
Pennsylvania,Ebensburg borough,3173,627,1406,476,33,214,2756
Pennsylvania,West Chester borough,19888,12134,3874,1299,359,514,18180
Pennsylvania,Bradford Woods borough,1201,190,676,62,7,72,1007
Pennsylvania,Aspers,249,101,89,17,9,0,216
Pennsylvania,Rauchtown,590,120,268,58,8,34,488
Pennsylvania,Raubsville,1433,444,667,136,28,17,1292
Pennsylvania,Ranshaw,367,54,182,71,0,39,346
Pennsylvania,Queens Gate,1420,700,329,93,40,64,1226
Pennsylvania,Prospect Park,397,93,126,57,0,31,307
Pennsylvania,West Fairview,1335,484,384,112,22,81,1083
Pennsylvania,Glen Osborne borough,576,91,293,34,5,21,444
Pennsylvania,Temple,1476,438,420,198,33,97,1186
Pennsylvania,Murrysville municipal,19908,3336,10831,1222,99,1221,16709
Pennsylvania,Monroeville municipal,27893,7192,12209,2408,349,1943,24101
Pennsylvania,Fairview,3015,410,1436,239,0,267,2352
Pennsylvania,Bethel Park municipal,32185,6575,15857,1993,289,2267,26981
Pennsylvania,West Lawn,1719,507,532,210,29,84,1362
Pennsylvania,Forestville,477,108,269,23,0,13,413
Pennsylvania,Rockhill borough,432,75,192,36,2,33,338
Pennsylvania,Rouzerville,926,123,418,129,0,48,718
Pennsylvania,Cleona borough,2091,432,916,235,19,112,1714
Pennsylvania,Washingtonville borough,163,55,42,29,2,8,136
Pennsylvania,Driftwood borough,31,5,11,11,0,4,31
Pennsylvania,Foxburg borough,149,32,77,11,6,18,144
Pennsylvania,Knox borough,1010,178,423,117,25,74,817
Pennsylvania,Rimersburg borough,913,220,333,68,15,94,730
Pennsylvania,Wrightsville borough,2299,519,904,267,54,100,1844
Pennsylvania,Flying Hills,2327,652,603,622,0,263,2140
Pennsylvania,Old Orchard,2432,433,1278,226,9,151,2097
Pennsylvania,Kenhorst borough,2870,711,1104,370,35,106,2326
Pennsylvania,Orbisonia borough,446,118,165,67,6,23,379
Pennsylvania,East Petersburg borough,4508,775,2259,358,46,248,3686
Pennsylvania,Ephrata borough,13802,3231,5904,969,297,564,10965
Pennsylvania,Baldwin borough,19651,5181,8409,1278,185,1384,16437
Pennsylvania,Chester Heights borough,2630,702,970,302,32,162,2168
Pennsylvania,Lima,1763,225,722,107,23,616,1693
Pennsylvania,Topton borough,1947,470,815,182,81,108,1656
Pennsylvania,North Catasauqua borough,2841,690,1198,252,41,162,2343
Pennsylvania,Schnecksville,3250,832,1402,191,62,159,2646
Pennsylvania,Hokendauqua,2996,622,1445,192,38,172,2469
Pennsylvania,Port Allegany borough,2226,465,899,190,49,136,1739
Pennsylvania,Edgewood borough,3070,994,1259,238,13,88,2592
Pennsylvania,Jefferson Hills borough,11231,2014,5749,774,75,678,9290
Pennsylvania,Millvale borough,3636,1355,839,472,150,295,3111
Pennsylvania,Pittsburgh,303587,137712,81737,24369,5126,15640,264584
Pennsylvania,Wall borough,667,167,255,86,15,28,551
Pennsylvania,Dushore borough,650,128,229,158,19,56,590
Pennsylvania,Forksville borough,147,46,32,32,8,15,133
Pennsylvania,Lorane,4037,1033,1829,399,64,224,3549
Pennsylvania,Lyons borough,567,179,220,64,10,39,512
Pennsylvania,New Morgan borough,75,55,2,5,1,1,64
Pennsylvania,Spring Ridge,947,120,591,75,0,87,873
Pennsylvania,Macungie borough,3144,1006,1049,439,116,177,2787
Pennsylvania,Pymatuning North,302,61,89,74,6,42,272
Pennsylvania,Coopersburg borough,2467,605,1000,289,23,199,2116
Pennsylvania,Refton,369,71,197,0,0,0,268
Pennsylvania,Ridley Park borough,7035,2152,2887,657,45,420,6161
Pennsylvania,Rehrersburg,204,62,106,0,0,19,187
Pennsylvania,Fallston borough,221,71,98,20,3,11,203
Pennsylvania,Homeacre-Lyndora,6714,1393,2940,735,139,522,5729
Pennsylvania,Allentown,120410,42921,31508,10346,3770,5214,93759
Pennsylvania,Colonial Park,12886,3362,5128,1527,98,674,10789
Pennsylvania,East Berlin borough,1645,338,767,122,38,54,1319
Pennsylvania,Norwood borough,5890,1919,2218,315,102,422,4976
Pennsylvania,Altoona,44372,12343,15557,4417,1151,2707,36175
Pennsylvania,Bessemer borough,1219,294,513,127,3,100,1037
Pennsylvania,Ellport borough,1053,279,388,122,6,110,905
Pennsylvania,Canonsburg borough,8864,2096,3249,1289,158,595,7387
Pennsylvania,Sharon Hill borough,5691,2067,1444,848,55,193,4607
Pennsylvania,Crafton borough,5839,1942,2091,463,140,292,4928
Pennsylvania,Mohnton borough,3019,618,1352,262,43,117,2392
Pennsylvania,Hop Bottom borough,301,74,104,45,2,25,250
Pennsylvania,Penn Lake Park borough,312,26,197,11,0,14,248
Pennsylvania,Twilight borough,198,26,121,9,4,3,163
Pennsylvania,Geistown borough,2410,534,1147,188,23,160,2052
Pennsylvania,Hummelstown borough,4650,1223,1744,496,95,273,3831
Pennsylvania,Old Forge borough,8038,2313,2785,1016,207,534,6855
Pennsylvania,Brookville borough,3842,821,1541,501,78,226,3167
Pennsylvania,Ridgway borough,3862,1049,1452,406,91,194,3192
Pennsylvania,Wilson borough,7795,2051,2812,844,285,450,6442
Pennsylvania,Kutztown borough,5042,2036,1633,278,40,383,4370
Pennsylvania,Plum borough,27304,4833,14243,1857,387,1585,22905
Pennsylvania,Glenfield borough,209,36,101,14,1,7,159
Pennsylvania,Venango borough,283,74,106,30,0,20,230
Pennsylvania,Shippensburg borough,5479,1764,1828,598,115,413,4718
Pennsylvania,Parker,615,89,294,53,15,50,501
Pennsylvania,South Coatesville borough,1276,352,463,163,18,64,1060
Pennsylvania,East Uniontown,2540,853,708,325,42,169,2097
Pennsylvania,Kennett Square borough,6159,1844,2397,447,172,207,5067
Pennsylvania,Daisytown borough,375,94,155,26,5,22,302
Pennsylvania,Belfast,1052,229,496,121,14,91,951
Pennsylvania,South Pottstown,2286,584,792,209,99,167,1851
Pennsylvania,McSherrystown borough,3071,712,1167,300,123,135,2437
Pennsylvania,Ford City borough,2848,721,1041,307,40,248,2357
Pennsylvania,Centerville borough (Crawford County),195,21,97,28,3,14,163
Pennsylvania,Snydertown borough,296,63,155,35,0,29,282
Pennsylvania,Shamokin,7096,1924,2054,882,202,628,5690
Pennsylvania,Northumberland borough,3692,625,1666,433,35,200,2959
Pennsylvania,Marion Heights borough,676,157,312,49,9,39,566
Pennsylvania,Edgewood,2376,827,706,157,72,191,1953
Pennsylvania,Tamaqua borough,6796,1723,2373,686,243,465,5490
Pennsylvania,Watsontown borough,2496,561,1012,176,73,236,2058
Pennsylvania,Palo Alto borough,887,138,444,83,11,63,739
Pennsylvania,Middleport borough,426,113,182,41,3,35,374
Pennsylvania,Wayne Heights,2438,506,979,204,74,96,1859
Pennsylvania,South Renovo borough,458,104,173,51,9,56,393
Pennsylvania,Yardley borough,2472,721,994,282,48,102,2147
Pennsylvania,Warrior Run borough,633,207,201,57,21,38,524
Pennsylvania,Bryn Athyn borough,1282,371,621,51,8,33,1084
Pennsylvania,Oneida,110,37,34,14,3,9,97
Pennsylvania,Bowmanstown borough,1019,297,386,91,11,79,864
Pennsylvania,Palmerton borough,5314,1201,2096,490,90,322,4199
Pennsylvania,Parryville borough,503,76,243,50,0,37,406
Pennsylvania,Midway borough,876,209,318,104,13,40,684
Pennsylvania,Middletown,7386,1951,3484,629,68,428,6560
Pennsylvania,Franklin Park borough,14448,1914,7925,572,221,538,11170
Pennsylvania,Galeton borough,998,213,392,155,26,71,857
Pennsylvania,Forty Fort borough,4129,892,1739,489,150,207,3477
Pennsylvania,Yatesville borough,617,181,280,35,0,27,523
Pennsylvania,Nuangola borough,759,161,359,59,6,63,648
Pennsylvania,Wilmore borough,245,59,99,21,1,9,189
Pennsylvania,Johnstown,19812,6672,4674,2387,635,1654,16022
Pennsylvania,Franklin,6216,1548,2168,846,152,490,5204
Pennsylvania,Juniata Terrace borough,513,83,221,54,4,30,392
Pennsylvania,Highland Park,1233,306,428,106,18,179,1037
Pennsylvania,Coburn,139,21,56,5,0,0,82
Pennsylvania,Boalsburg,4666,993,2429,352,41,164,3979
Pennsylvania,Weatherly borough,2615,627,1080,217,13,299,2236
Pennsylvania,Reinerton,520,128,227,60,11,24,450
Pennsylvania,Swarthmore borough,6304,2305,2279,336,60,170,5150
Pennsylvania,Darby borough,10699,3863,1881,826,425,625,7620
Pennsylvania,Lansdowne borough,10628,3244,3807,930,320,405,8706
Pennsylvania,Burlington borough,210,36,81,5,4,9,135
Pennsylvania,Towanda borough,2850,729,948,335,74,118,2204
Pennsylvania,West Kittanning borough,1161,186,491,110,29,127,943
Pennsylvania,Blakely borough,6316,1535,2793,655,90,593,5666
Pennsylvania,Glenburn,920,130,488,71,4,83,776
Pennsylvania,Jermyn borough,2164,626,775,303,24,171,1899
Pennsylvania,New Paris borough,190,52,90,21,2,4,169
Pennsylvania,Moscow borough,1859,467,923,133,26,105,1654
Pennsylvania,New Wilmington borough,2297,1255,537,108,20,165,2085
Pennsylvania,Duncannon borough,1489,280,528,252,19,131,1210
Pennsylvania,Mechanicsburg borough,8987,2236,3845,1031,151,420,7683
Pennsylvania,Evans City borough,1844,421,832,196,25,67,1541
Pennsylvania,Harrisville borough,899,193,318,75,37,100,723
Pennsylvania,Meridian,3765,607,2011,222,49,256,3145
Pennsylvania,New Castle Northwest,1284,243,584,84,51,166,1128
Pennsylvania,Zelienople borough,3683,820,1617,263,99,323,3122
Pennsylvania,Hyndman borough,824,158,434,60,10,47,709
Pennsylvania,Matamoras borough,2250,613,828,236,33,160,1870
Pennsylvania,Lebanon,25739,8018,7099,2955,492,1346,19910
Pennsylvania,Fairchance borough,2094,477,902,193,34,74,1680
Pennsylvania,Fayette City borough,496,116,174,53,22,39,404
Pennsylvania,Masontown borough,3358,818,1058,350,40,438,2704
Pennsylvania,Harrison City,69,0,40,14,0,15,69
Pennsylvania,Lynnwood-Pricedale,1774,373,894,139,17,172,1595
Pennsylvania,Coaldale borough (Bedford County),137,26,71,7,2,12,118
Pennsylvania,Madison borough,354,54,187,30,5,39,315
Pennsylvania,South Greensburg borough,2217,631,867,231,65,149,1943
Pennsylvania,Southwest Greensburg borough,2187,496,928,256,60,102,1842
Pennsylvania,Youngwood borough,2923,767,1265,257,41,199,2529
Pennsylvania,Beaver borough,4368,790,2028,408,40,371,3637
Pennsylvania,Monaca borough,5570,1233,2135,707,140,465,4680
Pennsylvania,Ohioville borough,3364,729,1594,299,49,198,2869
Pennsylvania,Mount Pleasant borough,4299,852,1780,624,85,325,3666
Pennsylvania,Pymatuning Central,2088,377,1104,208,61,176,1926
Pennsylvania,Townville borough,297,56,135,18,13,18,240
Pennsylvania,St. Petersburg borough,294,60,132,43,6,14,255
Pennsylvania,Mahaffey borough,391,94,168,41,17,22,342
Pennsylvania,New Washington borough,39,7,24,2,2,2,37
Pennsylvania,Osceola Mills borough,1051,241,436,71,28,68,844
Pennsylvania,Treasure Lake,3357,784,1464,411,0,140,2799
Pennsylvania,Wallaceton borough,316,63,125,28,17,19,252
Pennsylvania,Croydon,9675,2768,3574,761,185,539,7827
Pennsylvania,Glen Hope borough,163,25,93,13,0,9,140
Pennsylvania,Langhorne Manor borough,1563,794,452,110,0,60,1416
Pennsylvania,Richfield,564,85,276,9,7,91,468
Pennsylvania,Biglerville borough,1208,324,462,94,14,52,946
Pennsylvania,Carroll Valley borough,3907,655,1955,215,57,272,3154
Pennsylvania,Fairfield borough,544,105,278,34,9,38,464
Pennsylvania,Nemacolin,640,189,171,148,41,15,564
Pennsylvania,Rices Landing borough,494,91,200,58,6,51,406
Pennsylvania,Richlandtown borough,1202,321,480,93,27,82,1003
Pennsylvania,Woodward,156,33,60,2,0,10,105
Pennsylvania,Oxford borough,5420,1204,1577,595,213,282,3871
Pennsylvania,Williamsport,28757,11093,7920,2669,823,1205,23710
Pennsylvania,Ehrenfeld borough,167,32,74,16,2,17,141
Pennsylvania,Northern Cambria borough,3618,935,1477,319,59,125,2915
Pennsylvania,Summerhill borough,430,62,227,29,2,41,361
Pennsylvania,Vinco,1200,151,644,98,31,78,1002
Pennsylvania,Westmont borough,4866,1039,2636,260,13,155,4103
Pennsylvania,Grove City borough,8053,3636,2182,584,89,531,7022
Pennsylvania,New Milford borough,965,204,369,111,13,51,748
Pennsylvania,McDonald borough,2135,529,759,271,99,130,1788
Pennsylvania,New Kingstown,711,117,314,44,30,54,559
Pennsylvania,McGovern,2632,463,1249,275,18,147,2152
Pennsylvania,Stoneboro borough,850,147,368,151,12,87,765
Pennsylvania,Carlisle borough,19116,6382,6340,1510,369,1150,15751
Pennsylvania,Kenilworth,1991,559,881,97,52,94,1683
Pennsylvania,Garden View,2726,651,1252,145,22,227,2297
Pennsylvania,Montoursville borough,4483,927,1999,446,92,308,3772
Pennsylvania,Cornwall borough,4270,535,2475,341,34,277,3662
Pennsylvania,Summit Hill borough,2958,745,1278,236,67,176,2502
Pennsylvania,Lehighton borough,5313,1298,1783,685,135,451,4352
Pennsylvania,Mont Alto borough,1767,592,729,170,14,54,1559
Pennsylvania,Petrolia borough,174,36,55,23,5,20,139
Pennsylvania,Prospect borough,1052,178,538,128,14,58,916
Pennsylvania,Valencia borough,517,90,201,39,1,156,487
Pennsylvania,West Liberty borough,368,72,173,27,18,20,310
Pennsylvania,Adamsville,59,7,31,5,0,11,54
Pennsylvania,Shippenville borough,585,86,233,74,12,62,467
Pennsylvania,Eau Claire borough,348,96,158,16,0,12,282
Pennsylvania,Rochester borough,3530,1009,1041,626,49,254,2979
Pennsylvania,Brownsville borough,2046,696,603,267,17,150,1733
Pennsylvania,Dayton borough,530,71,257,36,7,45,416
Pennsylvania,Timber Hills,611,79,442,0,0,0,521
Pennsylvania,Danville borough,4646,1914,1101,596,59,325,3995
Pennsylvania,Mount Jewett borough,1012,260,384,85,8,64,801
Pennsylvania,Smethport borough,1649,285,718,196,21,99,1319
Pennsylvania,Belle Vernon borough,1016,245,283,183,31,158,900
Pennsylvania,Wormleysburg borough,3061,1062,1070,256,28,72,2488
Pennsylvania,West Middlesex borough,764,202,308,56,29,51,646
Pennsylvania,Jackson Center borough,197,32,85,25,2,8,152
Pennsylvania,Austin borough,548,158,201,33,18,74,484
Pennsylvania,Coudersport borough,2699,757,826,281,29,346,2239
Pennsylvania,Oswayo borough,198,45,69,9,5,10,138
Pennsylvania,Linntown,1344,301,835,41,14,17,1208
Pennsylvania,Beallsville borough,511,117,219,49,7,29,421
Pennsylvania,Charleroi borough,3976,1374,935,534,122,282,3247
Pennsylvania,Ellsworth borough,625,228,185,72,8,23,516
Pennsylvania,Gastonville,2687,646,1255,299,0,232,2432
Pennsylvania,New Eagle borough,2118,436,836,272,41,185,1770
Pennsylvania,Volant borough,111,26,55,10,1,6,98
Pennsylvania,Harmonsburg,468,104,134,63,5,20,326
Pennsylvania,Newport borough,1585,478,502,223,35,89,1327
Pennsylvania,Lincolnville,192,35,84,0,0,0,119
Pennsylvania,Pymatuning South,329,73,162,42,12,11,300
Pennsylvania,Marysville borough,2543,527,981,282,46,177,2013
Pennsylvania,West Hills,1171,204,611,42,45,73,975
Pennsylvania,Eastlawn Gardens,3387,899,1417,192,71,169,2748
Pennsylvania,Archbald borough,7002,1614,2846,660,42,486,5648
Pennsylvania,Oak Hills,2258,445,986,380,66,58,1935
Pennsylvania,Berwick borough,10167,2828,3619,1201,255,667,8570
Pennsylvania,Jonestown,83,16,57,7,0,3,83
Pennsylvania,Wilburton Number One,184,45,57,32,11,20,165
Pennsylvania,Lawnton,3986,810,1723,393,71,148,3145
Pennsylvania,Linglestown,5742,1234,2963,545,9,229,4980
Pennsylvania,Pillow borough,256,43,134,15,0,7,199
Pennsylvania,Berrysburg borough,323,85,146,22,14,24,291
Pennsylvania,Manorville borough,447,111,180,38,7,27,363
Pennsylvania,Hawthorn borough,416,68,202,47,1,18,336
Pennsylvania,Markleysburg borough,279,48,83,45,0,39,215
Pennsylvania,Tunkhannock borough,1771,503,656,209,51,143,1562
Pennsylvania,Chester Hill borough,830,217,317,76,6,45,661
Pennsylvania,Jim Thorpe borough,4643,1302,1571,547,228,369,4017
Pennsylvania,Greencastle borough,4021,797,1781,347,79,324,3328
Pennsylvania,West Easton borough,1387,359,491,133,52,95,1130
Pennsylvania,Bell Acres borough,1434,223,773,92,12,55,1155
Pennsylvania,Vowinckel,82,19,52,0,0,11,82
Pennsylvania,Aspinwall borough,2756,610,1246,205,15,112,2188
Pennsylvania,Hartstown,198,66,61,38,3,12,180
Pennsylvania,Springboro borough,435,113,152,63,2,8,338
Pennsylvania,Woodcock borough,122,20,69,10,0,9,108
Pennsylvania,Linesville borough,1002,157,412,103,10,117,799
Pennsylvania,New Beaver borough,1413,323,682,111,8,93,1217
Pennsylvania,S.N.P.J. borough,31,3,19,4,2,1,29
Pennsylvania,Wampum borough,628,143,278,58,11,61,551
Pennsylvania,Liverpool borough,855,223,366,85,14,73,761
Pennsylvania,Millerstown borough,791,146,349,77,12,52,636
Pennsylvania,Colver,810,264,273,46,49,73,705
Pennsylvania,Cresson borough,1709,585,639,103,9,128,1464
Pennsylvania,Dale borough,1056,332,269,143,35,98,877
Pennsylvania,Gallitzin borough,1599,381,576,190,14,92,1253
Pennsylvania,Bally borough,1264,249,538,111,21,54,973
Pennsylvania,Centerport borough,240,50,85,44,1,13,193
Pennsylvania,Clarks Summit borough,4915,675,2142,583,171,419,3990
Pennsylvania,Honey Brook borough,1865,384,758,150,46,119,1457
Pennsylvania,Avalon borough,4626,1566,1670,505,26,346,4113
Pennsylvania,Falls Creek borough,1019,234,469,105,14,29,851
Pennsylvania,Sunrise Lake,1239,36,774,12,0,76,898
Pennsylvania,Sun Valley,2013,522,759,261,36,74,1652
Pennsylvania,Swartzville,2463,804,919,269,24,146,2162
Pennsylvania,Sweden Valley,231,35,117,19,6,7,184
Pennsylvania,Table Rock,40,0,20,0,0,15,35
Pennsylvania,Taylorstown,226,37,95,25,0,5,162
Pennsylvania,Washington,13590,5171,3851,1790,275,708,11795
Pennsylvania,Templeton,290,50,138,23,10,10,231
Pennsylvania,The Hideout,1438,262,756,30,0,186,1234
Pennsylvania,Toftrees,2861,1350,1231,68,0,104,2753
Pennsylvania,Towamensing Trails,1924,246,1057,110,90,53,1556
Pennsylvania,Trexlertown,2182,586,962,127,32,158,1865
Pennsylvania,Trucksville,2084,385,1051,76,73,82,1667
Pennsylvania,Tyler Run,1775,504,686,215,23,255,1683
Pennsylvania,Tharptown (Uniontown),438,56,240,48,6,49,399
Pennsylvania,Boiling Springs,3144,650,1598,277,14,100,2639
Pennsylvania,Lemoyne borough,4641,1493,1732,211,111,258,3805
Pennsylvania,Portage borough,2491,617,976,243,35,199,2070
Pennsylvania,Stouchsburg,422,81,213,9,18,17,338
Pennsylvania,Strodes Mills,969,165,594,21,0,39,819
Pennsylvania,Strong,0,0,0,0,0,0,0
Pennsylvania,Howard borough,670,160,296,78,0,40,574
Pennsylvania,Dupont borough,2693,637,1216,314,0,201,2368
Pennsylvania,Seneca,1162,207,610,105,19,49,990
Pennsylvania,East Lansdowne borough,2678,895,1002,219,58,69,2243
Pennsylvania,New Oxford borough,2099,558,699,168,47,135,1607
Pennsylvania,McAlisterville,1068,214,462,77,0,48,801
Pennsylvania,Sellersville borough,4255,1157,1511,526,93,121,3408
Pennsylvania,Johnsonburg borough,2353,611,856,288,52,168,1975
Pennsylvania,Nanty-Glo borough,2570,711,1014,177,51,173,2126
Pennsylvania,Lorain borough,716,198,279,82,8,58,625
Pennsylvania,Elim,3376,789,1468,369,15,293,2934
Pennsylvania,Quakertown borough,8836,2491,2903,1028,195,572,7189
Pennsylvania,Tylersburg,89,21,63,0,0,5,89
Pennsylvania,Sturgeon,1580,366,786,117,18,68,1355
Pennsylvania,Union Deposit,415,61,177,22,0,0,260
Pennsylvania,University of Pittsburgh Johnstown,1552,1550,2,0,0,0,1552
Pennsylvania,Nescopeck borough,1565,365,692,194,9,113,1373
Pennsylvania,Hartleton borough,260,43,138,15,4,17,217
Pennsylvania,Rutledge borough,729,148,354,51,16,37,606
Pennsylvania,Linwood,3267,1201,668,332,138,216,2555
Pennsylvania,Folsom,8707,2143,3829,594,120,334,7020
Pennsylvania,Clifton Heights borough,6680,2410,2068,581,119,270,5448
Pennsylvania,West Wyoming borough,2692,682,1158,243,33,227,2343
Pennsylvania,Orrtanna,156,21,66,22,0,12,121
Pennsylvania,Lake Heritage,2303,235,1350,166,52,80,1883
Pennsylvania,Herndon borough,387,47,182,23,6,20,278
Pennsylvania,Williamsburg borough,1104,238,415,142,9,64,868
Pennsylvania,Thorndale,3956,1034,1530,492,128,153,3337
Pennsylvania,Garrett borough,392,84,171,27,12,36,330
Pennsylvania,Van Voorhis,182,55,78,11,0,27,171
Pennsylvania,Midway,1969,473,908,135,55,147,1718
Pennsylvania,Luzerne borough,2809,889,840,418,68,274,2489
Pennsylvania,Nanticoke,10302,3355,3481,892,198,789,8715
Pennsylvania,Hasson Heights,1586,275,694,188,45,90,1292
Pennsylvania,Upper Exeter,810,209,469,12,0,10,700
Pennsylvania,North Charleroi borough,1347,371,462,137,20,147,1137
Pennsylvania,Houston borough,1371,324,446,152,47,139,1108
Pennsylvania,Enon Valley borough,377,77,170,20,12,15,294
Pennsylvania,Sharpsville borough,4202,957,1701,339,59,358,3414
Pennsylvania,Manor borough,3294,586,1424,224,31,195,2460
Pennsylvania,Laurel Mountain borough,179,33,78,10,3,16,140
Pennsylvania,Hyde Park borough,464,119,180,52,8,40,399
Pennsylvania,Crabtree,190,40,85,7,0,0,132
Pennsylvania,Conyngham borough,1928,414,867,196,22,164,1663
Pennsylvania,Saltsburg borough,738,172,273,114,16,66,641
Pennsylvania,Clymer borough,1235,295,442,128,22,110,997
Pennsylvania,Mifflin borough,534,165,212,20,12,32,441
Pennsylvania,Woodbourne,4006,942,2175,141,52,107,3417
Pennsylvania,Polk borough,788,378,215,72,2,16,683
Pennsylvania,Unionville,811,183,284,233,0,55,755
Pennsylvania,Stony Creek Mills,777,172,380,77,9,42,680
Pennsylvania,Trevose,3716,1310,1376,216,19,181,3102
Pennsylvania,Stonerstown,423,118,176,39,5,20,358
Pennsylvania,Jamestown borough,648,116,274,88,13,39,530
Pennsylvania,Vicksburg,769,239,379,0,0,18,636
Pennsylvania,Cherry Valley borough,62,6,27,12,2,2,49
Pennsylvania,Rennerdale,914,183,381,113,55,112,844
Pennsylvania,Revloc,696,167,280,28,0,35,510
Pennsylvania,Rew,136,8,47,32,22,8,117
Pennsylvania,South Bethlehem borough,439,98,208,38,0,35,379
Pennsylvania,Reynolds Heights,1636,466,553,235,54,133,1441
Pennsylvania,Riverview Park,2726,484,1467,245,14,141,2351
Pennsylvania,Robinson,542,108,308,31,12,11,470
Pennsylvania,Rogersville,252,64,124,12,0,16,216
Pennsylvania,Ronco,133,13,0,77,0,15,105
Pennsylvania,Ronks,130,50,38,16,0,0,104
Pennsylvania,Rote,558,107,307,46,0,23,483
Pennsylvania,Riverside,273,44,157,27,0,27,255
Pennsylvania,Reinholds,2600,697,1204,129,0,45,2075
Pennsylvania,Mount Oliver borough,3340,1542,593,290,49,194,2668
Pennsylvania,South Williamsport borough,6193,1470,2469,704,116,279,5038
Pennsylvania,Carnegie borough,7905,2671,2451,946,126,614,6808
Pennsylvania,New Columbus borough,206,58,77,12,2,17,166
Pennsylvania,Bruin borough,440,88,224,22,7,22,363
Pennsylvania,Stonybrook,2250,296,1089,234,25,151,1795
Pennsylvania,Burgettstown borough,1385,427,438,200,5,86,1156
Pennsylvania,Baden borough,3977,976,1749,272,116,351,3464
Pennsylvania,Donegal borough,218,39,103,7,10,13,172
Pennsylvania,Collegeville borough,5170,2550,1672,203,24,63,4512
Pennsylvania,Glasgow borough,104,39,18,2,1,3,63
Pennsylvania,Emlenton borough,706,144,305,44,12,44,549
Pennsylvania,Westfield borough,1295,317,467,115,49,87,1035
Pennsylvania,Bangor borough,5225,1370,2017,280,184,420,4271
Pennsylvania,McMurray,4414,786,2487,204,20,148,3645
Pennsylvania,Telford borough,4793,1060,1917,353,104,352,3786
Pennsylvania,Shade Gap borough,83,20,23,8,5,9,65
Pennsylvania,Roulette,895,227,272,102,21,75,697
Pennsylvania,Rowes Run,640,146,239,41,35,7,468
Pennsylvania,Farrell,4722,1192,1267,553,151,519,3682
Pennsylvania,St. Michael,339,13,236,46,0,0,295
Pennsylvania,Slippery Rock University,2266,2240,26,0,0,0,2266
Pennsylvania,Slovan,490,73,255,31,0,30,389
Pennsylvania,Smock,556,87,260,29,19,40,435
Pennsylvania,Smoketown,372,8,201,0,14,13,236
Pennsylvania,Soudersburg,830,182,285,0,0,43,510
Pennsylvania,South Philipsburg,353,86,144,44,0,20,294
Pennsylvania,South Uniontown,1415,219,760,112,41,76,1208
Pennsylvania,Southview,352,152,83,76,0,8,319
Pennsylvania,Spinnerstown,1822,369,911,52,11,70,1413
Pennsylvania,Springmont,553,148,221,79,0,56,504
Pennsylvania,Starbrick,377,65,161,95,0,20,341
Pennsylvania,Star Junction,397,132,149,40,10,35,366
Pennsylvania,Stevens,445,64,247,52,0,0,363
Pennsylvania,Stiles,1220,386,443,189,14,41,1073
Pennsylvania,Russell,1383,231,808,50,13,95,1197
Pennsylvania,Slatedale,862,121,346,84,0,13,564
Pennsylvania,Simpson,1238,246,503,135,10,100,994
Pennsylvania,State Line,2287,366,1127,190,29,95,1807
Pennsylvania,Siglerville,158,14,116,10,0,10,150
Pennsylvania,Silkworth,928,187,460,42,34,47,770
Pennsylvania,Salix,1340,268,554,125,44,78,1069
Pennsylvania,Salunga,3100,504,1358,398,82,180,2522
Pennsylvania,Saw Creek,3757,1104,1798,193,105,95,3295
Pennsylvania,Saylorsburg,552,227,80,110,37,77,531
Pennsylvania,Schoeneck,1057,148,612,36,0,21,817
Pennsylvania,Schubert,264,51,114,14,0,30,209
Pennsylvania,St. Vincent College,1274,1250,5,13,0,0,1268
Pennsylvania,Shartlesville,587,124,320,17,11,47,519
Pennsylvania,Shavertown,2216,361,921,214,46,230,1772
Pennsylvania,Sheatown,840,214,293,27,40,82,656
Pennsylvania,Shippensburg University,1940,1919,21,0,0,0,1940
Pennsylvania,Sierra View,4487,1114,1942,420,113,196,3785
Pennsylvania,Scotland,836,125,492,42,0,26,685
Pennsylvania,Sidman,462,116,223,0,0,27,366
Puerto Rico,Culebra zona urbana,1182,,,,,,0
Puerto Rico,Las Ochenta comunidad,792,,,,,,0
Puerto Rico,Jobos comunidad,2103,,,,,,0
Puerto Rico,Rafael Capó comunidad,1709,,,,,,0
Puerto Rico,Humacao zona urbana,18487,,,,,,0
Puerto Rico,Bartolo comunidad,1232,,,,,,0
Puerto Rico,Río Grande zona urbana,12973,,,,,,0
Puerto Rico,Central Aguirre comunidad,1318,,,,,,0
Puerto Rico,Playita comunidad (Salinas Municipio),523,,,,,,0
Puerto Rico,G. L. García comunidad,1851,,,,,,0
Puerto Rico,Las Ollas comunidad,1722,,,,,,0
Puerto Rico,Galateo comunidad,3097,,,,,,0
Puerto Rico,San Antonio comunidad (Quebradillas Municipio),1591,,,,,,0
Puerto Rico,Levittown comunidad,25225,,,,,,0
Puerto Rico,Pole Ojea comunidad,1684,,,,,,0
Puerto Rico,Benítez comunidad,1444,,,,,,0
Puerto Rico,Caguas zona urbana,74980,,,,,,0
Puerto Rico,Vieques comunidad,2527,,,,,,0
Puerto Rico,Suárez comunidad,1877,,,,,,0
Puerto Rico,Puerto Real comunidad,6892,,,,,,0
Puerto Rico,Barranquitas zona urbana,2276,,,,,,0
Puerto Rico,Sabana Hoyos comunidad,2244,,,,,,0
Puerto Rico,La Playa comunidad,2131,,,,,,0
Puerto Rico,Isabela zona urbana,10708,,,,,,0
Puerto Rico,Adjuntas zona urbana,4222,,,,,,0
Puerto Rico,Playa Fortuna comunidad,1119,,,,,,0
Puerto Rico,Guayanilla zona urbana,4634,,,,,,0
Puerto Rico,Pájaros comunidad,9554,,,,,,0
Puerto Rico,Rosa Sánchez comunidad,415,,,,,,0
Puerto Rico,Lomas comunidad,1267,,,,,,0
Puerto Rico,Monserrate comunidad,2462,,,,,,0
Puerto Rico,Palmer comunidad,1017,,,,,,0
Puerto Rico,Barahona comunidad,2241,,,,,,0
Puerto Rico,Coto Norte comunidad,1225,,,,,,0
Puerto Rico,Villalba zona urbana,3028,,,,,,0
Puerto Rico,Ingenio comunidad,3896,,,,,,0
Puerto Rico,Marueño comunidad,838,,,,,,0
Puerto Rico,Capitanejo comunidad,3038,,,,,,0
Puerto Rico,Palo Seco comunidad,681,,,,,,0
Puerto Rico,María Antonia comunidad,944,,,,,,0
Puerto Rico,Río Lajas comunidad,2394,,,,,,0
Puerto Rico,Corozal zona urbana,8871,,,,,,0
Puerto Rico,Palmarejo comunidad (Coamo Municipio),676,,,,,,0
Puerto Rico,Piedra Gorda comunidad,1392,,,,,,0
Puerto Rico,Jayuya zona urbana,2506,,,,,,0
Puerto Rico,Barceloneta zona urbana,3851,,,,,,0
Puerto Rico,Las Marías comunidad,2286,,,,,,0
Puerto Rico,Yauco zona urbana,16802,,,,,,0
Puerto Rico,Potala Pastillo comunidad,2927,,,,,,0
Puerto Rico,Aguadilla zona urbana,11170,,,,,,0
Puerto Rico,Imbéry comunidad,4280,,,,,,0
Puerto Rico,Comerío zona urbana,4661,,,,,,0
Puerto Rico,Parcelas Nuevas comunidad,1399,,,,,,0
Puerto Rico,Cidra zona urbana,5620,,,,,,0
Puerto Rico,Cataño zona urbana,24888,,,,,,0
Puerto Rico,Loíza zona urbana,3343,,,,,,0
Puerto Rico,Garrochales comunidad,1125,,,,,,0
Puerto Rico,Bajadero comunidad,3411,,,,,,0
Puerto Rico,Cabán comunidad,3419,,,,,,0
Puerto Rico,Añasco zona urbana,5526,,,,,,0
Puerto Rico,Río Cañas Abajo comunidad,1242,,,,,,0
Puerto Rico,Aibonito zona urbana,8352,,,,,,0
Puerto Rico,Santa Clara comunidad,747,,,,,,0
Puerto Rico,Moca zona urbana,3486,,,,,,0
Puerto Rico,Breñas comunidad,4030,,,,,,0
Puerto Rico,Coquí comunidad,3187,,,,,,0
Puerto Rico,Miranda comunidad,1495,,,,,,0
Puerto Rico,Magas Arriba comunidad,910,,,,,,0
Puerto Rico,La Parguera comunidad,772,,,,,,0
Puerto Rico,Lares zona urbana,3983,,,,,,0
Puerto Rico,Las Marías zona urbana,704,,,,,,0
Puerto Rico,Sabana Grande zona urbana,9357,,,,,,0
Puerto Rico,Coco comunidad,5328,,,,,,0
Puerto Rico,San Lorenzo zona urbana,7629,,,,,,0
Puerto Rico,Vega Baja zona urbana,22815,,,,,,0
Puerto Rico,La Fermina comunidad,2574,,,,,,0
Puerto Rico,Playita comunidad (Yabucoa Municipio),1755,,,,,,0
Puerto Rico,Santa Isabel zona urbana,6196,,,,,,0
Puerto Rico,Luquillo zona urbana,7841,,,,,,0
Puerto Rico,Pueblito del Río comunidad,1418,,,,,,0
Puerto Rico,Duque comunidad,1643,,,,,,0
Puerto Rico,Juana Díaz zona urbana,7095,,,,,,0
Puerto Rico,Arroyo zona urbana,6134,,,,,,0
Puerto Rico,Tiburones comunidad,2072,,,,,,0
Puerto Rico,Ciales zona urbana,2274,,,,,,0
Puerto Rico,Campo Rico comunidad,2493,,,,,,0
Puerto Rico,Quebrada comunidad,1087,,,,,,0
Puerto Rico,Celada comunidad,4543,,,,,,0
Puerto Rico,Sabana Eneas comunidad,1120,,,,,,0
Puerto Rico,San Antonio comunidad (Aguadilla Municipio),1544,,,,,,0
Puerto Rico,Florida zona urbana,4274,,,,,,0
Puerto Rico,Hatillo zona urbana,4235,,,,,,0
Puerto Rico,El Ojo comunidad,1391,,,,,,0
Puerto Rico,La Dolores comunidad,2911,,,,,,0
Puerto Rico,H. Rivera Colón comunidad,2594,,,,,,0
Puerto Rico,Patillas zona urbana,3292,,,,,,0
Puerto Rico,Tallaboa comunidad,882,,,,,,0
Puerto Rico,Ponce zona urbana,116796,,,,,,0
Puerto Rico,El Negro comunidad,1221,,,,,,0
Puerto Rico,Mucarabones comunidad,1092,,,,,,0
Puerto Rico,Toa Alta zona urbana,3829,,,,,,0
Puerto Rico,Vieques zona urbana,3096,,,,,,0
Puerto Rico,Carolina zona urbana,140072,,,,,,0
Puerto Rico,Indios comunidad,1367,,,,,,0
Puerto Rico,Lajas zona urbana,4642,,,,,,0
Puerto Rico,Las Piedras zona urbana,6402,,,,,,0
Puerto Rico,Orocovis zona urbana,969,,,,,,0
Puerto Rico,Palomas comunidad (Comerío Municipio),1462,,,,,,0
Puerto Rico,Utuado zona urbana,7160,,,,,,0
Puerto Rico,Olimpo comunidad,2300,,,,,,0
Puerto Rico,Carrizales comunidad,3052,,,,,,0
Puerto Rico,Manatí zona urbana,12899,,,,,,0
Puerto Rico,Mayagüez zona urbana,62579,,,,,,0
Puerto Rico,Río Blanco comunidad,1631,,,,,,0
Puerto Rico,Peñuelas zona urbana,5253,,,,,,0
Puerto Rico,Quebradillas zona urbana,4495,,,,,,0
Puerto Rico,Vázquez comunidad,1839,,,,,,0
Puerto Rico,Toa Baja zona urbana,1370,,,,,,0
Puerto Rico,Morovis zona urbana,1941,,,,,,0
Puerto Rico,Hato Arriba comunidad,387,,,,,,0
Puerto Rico,Maricao zona urbana,789,,,,,,0
Puerto Rico,San Juan zona urbana,331165,,,,,,0
Puerto Rico,La Alianza comunidad,1602,,,,,,0
Puerto Rico,Bayamón comunidad,1784,,,,,,0
Puerto Rico,Jagual comunidad,1479,,,,,,0
Puerto Rico,Quebrada del Agua comunidad,1244,,,,,,0
Puerto Rico,Tibes comunidad,403,,,,,,0
Puerto Rico,Rodríguez Hevia comunidad,66,,,,,,0
Puerto Rico,Vayas comunidad,631,,,,,,0
Puerto Rico,Cerrillos Hoyos comunidad,985,,,,,,0
Puerto Rico,Corral Viejo comunidad,514,,,,,,0
Puerto Rico,Pastos comunidad,1174,,,,,,0
Puerto Rico,Liborio Negrón Torres comunidad,1228,,,,,,0
Puerto Rico,Yaurel comunidad,1302,,,,,,0
Puerto Rico,Rafael Hernández comunidad,1029,,,,,,0
Puerto Rico,Búfalo comunidad,992,,,,,,0
Puerto Rico,Aguilita comunidad,3928,,,,,,0
Puerto Rico,Guayabal comunidad,1579,,,,,,0
Puerto Rico,Camuy zona urbana,3834,,,,,,0
Puerto Rico,Cayey zona urbana,14610,,,,,,0
Puerto Rico,Guánica zona urbana,6781,,,,,,0
Puerto Rico,Hormigueros zona urbana,11009,,,,,,0
Puerto Rico,Antón Ruíz comunidad,2279,,,,,,0
Puerto Rico,Bajandas comunidad,637,,,,,,0
Puerto Rico,Esperanza comunidad,775,,,,,,0
Puerto Rico,Punta Santiago comunidad,4880,,,,,,0
Puerto Rico,Cacao comunidad,1364,,,,,,0
Puerto Rico,Campanilla comunidad,5304,,,,,,0
Puerto Rico,San José comunidad,2483,,,,,,0
Puerto Rico,Vega Alta zona urbana,9394,,,,,,0
Puerto Rico,Pueblito del Carmen comunidad,623,,,,,,0
Puerto Rico,Piedra Aguza comunidad,2697,,,,,,0
Puerto Rico,Parcelas Viejas Borinquen comunidad,665,,,,,,0
Puerto Rico,Parcelas Mandry comunidad,481,,,,,,0
Puerto Rico,San Sebastián zona urbana,8490,,,,,,0
Puerto Rico,Fránquez comunidad,1912,,,,,,0
Puerto Rico,Trujillo Alto zona urbana,44689,,,,,,0
Puerto Rico,Boquerón comunidad (Cabo Rojo Municipio),2401,,,,,,0
Puerto Rico,Boquerón comunidad (Las Piedras Municipio),1168,,,,,,0
Puerto Rico,Bairoa La Veinticinco comunidad,350,,,,,,0
Puerto Rico,Hacienda San José comunidad,2843,,,,,,0
Puerto Rico,Alianza comunidad,2786,,,,,,0
Puerto Rico,Anon Raices comunidad,129,,,,,,0
Puerto Rico,Buena Vista comunidad (Arroyo Municipio),1298,,,,,,0
Puerto Rico,Buena Vista comunidad (Humacao Municipio),962,,,,,,0
Puerto Rico,Calzada comunidad,178,,,,,,0
Puerto Rico,Peña Pobre comunidad,680,,,,,,0
Puerto Rico,Candelero Abajo comunidad,386,,,,,,0
Puerto Rico,El Paraiso comunidad,1757,,,,,,0
Puerto Rico,El Tumbao comunidad,2079,,,,,,0
Puerto Rico,La Liga comunidad,241,,,,,,0
Puerto Rico,Las Carolinas comunidad,2023,,,,,,0
Puerto Rico,Las Croabas comunidad,905,,,,,,0
Puerto Rico,La Yuca comunidad,458,,,,,,0
Puerto Rico,Los Panes comunidad,115,,,,,,0
Puerto Rico,Los Prados comunidad,2068,,,,,,0
Puerto Rico,Maguayo comunidad,996,,,,,,0
Puerto Rico,Monte Verde comunidad,28,,,,,,0
Puerto Rico,Palmas del Mar comunidad,1897,,,,,,0
Puerto Rico,Parcelas de Navarro comunidad,1569,,,,,,0
Puerto Rico,El Combate comunidad,207,,,,,,0
Puerto Rico,Naguabo zona urbana,5220,,,,,,0
Puerto Rico,Guayama zona urbana,22063,,,,,,0
Puerto Rico,Tierras Nuevas Poniente comunidad,3397,,,,,,0
Puerto Rico,Palmas comunidad,1088,,,,,,0
Puerto Rico,Jauca comunidad,1615,,,,,,0
Puerto Rico,Playita Cortada comunidad,946,,,,,,0
Puerto Rico,Ceiba zona urbana,5613,,,,,,0
Puerto Rico,El Mangó comunidad,1458,,,,,,0
Puerto Rico,Juncos zona urbana,7970,,,,,,0
Puerto Rico,Canóvanas zona urbana,7351,,,,,,0
Puerto Rico,Santa Bárbara comunidad,4673,,,,,,0
Puerto Rico,Coamo zona urbana,11148,,,,,,0
Puerto Rico,Fajardo zona urbana,25229,,,,,,0
Puerto Rico,Gurabo zona urbana,7515,,,,,,0
Puerto Rico,Parcelas Peñuelas comunidad,795,,,,,,0
Puerto Rico,La Plena comunidad,609,,,,,,0
Puerto Rico,Luis M. Cintrón comunidad,1866,,,,,,0
Puerto Rico,Corcovado comunidad,1744,,,,,,0
Puerto Rico,Daguao comunidad,1983,,,,,,0
Puerto Rico,San Antonio comunidad (Dorado Municipio),8144,,,,,,0
Puerto Rico,Salinas zona urbana,4694,,,,,,0
Puerto Rico,Luis Lloréns Torres comunidad,3192,,,,,,0
Puerto Rico,Mora comunidad,1780,,,,,,0
Puerto Rico,Juncal comunidad,759,,,,,,0
Puerto Rico,Mariano Colón comunidad,2757,,,,,,0
Puerto Rico,Stella comunidad,1610,,,,,,0
Puerto Rico,Palomas comunidad (Yauco Municipio),1761,,,,,,0
Puerto Rico,Yabucoa zona urbana,6829,,,,,,0
Puerto Rico,Martorell comunidad,2181,,,,,,0
Puerto Rico,Palmarejo comunidad (Lajas Municipio),1390,,,,,,0
Puerto Rico,Emajagua comunidad,2739,,,,,,0
Puerto Rico,Ramos comunidad,1536,,,,,,0
Puerto Rico,Aceitunas comunidad,1764,,,,,,0
Puerto Rico,Lamboglia comunidad,865,,,,,,0
Puerto Rico,Aguada zona urbana,2675,,,,,,0
Puerto Rico,Luyando comunidad,2766,,,,,,0
Puerto Rico,Espino comunidad,843,,,,,,0
Puerto Rico,Arecibo zona urbana,40108,,,,,,0
Puerto Rico,Betances comunidad,910,,,,,,0
Puerto Rico,Lluveras comunidad,1213,,,,,,0
Puerto Rico,San Germán zona urbana,11117,,,,,,0
Puerto Rico,Rafael González comunidad,1865,,,,,,0
Puerto Rico,Sabana comunidad,1064,,,,,,0
Puerto Rico,La Luisa comunidad,2445,,,,,,0
Puerto Rico,Maunabo zona urbana,1788,,,,,,0
Puerto Rico,Guaynabo zona urbana,69697,,,,,,0
Puerto Rico,Corazón comunidad,1724,,,,,,0
Puerto Rico,Fuig comunidad,1253,,,,,,0
Puerto Rico,Pajonal comunidad,707,,,,,,0
Puerto Rico,Los Llanos comunidad,1990,,,,,,0
Puerto Rico,Parcelas La Milagrosa comunidad,1081,,,,,,0
Puerto Rico,Naranjito zona urbana,1605,,,,,,0
Puerto Rico,Candelaria Arenas comunidad,3453,,,,,,0
Puerto Rico,Cayuco comunidad,1210,,,,,,0
Puerto Rico,Sabana Seca comunidad,7731,,,,,,0
Puerto Rico,Hato Candal comunidad,1673,,,,,,0
Puerto Rico,Tallaboa Alta comunidad,1472,,,,,,0
Puerto Rico,Rincón zona urbana,1077,,,,,,0
Puerto Rico,Candelero Arriba comunidad,1184,,,,,,0
Puerto Rico,Aguas Claras comunidad,2310,,,,,,0
Puerto Rico,San Isidro comunidad,6915,,,,,,0
Puerto Rico,Comunas comunidad,1209,,,,,,0
Puerto Rico,Bayamón zona urbana,165383,,,,,,0
Puerto Rico,Santo Domingo comunidad,3284,,,,,,0
Puerto Rico,Monte Grande comunidad,3446,,,,,,0
Puerto Rico,Candelaria comunidad,15846,,,,,,0
Puerto Rico,Animas comunidad,1190,,,,,,0
Puerto Rico,Aguas Buenas zona urbana,2866,,,,,,0
Puerto Rico,Ceiba comunidad,2078,,,,,,0
Puerto Rico,Dorado zona urbana,12330,,,,,,0
Puerto Rico,Coto Laurel comunidad,1639,,,,,,0
Puerto Rico,Cabo Rojo zona urbana,8862,,,,,,0
Rhode Island,Chepachet,1529,420,558,279,50,54,1361
Rhode Island,Clayville,223,21,94,16,7,11,149
Rhode Island,Greene,734,122,412,112,0,25,671
Rhode Island,Harmony,1128,239,503,136,0,83,961
Rhode Island,Misquamicut,361,37,240,35,0,42,354
Rhode Island,Watch Hill,144,28,73,35,0,0,136
Rhode Island,Weekapaug,457,85,204,68,0,35,392
Rhode Island,Hopkinton,722,91,363,46,14,71,585
Rhode Island,Charlestown,1241,221,707,77,14,113,1132
Rhode Island,Pawtucket,71756,24299,22216,7316,1757,3030,58618
Rhode Island,Westerly,17435,4212,7668,2108,172,917,15077
Rhode Island,Wyoming,284,50,115,70,15,0,250
Rhode Island,Providence,179435,78146,45410,12276,3843,6036,145711
Rhode Island,Narragansett Pier,3725,1287,1609,382,42,233,3553
Rhode Island,Cumberland Hill,8142,1460,4185,661,0,377,6683
Rhode Island,Hope Valley,1633,335,737,94,14,17,1197
Rhode Island,Warwick,81079,19818,35263,8559,633,5136,69409
Rhode Island,Pascoag,4824,901,2031,702,0,228,3862
Rhode Island,Central Falls,19382,6561,4874,1740,644,866,14685
Rhode Island,Quonochontaug,560,161,242,59,10,38,510
Rhode Island,Newport East,11561,3243,4723,1054,170,636,9826
Rhode Island,Woonsocket,41539,13619,12389,4988,801,2182,33979
Rhode Island,Carolina,602,72,350,91,0,13,526
Rhode Island,Foster Center,418,79,216,28,0,34,357
Rhode Island,Melville,1305,167,632,96,0,0,895
Rhode Island,Cranston,81196,24510,30324,7902,816,4331,67883
Rhode Island,Greenville,8387,1880,3869,715,15,828,7307
Rhode Island,Valley Falls,11828,3552,4937,984,38,695,10206
Rhode Island,Newport,24762,9997,7849,2550,275,1140,21811
Rhode Island,Tiverton,7757,1611,3627,698,73,482,6491
Rhode Island,Kingston,6789,5675,770,125,0,51,6621
Rhode Island,Ashaway,1186,244,559,143,12,30,988
Rhode Island,Wakefield-Peacedale,9092,2755,3254,1046,62,596,7713
Rhode Island,Harrisville,1348,432,326,213,24,104,1099
Rhode Island,Bradford,1432,484,559,129,14,80,1266
Rhode Island,East Providence,47449,13484,17376,5076,951,3055,39942
South Carolina,Lane,460,140,139,26,39,33,377
South Carolina,Clarks Hill,367,117,71,29,0,33,250
South Carolina,Lesslie,2809,416,1364,283,52,167,2282
South Carolina,Clover,5955,1341,2007,537,274,316,4475
South Carolina,Smoaks,91,14,53,7,6,5,85
South Carolina,Cameron,416,60,176,47,9,60,352
South Carolina,Denmark,3062,1558,523,152,78,390,2701
South Carolina,Pelzer,1407,335,563,164,36,111,1209
South Carolina,Iva,1515,306,437,171,65,182,1161
South Carolina,North Augusta,22603,4783,9849,2296,332,1251,18511
South Carolina,Walterboro,5503,1408,1420,549,240,447,4064
South Carolina,Lodge,46,4,24,4,0,10,42
South Carolina,Irwin,1303,313,295,224,50,173,1055
South Carolina,Buffalo,1655,530,549,133,53,82,1347
South Carolina,Little River,9523,1716,4311,1641,237,611,8516
South Carolina,Atlantic Beach,242,99,42,9,18,22,190
South Carolina,Lugoff,8360,1675,3160,804,231,488,6358
South Carolina,Bethune,253,50,115,22,0,36,223
South Carolina,Great Falls,1988,642,432,157,58,145,1434
South Carolina,Plum Branch,84,28,36,2,1,9,76
South Carolina,Charleston,133762,48351,46564,11376,1866,6061,114218
South Carolina,Bradley,57,5,48,4,0,0,57
South Carolina,Norway,334,137,95,21,8,23,284
South Carolina,Wilkinson Heights,1546,598,333,138,83,276,1428
South Carolina,Woodford,164,47,56,7,5,18,133
South Carolina,Saluda,3613,1210,1049,199,42,136,2636
South Carolina,Chapin,1755,418,658,152,62,101,1391
South Carolina,Mount Croghan,133,17,71,4,7,4,103
South Carolina,Kline,172,55,41,14,0,7,117
South Carolina,Arcadia,4073,1216,907,451,229,242,3045
South Carolina,Alcolu,499,112,227,24,22,23,408
South Carolina,Van Wyck,683,144,313,0,0,0,457
South Carolina,Pelion,741,130,320,79,33,34,596
South Carolina,McCormick,2654,1141,496,460,128,150,2375
South Carolina,New Ellenton,2158,626,697,250,9,159,1741
South Carolina,Jackson,1953,382,818,198,60,124,1582
South Carolina,Lowndesville,96,37,18,16,3,9,83
South Carolina,York,8062,2630,2332,859,258,409,6488
South Carolina,Smyrna,28,8,9,6,0,2,25
South Carolina,Wellford,2561,669,695,330,113,171,1978
South Carolina,Boiling Springs,9282,1901,3876,800,156,458,7191
South Carolina,South Congaree,2395,525,1027,270,35,107,1964
South Carolina,Ridgeway,358,119,131,25,0,32,307
South Carolina,Cottageville,821,167,358,86,19,47,677
South Carolina,Bluffton,18835,3967,8767,1204,293,679,14910
South Carolina,Belton,4309,831,1683,571,151,306,3542
South Carolina,Seabrook Island,1694,104,1405,71,4,87,1671
South Carolina,Goose Creek,41339,10463,16249,3414,1350,1354,32830
South Carolina,North Hartsville,2588,521,1173,207,138,151,2190
South Carolina,Patrick,355,90,112,81,12,21,316
South Carolina,Camden,7060,1595,2699,809,134,510,5747
South Carolina,Chesterfield,1512,345,563,139,37,72,1156
South Carolina,Eureka Mill,1527,612,333,69,65,154,1233
South Carolina,Hollywood,5119,749,2548,618,113,336,4364
South Carolina,Jefferson,981,257,333,76,30,50,746
South Carolina,Edgefield,4735,2151,1082,688,229,286,4436
South Carolina,Luray,173,54,44,30,2,13,143
South Carolina,Langley,1309,366,405,149,96,136,1152
South Carolina,East Gaffney,2944,833,800,494,152,105,2384
South Carolina,Clio,957,264,365,67,42,68,806
South Carolina,McColl,1981,640,575,171,131,152,1669
South Carolina,Scotia,252,61,98,19,0,19,197
South Carolina,Burton,8199,2323,2624,698,457,442,6544
South Carolina,Wedgefield,1865,435,867,122,46,31,1501
South Carolina,Powdersville,8991,2008,3997,810,152,244,7211
South Carolina,James Island,12010,2931,5179,1300,59,823,10292
South Carolina,Society Hill,669,140,230,75,0,34,479
South Carolina,Summerville,50894,12752,18949,5204,824,2201,39930
South Carolina,Bonneau Beach,1870,169,982,332,28,40,1551
South Carolina,Boykin,198,75,103,0,0,0,178
South Carolina,Catawba,1151,288,307,216,34,51,896
South Carolina,Mulberry,233,95,77,41,0,11,224
South Carolina,Clifton,576,163,177,93,0,89,522
South Carolina,Cross Anchor,172,102,0,34,0,0,136
South Carolina,Enoree,682,134,191,67,44,38,474
South Carolina,Fairforest,1644,381,456,145,128,74,1184
South Carolina,Fair Play,475,103,320,37,0,15,475
South Carolina,Fingerville,26,0,26,0,0,0,26
South Carolina,Gadsden,1873,362,886,122,84,178,1632
South Carolina,Glendale,293,97,127,44,0,20,288
South Carolina,Gramling,43,0,43,0,0,0,43
South Carolina,Graniteville,3415,967,1015,328,120,117,2547
South Carolina,Hopkins,2956,1463,722,186,193,136,2700
South Carolina,Islandton,64,7,43,0,0,5,55
South Carolina,Jacksonboro,511,192,195,60,0,36,483
South Carolina,Converse,737,246,111,90,21,59,527
South Carolina,Cane Savannah,1035,239,363,85,47,126,860
South Carolina,Bishopville,3122,1188,743,253,93,312,2589
South Carolina,Gifford,287,107,56,32,5,35,235
South Carolina,Hampton,2608,479,891,388,39,291,2088
South Carolina,Arial,2030,378,837,319,45,120,1699
South Carolina,Five Forks,18004,2658,8767,930,141,550,13046
South Carolina,Parker,12850,3529,3564,1295,626,803,9817
South Carolina,Lydia,499,132,147,181,18,0,478
South Carolina,Kingstree,3122,913,863,289,91,226,2382
South Carolina,Campobello,468,91,202,54,32,27,406
South Carolina,Duncan,3375,1025,947,347,119,130,2568
South Carolina,Greer,29717,6877,11639,2781,616,1193,23106
South Carolina,Inman,2694,504,919,332,48,296,2099
South Carolina,Roebuck,2352,571,1070,268,57,87,2053
South Carolina,Landrum,2534,534,1057,363,32,150,2136
South Carolina,Varnville,1877,604,528,204,33,167,1536
South Carolina,Mayo,1416,145,760,173,0,68,1146
South Carolina,Elgin,3610,680,1323,507,88,384,2982
South Carolina,Eastover,800,351,89,91,17,77,625
South Carolina,East Sumter,1172,370,352,105,82,53,962
South Carolina,Mayesville,523,196,153,34,3,61,447
South Carolina,Whitmire,1561,377,556,124,84,54,1195
South Carolina,Westminster,2512,703,802,360,52,92,2009
South Carolina,Columbia,133352,65454,31763,10615,3010,4884,115726
South Carolina,Tatum,79,21,38,7,5,6,77
South Carolina,Pinewood,492,137,154,27,14,21,353
South Carolina,Shiloh,211,36,97,22,0,14,169
South Carolina,Blacksburg,2008,646,499,170,63,121,1499
South Carolina,Estill,2856,607,814,358,85,361,2225
South Carolina,Reidville,869,149,403,85,10,33,680
South Carolina,Piedmont,6401,1367,2984,396,86,330,5163
South Carolina,Rockville,120,3,82,15,1,5,106
South Carolina,Pinopolis,1247,115,949,60,37,31,1192
South Carolina,Gayle Mill,1075,490,176,95,0,88,849
South Carolina,Heath Springs,640,195,158,106,19,58,536
South Carolina,Central,5241,2845,760,565,206,376,4752
South Carolina,Holly Hill,1359,475,391,91,82,112,1151
South Carolina,Neeses,281,81,113,18,12,21,245
South Carolina,Woodruff,4164,1038,1409,392,266,250,3355
South Carolina,North,664,185,193,64,24,90,556
South Carolina,Vance,92,22,16,8,15,21,82
South Carolina,Rowesville,267,71,89,28,3,29,220
South Carolina,Ridgeland,3948,1160,997,466,105,218,2946
South Carolina,Furman,250,67,94,31,3,34,229
South Carolina,Lyman,3481,465,1617,430,22,238,2772
South Carolina,Turbeville,1002,248,307,64,33,98,750
South Carolina,Troy,102,18,68,3,0,5,94
South Carolina,Springdale,2733,679,1012,355,44,215,2305
South Carolina,West Columbia,17296,5683,5390,1838,400,1624,14935
South Carolina,Beaufort,13336,3337,4652,1427,307,740,10463
South Carolina,Elko,182,72,42,26,3,21,164
South Carolina,Red Bank,9623,2030,3981,1118,259,333,7721
South Carolina,Cayce,13621,5149,4092,1225,297,739,11502
South Carolina,Joanna,1329,417,524,127,45,82,1195
South Carolina,Rock Hill,71903,23838,22420,6498,1722,3598,58076
South Carolina,Gilbert,733,141,339,35,23,24,562
South Carolina,Greenwood,23230,8803,5364,2259,712,1492,18630
South Carolina,Jamestown,71,27,27,12,5,0,71
South Carolina,Swansea,880,254,258,99,26,66,703
South Carolina,Lowrys,245,59,105,20,5,11,200
South Carolina,Springfield,539,149,199,33,8,60,449
South Carolina,Orangeburg,13120,5970,2775,896,284,782,10707
South Carolina,Eutawville,249,47,126,27,3,34,237
South Carolina,Edisto,2290,680,458,259,105,195,1697
South Carolina,Fairfax,2093,742,617,118,51,189,1717
South Carolina,Ninety Six,1839,323,692,204,15,146,1380
South Carolina,Newry,140,0,102,0,27,11,140
South Carolina,Jenkinsville,73,21,18,4,0,16,59
South Carolina,Chesnee,664,191,255,73,46,54,619
South Carolina,Stateburg,1611,286,772,176,7,25,1266
South Carolina,Fountain Inn,8684,1910,3700,511,86,301,6508
South Carolina,Aynor,721,153,301,99,10,44,607
South Carolina,Salley,245,48,98,19,9,27,201
South Carolina,Jonesville,678,172,211,70,40,85,578
South Carolina,Judson,1777,716,331,242,94,58,1441
South Carolina,Garden City,10070,1730,4618,1288,183,1404,9223
South Carolina,Harleyville,802,235,261,59,29,30,614
South Carolina,Honea Path,3687,922,1401,212,65,299,2899
South Carolina,Calhoun Falls,1924,670,542,183,50,155,1600
South Carolina,Utica,1501,288,359,220,139,84,1090
South Carolina,Bowman,705,257,184,104,28,52,625
South Carolina,Greenville,65727,22566,21279,6441,1629,2696,54611
South Carolina,Rembert,229,48,105,20,21,21,215
South Carolina,Lamar,983,229,331,82,50,94,786
South Carolina,Cheraw,5701,1975,1583,462,133,412,4565
South Carolina,Promised Land,432,106,51,55,59,161,432
South Carolina,Pickens,3153,869,1000,333,82,258,2542
South Carolina,Riverview,833,55,545,28,0,46,674
South Carolina,Union,7878,2329,2160,952,217,585,6243
South Carolina,Andrews,2981,907,892,331,53,161,2344
South Carolina,Barnwell,4502,1421,1249,303,109,337,3419
South Carolina,Snelling,267,83,123,16,0,13,235
South Carolina,Mount Carmel,255,71,134,38,0,7,250
South Carolina,Williston,2995,968,698,186,130,222,2204
South Carolina,Moncks Corner,10169,2489,3989,856,313,423,8070
South Carolina,Edisto Beach,574,44,463,27,4,30,568
South Carolina,Abbeville,5079,1625,1065,491,305,546,4032
South Carolina,Little Mountain,225,14,101,19,1,23,158
South Carolina,Lynchburg,361,144,88,21,5,35,293
South Carolina,St. Stephen,1787,501,511,127,95,144,1378
South Carolina,Modoc,202,17,161,11,4,0,193
South Carolina,Six Mile,872,159,399,63,12,43,676
South Carolina,Easley,20784,4565,7936,2300,494,1872,17167
South Carolina,City View,1448,636,301,269,0,49,1255
South Carolina,Taylors,21923,5120,8951,2201,501,1202,17975
South Carolina,Welcome,7394,2083,2567,727,245,319,5941
South Carolina,Branchville,1132,382,249,105,56,77,869
South Carolina,Cowpens,1782,471,555,188,59,192,1465
South Carolina,Pacolet,2456,601,781,327,80,174,1963
South Carolina,Watts Mills,1384,463,380,154,73,54,1124
South Carolina,Simpsonville,21423,4551,9092,2127,381,813,16964
South Carolina,Walhalla,4293,829,1561,559,237,357,3543
South Carolina,Paxville,474,140,209,24,14,25,412
South Carolina,Summerton,997,415,289,46,16,85,851
South Carolina,McClellanville,545,73,248,75,2,49,447
South Carolina,Central Pacolet,138,19,64,23,1,14,121
South Carolina,Inman Mills,1306,173,472,124,0,167,936
South Carolina,Saxon,3710,1385,553,429,187,215,2769
South Carolina,Stuckey,215,66,82,13,2,18,181
South Carolina,Cross Hill,572,188,194,51,16,22,471
South Carolina,Mauldin,25009,7194,9588,2488,342,1004,20616
South Carolina,Forestbrook,5682,1290,2598,605,121,160,4774
South Carolina,Kiawah Island,1525,50,1283,107,18,62,1520
South Carolina,North Charleston,109886,38117,30218,9497,3447,4576,85855
South Carolina,Ravenel,2655,771,1048,164,84,187,2254
South Carolina,Ridgeville,2135,1016,505,313,54,79,1967
South Carolina,Anderson,27129,8049,7839,2998,688,2453,22027
South Carolina,Centerville,7303,1197,3428,672,144,467,5908
South Carolina,North Myrtle Beach,15862,2616,8504,1864,303,1217,14504
South Carolina,Northlake,3793,606,2237,302,50,143,3338
South Carolina,Bamberg,3317,1286,898,157,158,250,2749
South Carolina,Olar,183,33,82,22,11,18,166
South Carolina,Laurel Bay,6470,1013,2885,363,113,62,4436
South Carolina,Port Royal,12446,5068,3901,916,318,237,10440
South Carolina,Trenton,316,95,140,12,9,19,275
South Carolina,Briarcliffe Acres,547,60,302,30,27,49,468
South Carolina,Williams,164,34,67,6,8,8,123
South Carolina,Sullivan's Island,2148,537,1047,131,3,100,1818
South Carolina,Wagener,889,331,240,94,8,44,717
South Carolina,Georgetown,8936,2735,2498,771,238,613,6855
South Carolina,Norris,856,160,284,92,38,67,641
South Carolina,Cordova,240,79,74,9,3,6,171
South Carolina,Greeleyville,398,115,167,21,16,27,346
South Carolina,Hemingway,562,170,194,37,16,50,467
South Carolina,Southern Shops,3667,1079,806,389,113,139,2526
South Carolina,West Union,313,88,79,31,2,38,238
South Carolina,Travelers Rest,5063,1368,1808,390,42,374,3982
South Carolina,Dentsville,14887,5557,3402,1588,420,867,11834
South Carolina,Peak,51,19,21,4,0,4,48
South Carolina,Dalzell,3795,954,1328,172,44,203,2701
South Carolina,Privateer,1939,429,807,159,140,211,1746
South Carolina,Sans Souci,8776,2523,2591,1013,351,301,6779
South Carolina,Sumter,39964,11599,12675,3225,1209,2484,31192
South Carolina,Latta,1377,394,339,145,68,140,1086
South Carolina,Lake Murray of Richland,6427,893,3449,617,117,312,5388
South Carolina,Lake Wylie,12569,1729,5997,1008,243,484,9461
South Carolina,Santee,1003,356,249,84,83,110,882
South Carolina,Reevesville,260,96,96,10,11,8,221
South Carolina,Elgin,1705,255,748,137,3,44,1187
South Carolina,Red Hill,15459,4720,5980,1292,415,700,13107
South Carolina,Monarch Mill,1416,214,738,204,17,81,1254
South Carolina,Lake City,6658,2360,1348,606,286,495,5095
South Carolina,Scranton,786,280,200,54,30,123,687
South Carolina,Loris,2625,798,806,241,140,225,2210
South Carolina,Coronaca,146,29,60,10,0,0,99
South Carolina,Batesburg-Leesville,5424,1450,1884,623,73,301,4331
South Carolina,Florence,37802,10844,13042,2892,1027,2267,30072
South Carolina,Olanta,561,106,196,47,20,53,422
South Carolina,Conway,22661,8733,6666,1913,556,1422,19290
South Carolina,Myrtle Beach,31783,8866,11296,3944,775,2024,26905
South Carolina,Surfside Beach,4312,793,1888,728,133,317,3859
South Carolina,Meggett,1211,127,729,88,23,77,1044
South Carolina,Winnsboro Mills,1944,698,580,315,23,140,1756
South Carolina,Perry,197,80,35,21,8,10,154
South Carolina,St. George,2581,1022,596,235,128,157,2138
South Carolina,Chester,5433,2021,1410,322,188,396,4337
South Carolina,Sharon,480,116,187,40,19,20,382
South Carolina,Allendale,3072,1181,491,162,154,411,2399
South Carolina,Sycamore,144,20,59,24,5,25,133
South Carolina,Ulmer,37,13,16,2,0,6,37
South Carolina,Hilda,448,131,186,41,4,26,388
South Carolina,Bonneau,668,102,267,41,17,30,457
South Carolina,Richburg,405,153,94,7,21,26,301
South Carolina,Darlington,6034,1883,1600,625,217,697,5022
South Carolina,Awendaw,1308,276,471,166,43,101,1057
South Carolina,Cokesbury,306,42,142,16,0,18,218
South Carolina,Summit,568,105,228,45,34,8,420
South Carolina,Homeland Park,6157,1508,1748,937,291,623,5107
South Carolina,Valley Falls,6522,3272,1711,571,96,340,5990
South Carolina,Princeton,33,15,18,0,0,0,33
South Carolina,Aiken,30464,8023,12803,2719,621,2081,26247
South Carolina,Fort Mill,15924,3438,6606,1240,128,550,11962
South Carolina,Arcadia Lakes,741,136,427,59,8,62,692
South Carolina,St. Andrews,21494,8767,4554,2559,654,837,17371
South Carolina,Prosperity,1281,367,485,86,22,42,1002
South Carolina,Clearwater,4319,1164,1259,423,18,249,3113
South Carolina,Silverstreet,146,18,67,20,0,24,129
South Carolina,Lake Secession,1050,198,544,133,125,26,1026
South Carolina,Clinton,8508,3164,2046,869,222,899,7200
South Carolina,Lancaster,9150,2852,2290,886,212,697,6937
South Carolina,Sellers,200,91,24,35,21,22,193
South Carolina,Hodges,101,14,52,10,5,1,82
South Carolina,Lockhart,440,115,85,63,7,65,335
South Carolina,Ward,139,25,81,12,8,4,130
South Carolina,Folly Beach,2647,781,1259,271,0,230,2541
South Carolina,Bucksport,792,199,195,119,42,95,650
South Carolina,Quinby,1233,368,564,55,0,91,1078
South Carolina,Coward,711,124,190,135,50,49,548
South Carolina,Pawleys Island,89,5,65,11,1,7,89
South Carolina,Winnsboro,3280,1147,1153,178,57,162,2697
South Carolina,Ehrhardt,445,141,135,44,27,49,396
South Carolina,Williamston,4130,874,1725,454,104,277,3434
South Carolina,Lincolnville,1280,389,395,146,27,50,1007
South Carolina,Antreville,101,4,51,19,0,26,100
South Carolina,Pageland,2684,734,764,261,98,215,2072
South Carolina,Ruby,442,50,223,49,0,29,351
South Carolina,Manning,3984,1408,986,291,76,363,3124
South Carolina,Kershaw,2021,557,675,150,91,122,1595
South Carolina,Due West,1361,740,337,35,14,70,1196
South Carolina,Mountville,127,37,45,16,12,0,110
South Carolina,Oakland,1140,216,322,107,62,190,897
South Carolina,Lake View,838,265,272,96,16,73,722
South Carolina,Slater-Marietta,2009,507,753,171,64,82,1577
South Carolina,Brookdale,4588,2001,826,257,243,330,3657
South Carolina,Livingston,127,21,41,6,2,8,78
South Carolina,West Pelzer,821,146,220,131,38,86,621
South Carolina,Hilton Head Island,39820,7521,21066,3146,715,2583,35031
South Carolina,Pamplico,1091,308,345,30,56,97,836
South Carolina,McConnells,263,43,122,23,1,9,198
South Carolina,India Hook,4275,540,2267,499,45,103,3454
South Carolina,Hickory Grove,516,114,224,48,4,23,413
South Carolina,Donalds,277,66,89,39,14,35,243
South Carolina,Willington,64,64,0,0,0,0,64
South Carolina,Parksville,218,24,71,35,3,7,140
South Carolina,Johnston,2221,672,688,252,96,114,1822
South Carolina,Warrenville,1004,230,355,152,14,111,862
South Carolina,Ware Place,170,55,65,14,26,0,160
South Carolina,Wallace,695,131,298,58,0,70,557
South Carolina,Tigerville,2016,1895,70,20,0,0,1985
South Carolina,Sangaree,7760,1805,3074,1080,215,205,6379
South Carolina,Russellville,197,40,58,33,48,18,197
South Carolina,Golden Grove,3335,896,1364,306,0,185,2751
South Carolina,Dunean,3605,1132,1312,313,100,256,3113
South Carolina,Gantt,15178,4514,4257,1390,522,926,11609
South Carolina,Brunson,471,136,158,64,8,40,406
South Carolina,Clemson,15966,8636,4045,811,141,433,14066
South Carolina,Berea,14923,3686,4994,1629,665,1015,11989
South Carolina,Wade Hampton,20925,4826,8512,2592,283,1402,17615
South Carolina,Mullins,4429,1594,931,453,284,332,3594
South Carolina,Gray Court,787,249,232,126,29,49,685
South Carolina,Cope,49,17,27,0,0,5,49
South Carolina,Laurens,8914,2471,2778,846,232,806,7133
South Carolina,Ware Shoals,2547,698,855,268,88,126,2035
South Carolina,Nichols,262,81,89,22,6,37,235
South Carolina,Elloree,637,253,204,56,14,47,574
South Carolina,Oswego,223,16,161,0,0,33,210
South Carolina,South Sumter,2294,880,412,191,139,171,1793
South Carolina,Seneca,8290,1951,3126,803,212,758,6850
South Carolina,Blythewood,3148,805,1413,247,55,4,2524
South Carolina,Forest Acres,10433,2980,3995,845,63,672,8555
South Carolina,Irmo,12087,2813,5227,1115,155,538,9848
South Carolina,Gaffney,12526,4208,3276,1091,582,934,10091
South Carolina,Dillon,6456,2008,1935,350,249,448,4990
South Carolina,Hardeeville,5836,1287,3059,386,118,248,5098
South Carolina,Yemassee,985,200,313,132,23,100,768
South Carolina,Marion,6548,2159,2000,323,252,369,5103
South Carolina,Ridge Spring,678,269,216,72,5,48,610
South Carolina,Gloverville,2788,715,851,375,157,194,2292
South Carolina,Pendleton,3158,966,962,309,123,281,2641
South Carolina,Starr,141,35,43,27,4,14,123
South Carolina,Monetta,209,75,50,14,2,30,171
South Carolina,Spartanburg,37370,13288,9579,3747,1509,2186,30309
South Carolina,Startex,1437,186,619,121,35,32,993
South Carolina,Belvedere,4925,1050,1825,665,96,368,4004
South Carolina,Springdale,2355,481,815,128,63,334,1821
South Carolina,Waterloo,148,59,40,12,2,17,130
South Carolina,Gaston,1621,325,625,190,48,50,1238
South Carolina,Lexington,21040,5023,8032,1978,513,927,16473
South Carolina,Blackville,2027,749,340,142,77,216,1524
South Carolina,Newberry,10289,3999,2297,768,683,668,8415
South Carolina,Liberty,3185,678,1126,423,159,176,2562
South Carolina,Timmonsville,2321,896,617,206,89,181,1989
South Carolina,Johnsonville,1596,426,626,111,55,87,1305
South Carolina,Murrells Inlet,9396,1639,4720,1132,71,763,8325
South Carolina,Murphys Estates,1696,474,492,170,29,101,1266
South Carolina,St. Matthews,2410,762,715,178,77,255,1987
South Carolina,Shell Point,2694,819,896,259,57,184,2215
South Carolina,Burnettown,2718,662,899,244,116,88,2009
South Carolina,Carlisle,455,192,97,42,28,38,397
South Carolina,Seven Oaks,15559,4433,5699,1566,344,762,12804
South Carolina,Pine Ridge,2171,473,1062,144,93,114,1886
South Carolina,Govan,74,9,29,10,0,10,58
South Carolina,Mount Pleasant,83700,16627,40518,6092,1099,3265,67601
South Carolina,Windsor,117,24,74,6,0,9,113
South Carolina,Cherryvale,3202,1072,724,139,178,122,2235
South Carolina,Lakewood,2644,531,1114,393,48,161,2247
South Carolina,Bennettsville,8308,2985,2111,680,195,670,6641
South Carolina,Blenheim,231,63,98,19,0,13,193
South Carolina,Pomaria,145,44,47,6,21,8,126
South Carolina,Salem,95,15,45,6,0,7,73
South Carolina,Woodfield,9730,2818,2747,1000,311,466,7342
South Carolina,Oak Grove,10993,3080,4153,978,236,675,9122
South Carolina,Tega Cay,9954,1295,5468,352,141,256,7512
South Carolina,Hanahan,22963,5741,8947,2112,561,666,18027
South Carolina,Newport,4194,756,2224,240,45,153,3418
South Carolina,Socastee,24056,6408,8233,2485,847,1582,19555
South Carolina,Isle of Palms,4345,739,2630,257,40,150,3816
South Carolina,Hartsville,7658,2596,1971,613,261,515,5956
South Carolina,McBee,1002,206,317,96,25,62,706
South Carolina,Ladson,15383,4236,5089,1578,502,689,12094
South Carolina,Fort Lawn,1012,315,319,88,19,59,800
South Dakota,Cow Creek,39,3,24,8,0,0,35
South Dakota,Corn Creek,122,61,18,14,0,7,100
South Dakota,Chester,331,56,170,27,0,14,267
South Dakota,Bath,220,41,116,14,0,8,179
South Dakota,Fruitdale,88,8,45,3,2,8,66
South Dakota,Peever,169,52,40,11,1,7,111
South Dakota,Ortley,47,13,18,6,0,5,42
South Dakota,Fedora,23,5,6,0,0,12,23
South Dakota,Crocker,27,0,27,0,0,0,27
South Dakota,Bijou Hills,0,0,0,0,0,0,0
South Dakota,Bath Corner,74,26,48,0,0,0,74
South Dakota,Blucksberg Mountain,492,62,398,0,0,0,460
South Dakota,Iroquois,369,64,152,50,1,20,287
South Dakota,Harrison,118,18,69,3,0,3,93
South Dakota,Mitchell,15722,3764,6295,1454,388,965,12866
South Dakota,Marty,484,220,24,34,0,27,305
South Dakota,Buffalo,337,85,134,41,2,25,287
South Dakota,La Plant,198,87,32,16,12,9,156
South Dakota,Kranzburg,219,48,120,5,0,7,180
South Dakota,Manderson-White Horse Creek,393,242,11,38,0,11,302
South Dakota,Pringle,156,46,54,29,0,3,132
South Dakota,Fairview,49,18,27,0,2,0,47
South Dakota,Woonsocket,653,98,257,94,2,64,515
South Dakota,Agency Village,305,106,33,53,0,0,192
South Dakota,Brant Lake South,187,27,126,12,0,4,169
South Dakota,Brant Lake,71,18,41,3,0,0,62
South Dakota,Platte,1501,198,731,117,8,149,1203
South Dakota,Rockham,30,3,13,4,0,0,20
South Dakota,Watertown,22124,5093,9133,1855,221,1284,17586
South Dakota,Piedmont,1030,132,464,100,14,44,754
South Dakota,Worthing,1025,182,430,103,6,20,741
South Dakota,Summerset,2412,436,1133,124,8,62,1763
South Dakota,Dakota Dunes,3067,671,1368,250,0,120,2409
South Dakota,Buffalo Chip,0,0,0,0,0,0,0
South Dakota,Anderson,450,78,219,20,5,13,335
South Dakota,Crooks,1363,172,710,43,0,27,952
South Dakota,Cavour,132,27,56,8,0,2,93
South Dakota,White,580,88,274,35,3,17,417
South Dakota,Sioux Falls,174151,46774,66125,15028,2025,7082,137034
South Dakota,Springfield,2045,953,407,361,82,70,1873
South Dakota,Hitchcock,130,28,81,6,0,9,124
South Dakota,Dimock,174,12,82,17,0,3,114
South Dakota,Bowdle,459,35,192,44,0,42,313
South Dakota,Eden,115,21,66,6,3,5,101
South Dakota,Ree Heights,76,14,40,10,0,2,66
South Dakota,Willow Lake,363,43,144,9,3,38,237
South Dakota,Lennox,2437,560,839,233,23,193,1848
South Dakota,Broadland,27,8,10,2,0,0,20
South Dakota,Wakonda,265,41,117,35,4,19,216
South Dakota,Doland,243,52,109,15,1,11,188
South Dakota,Sinai,91,30,32,8,1,9,80
South Dakota,Canistota,680,228,210,26,9,50,523
South Dakota,Wanblee,940,368,119,101,0,11,599
South Dakota,Kadoka,773,222,222,71,24,91,630
South Dakota,Delmont,242,43,125,13,0,16,197
South Dakota,Hoven,341,42,191,14,0,50,297
South Dakota,Quinn,44,5,30,0,0,0,35
South Dakota,Vivian,115,34,59,11,0,5,109
South Dakota,Lemmon,1265,281,563,128,4,121,1097
South Dakota,Frederick,196,28,99,30,1,15,173
South Dakota,Herreid,404,78,216,12,0,50,356
South Dakota,Rosholt,537,122,238,41,3,39,443
South Dakota,Conde,123,18,49,19,1,29,116
South Dakota,Box Elder,9407,2481,3882,536,65,217,7181
South Dakota,Hartford,3145,523,1252,335,15,92,2217
South Dakota,Groton,1712,364,702,146,4,95,1311
South Dakota,Warner,413,53,217,28,0,9,307
South Dakota,Westport,105,21,55,3,0,5,84
South Dakota,Lane,78,31,24,9,0,3,67
South Dakota,South Shore,208,61,62,45,0,15,183
South Dakota,Tea,5098,855,2149,277,83,74,3438
South Dakota,Wounded Knee,456,199,20,35,0,13,267
South Dakota,Altamont,33,10,6,7,0,2,25
South Dakota,Toronto,231,42,99,18,2,13,174
South Dakota,Sherman,60,8,30,8,0,2,48
South Dakota,Eagle Butte,1134,386,180,126,9,48,749
South Dakota,Irene,499,105,183,43,3,47,381
South Dakota,Bristol,370,81,158,49,8,43,339
South Dakota,Butler,9,2,7,0,0,0,9
South Dakota,Fairfax,137,18,77,9,5,10,119
South Dakota,Dante,104,24,41,1,0,2,68
South Dakota,Pickstown,225,36,115,14,2,15,182
South Dakota,Reliance,147,28,81,6,0,10,125
South Dakota,Hosmer,275,70,118,6,0,21,215
South Dakota,Ipswich,955,278,334,89,1,81,783
South Dakota,Martin,970,255,289,91,8,79,722
South Dakota,Emery,550,143,195,46,0,22,406
South Dakota,Colton,743,144,322,67,19,36,588
South Dakota,Hillsview,0,0,0,0,0,0,0
South Dakota,Belle Fourche,5610,1137,2113,941,56,348,4595
South Dakota,New Underwood,731,226,222,89,14,49,600
South Dakota,New Effington,219,59,72,40,0,18,189
South Dakota,Wilmot,536,112,280,27,7,47,473
South Dakota,Salem,1393,191,688,113,5,77,1074
South Dakota,Gettysburg,1258,329,495,96,10,77,1007
South Dakota,Lebanon,23,4,11,5,0,1,21
South Dakota,Beresford,2235,419,1079,191,6,118,1813
South Dakota,Antelope,978,344,109,98,13,36,600
South Dakota,Chancellor,298,48,127,30,6,23,234
South Dakota,Ethan,397,81,170,22,6,19,298
South Dakota,Whitewood,1051,234,437,95,2,77,845
South Dakota,Rapid City,73721,19734,27011,8000,643,3699,59087
South Dakota,Lower Brule,785,283,139,50,16,39,527
South Dakota,Alcester,880,168,347,93,26,86,720
South Dakota,Mission,1231,399,197,84,5,42,727
South Dakota,Glenham,113,37,53,2,0,3,95
South Dakota,Carthage,178,25,77,12,1,31,146
South Dakota,Howard,841,157,384,74,5,64,684
South Dakota,Farmer,1,0,0,0,0,1,1
South Dakota,Mobridge,3422,872,1262,382,11,298,2825
South Dakota,Tulare,258,49,108,15,4,13,189
South Dakota,Wood,37,4,11,15,2,5,37
South Dakota,Two Strike,182,75,33,21,0,0,129
South Dakota,Midland,130,9,65,13,0,15,102
South Dakota,Ward,58,19,19,8,0,7,53
South Dakota,Flandreau,2438,489,867,258,45,170,1829
South Dakota,Alpena,313,49,142,46,1,16,254
South Dakota,New Witten,54,15,24,3,0,5,47
South Dakota,Porcupine,1517,604,155,118,12,36,925
South Dakota,Armour,828,127,462,23,3,56,671
South Dakota,Oelrichs,100,15,47,12,0,14,88
South Dakota,Nisland,340,52,169,50,0,2,273
South Dakota,Camp Crook,58,4,31,10,0,11,56
South Dakota,Dallas,70,15,45,3,2,4,69
South Dakota,Timber Lake,579,161,201,46,5,30,443
South Dakota,Fairburn,96,6,65,3,0,14,88
South Dakota,Stockholm,131,35,43,15,0,6,99
South Dakota,Little Eagle,278,119,27,11,7,11,175
South Dakota,Lesterville,118,28,63,12,3,8,114
South Dakota,Parkston,1649,304,702,116,7,132,1261
South Dakota,Menno,713,117,329,71,2,78,597
South Dakota,Newell,804,168,335,73,39,59,674
South Dakota,Valley Springs,757,145,324,82,5,31,587
South Dakota,Milbank,3210,739,1413,298,9,208,2667
South Dakota,Tolstoy,30,2,15,9,0,4,30
South Dakota,Britton,1792,328,621,184,1,138,1272
South Dakota,Veblen,570,128,147,40,18,17,350
South Dakota,Lowry,7,0,7,0,0,0,7
South Dakota,Fort Thompson,1260,510,195,93,17,22,837
South Dakota,Tyndall,1167,288,376,156,12,123,955
South Dakota,Highmore,798,140,413,58,2,60,673
South Dakota,Okaton,6,0,6,0,0,0,6
South Dakota,Lead,2998,466,1431,466,18,125,2506
South Dakota,Estelline,854,133,346,82,1,79,641
South Dakota,Belvidere,99,27,31,5,0,14,77
South Dakota,Canova,85,17,34,9,0,13,73
South Dakota,Lake City,61,9,29,14,0,4,56
South Dakota,Claremont,63,9,24,7,0,16,56
South Dakota,Fulton,132,34,32,16,9,12,103
South Dakota,Naples,18,1,10,0,0,1,12
South Dakota,Herrick,113,9,71,0,0,5,85
South Dakota,Burke,605,98,305,47,8,52,510
South Dakota,Twin Brooks,44,8,28,2,0,1,39
South Dakota,La Bolt,94,33,44,4,0,5,86
South Dakota,Whitehorse,178,40,55,6,2,3,106
South Dakota,Webster,1730,396,716,197,20,155,1484
South Dakota,Custer,2113,324,1067,326,13,158,1888
South Dakota,Verdon,3,0,3,0,0,0,3
South Dakota,White Rock,4,0,0,4,0,0,4
South Dakota,Andover,110,14,49,28,5,2,98
South Dakota,Wasta,133,27,64,11,3,7,112
South Dakota,Faith,360,43,157,33,3,25,261
South Dakota,Oglala,1548,773,199,117,0,45,1134
South Dakota,Kyle,966,362,117,83,0,23,585
South Dakota,McLaughlin,482,138,130,39,14,21,342
South Dakota,Bradley,75,9,34,9,6,0,58
South Dakota,Strandburg,70,12,19,15,1,2,49
South Dakota,Albee,4,0,3,1,0,0,4
South Dakota,Isabel,168,54,42,19,0,7,122
South Dakota,Waubay,498,74,171,64,19,51,379
South Dakota,Roslyn,251,27,131,36,0,23,217
South Dakota,Pierpont,154,13,88,20,0,2,123
South Dakota,Dupree,535,206,109,61,8,25,409
South Dakota,Clear Lake,1319,267,648,92,3,101,1111
South Dakota,Langford,418,126,156,47,0,23,352
South Dakota,Colome,370,66,160,7,4,19,256
South Dakota,Pine Ridge,3711,1669,480,292,85,123,2649
South Dakota,Harrisburg,5760,1016,2258,397,88,73,3832
South Dakota,Brookings,23863,11471,7040,1058,83,811,20463
South Dakota,Elkton,727,113,296,55,13,35,512
South Dakota,Utica,97,9,49,5,3,1,67
South Dakota,Olivet,71,15,26,8,1,3,53
South Dakota,Tripp,676,152,285,49,0,82,568
South Dakota,Chamberlain,2486,615,945,255,16,170,2001
South Dakota,Trent,274,68,142,45,0,3,258
South Dakota,Gayville,384,84,153,41,5,38,321
South Dakota,Tabor,477,62,253,28,0,19,362
South Dakota,Pukwana,271,69,116,29,0,14,228
South Dakota,Blackhawk,3148,687,1510,298,0,115,2610
South Dakota,Hudson,349,75,139,53,3,24,294
South Dakota,Wallace,109,20,43,0,0,2,65
South Dakota,Canton,3392,878,1325,339,79,158,2779
South Dakota,Central City,131,40,33,42,0,4,119
South Dakota,Philip,840,149,415,50,9,118,741
South Dakota,Miller,1433,258,659,145,0,152,1214
South Dakota,Freeman,1408,254,590,93,7,139,1083
South Dakota,Ramona,200,36,91,27,0,14,168
South Dakota,Brentford,69,13,19,5,3,5,45
South Dakota,Oacoma,418,103,179,35,0,17,334
South Dakota,Presho,507,71,275,51,0,23,420
South Dakota,Hetland,11,5,0,6,0,0,11
South Dakota,Jefferson,616,103,282,75,3,24,487
South Dakota,Lake Norden,436,118,182,24,6,40,370
South Dakota,Parmelee,619,289,92,15,13,27,436
South Dakota,Baltic,1069,209,511,58,0,18,796
South Dakota,Aurora Center,79,4,31,5,0,0,40
South Dakota,Long Lake,37,1,29,0,0,0,30
South Dakota,Marion,799,125,370,69,3,101,668
South Dakota,Kennebec,352,69,149,19,16,23,276
South Dakota,Plankinton,660,123,311,56,3,48,541
South Dakota,Java,152,28,62,5,0,17,112
South Dakota,Aurora,736,111,309,58,0,29,507
South Dakota,Castlewood,661,95,334,37,14,11,491
South Dakota,Badger,81,17,34,19,0,6,76
South Dakota,Sisseton,2486,780,540,375,43,226,1964
South Dakota,Clark,1448,239,582,179,4,149,1153
South Dakota,White Lake,459,87,189,14,4,56,350
South Dakota,Leola,433,47,189,41,0,22,299
South Dakota,Viborg,868,215,309,89,18,97,728
South Dakota,Alexandria,743,228,264,53,3,31,579
South Dakota,Cottonwood,6,0,0,4,0,2,6
South Dakota,Eureka,979,190,428,84,20,163,885
South Dakota,Centerville,905,148,350,109,7,82,696
South Dakota,Monroe,166,50,53,18,1,7,129
South Dakota,Stickney,318,22,153,31,0,19,225
South Dakota,Cresbard,90,20,47,7,0,9,83
South Dakota,Onaka,6,2,0,2,2,0,6
South Dakota,Orient,56,20,31,2,0,3,56
South Dakota,Wetonka,12,5,7,0,0,0,12
South Dakota,Columbia,123,11,61,15,0,11,98
South Dakota,Dell Rapids,3669,582,1747,296,14,169,2808
South Dakota,Brandon,9867,1687,4540,574,24,368,7193
South Dakota,Renner Corner,357,67,199,55,8,9,338
South Dakota,Richland,124,0,23,53,0,0,76
South Dakota,Running Water,31,17,14,0,0,0,31
South Dakota,Shindler,825,217,383,51,0,16,667
South Dakota,Soldier Creek,269,141,0,33,0,16,190
South Dakota,Vale,101,24,54,14,0,9,101
South Dakota,St. Onge,122,0,122,0,0,0,122
South Dakota,Waverly,47,42,0,0,0,5,47
South Dakota,Caputa,0,0,0,0,0,0,0
South Dakota,Roswell,2,0,2,0,0,0,2
South Dakota,Kimball,572,136,220,73,6,40,475
South Dakota,Deadwood,1463,441,542,263,19,84,1349
South Dakota,Ravinia,88,26,25,2,0,0,53
South Dakota,Morristown,42,9,14,0,3,5,31
South Dakota,Winfred,88,4,45,30,0,0,79
South Dakota,Henry,316,80,113,28,5,24,250
South Dakota,Prairie City,5,0,4,0,0,0,4
South Dakota,Ola,0,0,0,0,0,0,0
South Dakota,Ferney,60,0,0,0,0,60,60
South Dakota,Forestburg,119,62,57,0,0,0,119
South Dakota,Gann Valley,16,12,4,0,0,0,16
South Dakota,Goodwill,934,333,68,83,20,29,533
South Dakota,Johnson Siding,542,41,360,80,0,28,509
South Dakota,Kidder,0,0,0,0,0,0,0
South Dakota,Pine Lakes Addition,313,40,207,4,5,0,256
South Dakota,Lake Madison,905,85,667,64,0,42,858
South Dakota,Long Hollow,198,71,20,17,0,0,108
South Dakota,Mansfield,141,33,75,8,0,0,116
South Dakota,Meadow View Addition,515,153,208,85,0,15,461
South Dakota,Morningside,167,34,111,0,0,0,145
South Dakota,Norris,232,70,45,2,9,3,129
South Dakota,Okreek,304,97,50,22,0,0,169
South Dakota,Lake Poinsett,468,32,344,9,0,9,394
South Dakota,Harrold,81,17,40,11,2,6,76
South Dakota,Astoria,156,29,71,15,0,8,123
South Dakota,Buffalo Gap,88,8,39,16,3,20,86
South Dakota,Winner,2839,809,1186,250,7,209,2461
South Dakota,Raymond,47,11,25,6,0,5,47
South Dakota,Geddes,262,33,89,27,5,28,182
South Dakota,Vermillion,10700,5465,2966,441,75,251,9198
South Dakota,Colman,639,126,284,71,2,11,494
South Dakota,Bullhead,362,144,49,23,0,14,230
South Dakota,Batesland,72,21,23,4,2,2,52
South Dakota,Wessington Springs,844,125,429,59,8,109,730
South Dakota,Artesian,255,39,113,16,0,6,174
South Dakota,Artas,29,12,8,3,0,6,29
South Dakota,Draper,77,17,44,4,0,1,66
South Dakota,Spearfish,11393,3606,4199,1103,69,809,9786
South Dakota,Keystone,435,144,135,58,0,11,348
South Dakota,Huron,13291,3087,4970,1202,100,768,10127
South Dakota,Sturgis,6772,1297,2993,570,0,487,5347
South Dakota,Brandt,107,28,45,7,0,2,82
South Dakota,Florence,376,39,183,10,2,23,257
South Dakota,Aberdeen,28124,7987,10382,2664,173,1502,22708
South Dakota,Hermosa,417,93,202,23,7,16,341
South Dakota,Green Grass,15,6,0,0,0,4,10
South Dakota,North Eagle Butte,2191,670,366,251,24,92,1403
South Dakota,Big Stone City,597,132,269,61,0,41,503
South Dakota,Bonesteel,441,83,186,18,2,30,319
South Dakota,St. Charles,4,0,4,0,0,0,4
South Dakota,Davis,70,23,27,7,7,2,66
South Dakota,Vienna,86,4,16,7,0,0,27
South Dakota,St. Lawrence,202,32,111,8,0,6,157
South Dakota,Kaylor,28,0,28,0,0,0,28
South Dakota,Yankton,14577,3765,5799,1394,114,882,11954
South Dakota,Pollock,189,18,110,26,6,17,177
South Dakota,Faulkton,919,116,348,93,3,114,674
South Dakota,Spencer,147,14,99,1,0,5,119
South Dakota,Lake Andes,871,283,179,77,12,76,627
South Dakota,Dolton,54,14,14,9,0,0,37
South Dakota,Milltown,23,0,23,0,0,0,23
South Dakota,Storla,32,14,0,5,0,0,19
South Dakota,McIntosh,191,48,61,16,0,14,139
South Dakota,Hazel,113,9,49,12,0,2,72
South Dakota,Arlington,1048,217,432,78,11,101,839
South Dakota,Bancroft,20,5,7,0,0,2,14
South Dakota,Onida,601,98,264,60,0,29,451
South Dakota,Northville,130,21,58,7,0,1,87
South Dakota,Turton,59,0,31,4,0,0,35
South Dakota,Mount Vernon,547,111,232,33,0,12,388
South Dakota,Bushnell,92,29,29,19,1,2,80
South Dakota,Avon,654,126,278,19,4,51,478
South Dakota,Scotland,710,152,301,83,13,92,641
South Dakota,North Spearfish,2339,449,1197,139,0,52,1837
South Dakota,Ashland Heights,796,128,68,309,39,79,623
South Dakota,Claire City,78,14,46,1,0,5,66
South Dakota,Corona,76,20,44,4,0,2,70
South Dakota,Summit,382,97,103,32,4,15,251
South Dakota,Pierre,13988,3598,5340,1484,149,815,11386
South Dakota,White Horse,153,100,0,20,0,6,126
South Dakota,Grenville,57,13,36,6,0,2,57
South Dakota,Letcher,240,61,78,22,6,15,182
South Dakota,Goodwin,114,23,52,13,0,13,101
South Dakota,Gregory,1467,325,563,154,9,141,1192
South Dakota,Seneca,26,8,13,4,0,1,26
South Dakota,Bruce,153,26,87,9,0,17,139
South Dakota,Allen,450,211,8,11,0,7,237
South Dakota,Yale,108,15,43,28,0,2,88
South Dakota,Virgil,16,7,7,1,0,1,16
South Dakota,Parker,915,84,496,78,3,49,710
South Dakota,Bridgewater,383,71,172,24,7,32,306
South Dakota,Montrose,581,150,238,24,9,15,436
South Dakota,White River,587,144,173,38,20,42,417
South Dakota,Elk Point,2168,325,993,188,12,129,1647
South Dakota,New Holland,21,0,21,0,0,0,21
South Dakota,Mound City,56,4,42,7,0,2,55
South Dakota,Volin,189,50,90,15,1,0,156
South Dakota,Hot Springs,3515,836,1281,640,74,393,3224
South Dakota,Colonial Pine Hills,2146,368,1242,47,68,86,1811
South Dakota,Oldham,153,33,42,16,0,13,104
South Dakota,Chelsea,39,7,21,4,0,0,32
South Dakota,Green Valley,946,223,332,153,47,25,780
South Dakota,Wall,729,172,303,61,2,48,586
South Dakota,Madison,7203,2374,2527,519,79,483,5982
South Dakota,Nunda,52,0,18,14,0,2,34
South Dakota,Wolsey,450,52,190,62,0,37,341
South Dakota,Volga,1799,382,714,120,12,78,1306
South Dakota,Stratford,50,11,20,7,0,0,38
South Dakota,Wagner,1525,425,473,138,13,153,1202
South Dakota,Egan,336,61,140,47,4,13,265
South Dakota,Hamill,0,0,0,0,0,0,0
South Dakota,Garden City,71,16,26,3,2,5,52
South Dakota,Gary,300,40,127,54,0,22,243
South Dakota,Hill City,876,155,330,167,0,45,697
South Dakota,Bison,302,69,157,16,1,13,256
South Dakota,Marvin,34,1,28,0,3,2,34
South Dakota,Corsica,614,55,338,46,6,82,527
South Dakota,Redfield,2582,579,899,341,42,267,2128
South Dakota,Frankfort,94,20,47,8,0,10,85
South Dakota,Wentworth village,196,53,79,39,0,3,174
South Dakota,Erwin,41,4,26,2,1,2,35
South Dakota,De Smet,1109,112,541,81,8,137,879
South Dakota,Blunt,413,78,147,21,0,16,262
South Dakota,North Sioux City,2781,682,1081,360,61,127,2311
South Dakota,Rosebud,1715,770,126,226,11,36,1169
South Dakota,St. Francis,615,238,81,49,14,25,407
South Dakota,Humboldt,784,133,374,37,5,19,568
South Dakota,Spring Creek,303,161,18,8,0,8,195
South Dakota,Interior,75,0,52,0,0,5,57
South Dakota,Selby,629,60,251,92,0,86,489
South Dakota,Bryant,534,101,215,41,0,61,418
South Dakota,Hayti,453,55,212,41,1,15,324
South Dakota,Lake Preston,504,65,245,70,7,39,426
South Dakota,Rapid Valley,9475,2427,3845,963,16,205,7456
South Dakota,Agar,73,4,23,19,0,8,54
South Dakota,Murdo,389,113,142,30,7,44,336
South Dakota,Garretson,1214,240,499,143,6,61,949
South Dakota,Akaska,44,9,19,10,0,3,41
South Dakota,Vilas,15,0,10,0,0,0,10
South Dakota,Mellette,188,50,79,22,1,7,159
South Dakota,Roscoe,341,54,144,47,0,15,260
South Dakota,Edgemont,750,119,251,95,13,80,558
South Dakota,Fort Pierre,2297,343,1186,121,9,108,1767
South Dakota,Hecla,221,16,131,15,0,15,177
South Dakota,Revillo,94,27,32,15,0,6,80
South Dakota,Ashton,137,23,64,15,1,4,107
South Dakota,Hurley,361,75,189,31,2,14,311
South Dakota,Loomis,0,0,0,0,0,0,0
South Dakota,Mission Hill,218,68,95,13,0,9,185
South Dakota,Wessington,310,25,91,31,20,30,197
South Dakota,Lily,2,0,2,0,0,0,2
Tennessee,Millington,10720,3122,3721,1390,211,675,9119
Tennessee,Halls,2231,479,641,282,27,180,1609
Tennessee,Hendersonville,56421,11943,24409,5711,581,2781,45425
Tennessee,Loretto,1838,343,861,172,58,124,1558
Tennessee,New Market,1471,218,676,139,44,68,1145
Tennessee,Middleton,660,120,298,57,17,29,521
Tennessee,Grand Junction,329,84,136,29,9,16,274
Tennessee,Bolivar,5002,1508,1531,680,136,337,4192
Tennessee,Winchester,8578,1397,3878,830,224,772,7101
Tennessee,Alamo,2241,455,934,208,69,141,1807
Tennessee,Trezevant,775,175,205,183,18,48,629
Tennessee,Brentwood,41987,7041,22294,1634,237,1043,32249
Tennessee,Pine Crest,2412,513,1022,398,9,60,2002
Tennessee,Central,2350,468,955,272,22,237,1954
Tennessee,Dowelltown,334,56,125,69,2,24,276
Tennessee,Charleston,844,126,304,140,10,54,634
Tennessee,Lebanon,31592,7155,12047,3205,920,1696,25023
Tennessee,East Cleveland,1682,395,511,263,122,114,1405
Tennessee,Rutherford,1146,270,457,116,16,87,946
Tennessee,Braden,268,57,152,11,2,18,240
Tennessee,Portland,12539,2852,4628,1549,271,636,9936
Tennessee,New Johnsonville,2107,498,891,210,26,102,1727
Tennessee,Yorkville,249,44,108,20,4,36,212
Tennessee,Dandridge,3091,708,1410,344,35,266,2763
Tennessee,White Pine,2135,543,784,273,52,157,1809
Tennessee,Gallatin,36139,8009,14575,3759,453,1748,28544
Tennessee,Westmoreland,2603,591,946,323,50,176,2086
Tennessee,Pleasant Hill,426,22,197,65,8,83,375
Tennessee,Liberty,358,74,166,21,12,26,299
Tennessee,Baileyton,527,80,199,102,16,32,429
Tennessee,Mount Carmel,5327,1167,2211,580,81,267,4306
Tennessee,Murfreesboro,130968,41541,47202,10656,1432,4558,105389
Tennessee,Clarksville,150602,34173,59554,14373,2735,4711,115546
Tennessee,Greenback,1263,303,514,143,1,25,986
Tennessee,Cleveland,43924,11993,15643,4858,836,2499,35829
Tennessee,Palmer,674,198,252,52,21,54,577
Tennessee,Huntland,821,162,347,78,2,72,661
Tennessee,Charlotte,1674,513,606,143,48,130,1440
Tennessee,Bells,2777,541,907,274,160,202,2084
Tennessee,Somerville,3139,905,954,410,64,194,2527
Tennessee,La Grange,94,8,57,4,12,10,91
Tennessee,Spring Hill,37830,6555,17848,2051,137,667,27258
Tennessee,Fairview,8599,1931,3721,932,139,170,6893
Tennessee,Centertown,350,55,159,52,7,11,284
Tennessee,Brownsville,9715,3021,2623,1059,272,748,7723
Tennessee,Walden,1828,258,1006,139,10,84,1497
Tennessee,Lakesite,2004,421,1000,172,25,110,1728
Tennessee,Toone,390,132,110,52,9,30,333
Tennessee,Gruetli-Laager,2388,567,944,152,42,149,1854
Tennessee,Rutledge,1565,322,501,251,14,184,1272
Tennessee,Blaine,2053,401,888,163,65,142,1659
Tennessee,Parrottsville,289,76,77,49,11,15,228
Tennessee,Camden,3549,712,1183,652,51,356,2954
Tennessee,Troy,1644,295,712,188,38,70,1303
Tennessee,Adamsville,2192,290,923,330,53,114,1710
Tennessee,Mount Pleasant,4810,1488,1728,522,40,284,4062
Tennessee,Banner Hill,1455,266,610,174,47,177,1274
Tennessee,Hopewell,1888,138,919,177,61,205,1500
Tennessee,South Cleveland,8069,1339,3794,614,64,394,6205
Tennessee,Elkton,485,137,211,45,2,44,439
Tennessee,Jamestown,2010,414,602,349,39,235,1639
Tennessee,White Bluff,3449,849,1159,459,138,199,2804
Tennessee,Enville,209,16,106,26,3,14,165
Tennessee,Gatlinburg,4150,861,1835,539,111,152,3498
Tennessee,Mascot,2361,635,931,214,31,84,1895
Tennessee,Saltillo,542,98,275,85,13,32,503
Tennessee,Linden,936,201,332,98,8,146,785
Tennessee,Niota,1018,219,371,132,44,51,817
Tennessee,Baxter,1536,229,588,167,38,99,1121
Tennessee,Pittman Center,627,107,313,55,9,23,507
Tennessee,Cross Plains,1769,333,761,203,17,87,1401
Tennessee,Rogersville,4341,929,1407,693,81,413,3523
Tennessee,Greeneville,14896,3041,5044,2659,352,1092,12188
Tennessee,Pleasant View,4360,887,2107,274,15,152,3435
Tennessee,Puryear,720,167,268,106,20,64,625
Tennessee,Henry,624,147,238,57,4,28,474
Tennessee,Dunlap,5083,861,1928,766,157,465,4177
Tennessee,Dresden,2957,573,1111,277,38,289,2288
Tennessee,Mosheim,2398,497,1045,378,41,116,2077
Tennessee,Moscow,668,263,134,89,0,26,512
Tennessee,Hornsby,295,57,138,31,2,14,242
Tennessee,Tullahoma,19669,3259,7884,2301,537,1368,15349
Tennessee,Friendship,756,124,213,112,28,63,540
Tennessee,Walnut Hill,2286,345,1174,204,7,163,1893
Tennessee,Colonial Heights,3642,784,1690,583,21,123,3201
Tennessee,Millersville,6570,1358,2819,824,204,239,5444
Tennessee,McLemoresville,332,69,144,45,8,30,296
Tennessee,Three Way,1618,311,891,135,16,75,1428
Tennessee,Lawrenceburg,10684,2229,3733,1825,197,895,8879
Tennessee,Baneberry,553,50,366,34,3,30,483
Tennessee,Williston,362,102,118,39,7,34,300
Tennessee,Crump,1371,230,639,110,45,152,1176
Tennessee,Piperton,1892,310,1020,129,16,167,1642
Tennessee,Celina,1803,299,520,330,10,207,1366
Tennessee,Thompson's Station,4754,847,2469,376,6,57,3755
Tennessee,Sparta,4940,878,1828,611,66,488,3871
Tennessee,McMinnville,13650,3028,4250,2384,360,955,10977
Tennessee,Coalmont,759,181,312,75,32,42,642
Tennessee,Medina,4175,791,1594,418,21,106,2930
Tennessee,Bradford,1150,222,435,129,27,105,918
Tennessee,Dyer,2446,481,920,235,66,224,1926
Tennessee,Gibson,367,80,158,36,0,19,293
Tennessee,Milan,7703,1646,2881,867,258,693,6345
Tennessee,Gallaway,710,205,113,75,36,134,563
Tennessee,New Hope,831,185,384,88,7,30,694
Tennessee,Memphis,653248,244584,159550,59105,20170,30373,513782
Tennessee,Manchester,10561,2049,4273,1545,295,460,8622
Tennessee,Lenoir City,9122,1709,3007,1217,223,722,6878
Tennessee,Hohenwald,3657,830,1024,620,4,334,2812
Tennessee,Smyrna,48361,12081,17857,5761,590,2041,38330
Tennessee,Rockwood,5419,937,2147,828,72,493,4477
Tennessee,Oak Ridge,29030,6847,11505,3242,620,1631,23845
Tennessee,Caryville,2653,636,956,331,77,110,2110
Tennessee,Cumberland Gap,295,178,76,23,2,5,284
Tennessee,Pegram,2469,471,1101,280,7,176,2035
Tennessee,Copperhill,504,63,161,122,8,30,384
Tennessee,Benton,1584,382,528,198,38,162,1308
Tennessee,Orme,80,12,38,14,1,10,75
Tennessee,Livingston,4024,763,1447,566,25,415,3216
Tennessee,Lewisburg,11638,2693,3978,1496,428,666,9261
Tennessee,Stantonville,300,66,118,43,7,26,260
Tennessee,Selmer,4422,1026,1750,545,91,233,3645
Tennessee,Pigeon Forge,6197,1240,2773,626,92,417,5148
Tennessee,Ridgetop,2274,315,1117,224,13,129,1798
Tennessee,Coopertown,4455,1010,2283,281,30,88,3692
Tennessee,Gleason,1462,343,590,104,54,109,1200
Tennessee,Dover,2150,446,784,261,49,140,1680
Tennessee,Erin,1315,412,440,124,13,157,1146
Tennessee,Doyle,561,78,267,64,5,36,450
Tennessee,Vonore,1913,327,847,220,35,103,1532
Tennessee,Spring City,2094,311,747,277,51,339,1725
Tennessee,Carthage,2546,567,801,439,60,215,2082
Tennessee,Cumberland City,307,90,111,28,12,30,271
Tennessee,Mountain City,2349,476,866,364,54,219,1979
Tennessee,Monterey,2845,555,954,354,77,196,2136
Tennessee,Jefferson City,8235,2908,2509,835,216,519,6987
Tennessee,Silerton,127,42,47,22,0,5,116
Tennessee,Green Hill,6695,1327,3567,495,34,195,5618
Tennessee,Nolensville,7656,1323,3667,333,10,119,5452
Tennessee,Slayden,154,23,69,24,6,7,129
Tennessee,Jackson,66878,20266,21854,6554,1457,3588,53719
Tennessee,Maury City,873,222,261,99,32,42,656
Tennessee,Gadsden,582,122,244,67,17,17,467
Tennessee,Huntingdon,3845,627,1503,451,100,315,2996
Tennessee,Atwood,992,196,349,153,3,43,744
Tennessee,Bristol,26766,6075,10487,3476,469,1828,22335
Tennessee,Bloomingdale,8660,1637,3592,1289,155,807,7480
Tennessee,Etowah,3474,411,1515,470,116,281,2793
Tennessee,Ridgeside,689,105,338,30,2,24,499
Tennessee,Estill Springs,2282,428,1100,214,39,146,1927
Tennessee,Cowan,1475,274,502,263,41,129,1209
Tennessee,Pikeville,2251,525,796,336,86,147,1890
Tennessee,Gilt Edge,439,103,172,40,11,21,347
Tennessee,Sharon,1023,165,402,106,41,140,854
Tennessee,Martin,10721,5238,2929,741,43,571,9522
Tennessee,Plainview,1803,283,812,210,41,112,1458
Tennessee,Red Bank,11748,3475,3899,1731,297,622,10024
Tennessee,South Carthage,1233,257,514,144,33,52,1000
Tennessee,Brighton,2944,809,999,334,32,122,2296
Tennessee,Pulaski,7652,2104,2257,1002,284,541,6188
Tennessee,Cedar Hill,303,73,83,37,7,18,218
Tennessee,Petersburg,713,99,263,79,29,43,513
Tennessee,Ramer,444,110,163,37,15,17,342
Tennessee,Tellico Plains,961,194,290,122,38,99,743
Tennessee,Bethel Springs,766,151,282,90,28,48,599
Tennessee,Sardis,389,46,191,66,6,25,334
Tennessee,Soddy-Daisy,13460,2600,5581,1793,256,818,11048
Tennessee,Signal Mountain,8523,1167,4254,572,125,492,6610
Tennessee,Lookout Mountain,1992,262,1082,123,13,78,1558
Tennessee,Big Sandy,666,123,233,110,6,55,527
Tennessee,Watertown,1630,328,604,184,37,149,1302
Tennessee,Mitchellville,163,49,48,36,0,7,140
Tennessee,Medon,278,71,98,42,3,11,225
Tennessee,St. Joseph,913,185,379,103,12,74,753
Tennessee,Ooltewah,786,195,444,68,0,10,717
Tennessee,Saulsbury,95,17,26,14,3,16,76
Tennessee,Allardt,625,103,304,59,12,69,547
Tennessee,Lexington,7735,1703,2854,874,245,372,6048
Tennessee,Orlinda,997,187,433,64,35,56,775
Tennessee,Madisonville,4903,956,1831,814,50,419,4070
Tennessee,Harrogate,4323,1390,1693,434,15,288,3820
Tennessee,Erwin,5891,1243,2364,822,122,438,4989
Tennessee,Bean Station,3089,513,1364,392,7,351,2627
Tennessee,Stanton,440,114,113,63,13,26,329
Tennessee,East Ridge,21134,6048,7563,2217,341,1114,17283
Tennessee,Greenfield,2357,488,819,342,31,221,1901
Tennessee,Spencer,1614,236,619,275,51,161,1342
Tennessee,Seymour,10873,2040,5064,1210,120,709,9143
Tennessee,Oakdale,219,57,57,33,9,8,164
Tennessee,Michie,963,116,363,87,31,104,701
Tennessee,Englewood,1592,286,666,191,35,131,1309
Tennessee,Calhoun,554,93,198,65,2,69,427
Tennessee,Gray,1552,504,528,214,0,69,1315
Tennessee,Hartsville/Trousdale,9573,2725,3132,1057,557,496,7967
Tennessee,Watauga,345,77,134,44,8,24,287
Tennessee,Tennessee Ridge,1481,276,651,104,0,94,1125
Tennessee,La Follette,6911,1521,2166,846,212,774,5519
Tennessee,McKenzie,5363,1453,1869,698,127,424,4571
Tennessee,Jonesborough,5321,1102,2362,730,139,366,4699
Tennessee,Cookeville,32894,12160,10414,3391,481,1699,28145
Tennessee,Luttrell,838,202,316,131,25,66,740
Tennessee,Sevierville,16439,3079,6716,1853,360,1266,13274
Tennessee,Paris,10042,2174,3480,1348,180,900,8082
Tennessee,Wildwood Lake,3400,348,1651,157,195,187,2538
Tennessee,Ridgely,1828,434,631,257,55,152,1529
Tennessee,Tiptonville,4359,1923,817,745,229,249,3963
Tennessee,Knoxville,185429,67155,53227,21539,4194,9553,155668
Tennessee,Athens,13752,3324,4301,2016,346,1225,11212
Tennessee,Chapel Hill,1563,210,751,204,11,98,1274
Tennessee,Decatur,1557,316,640,145,16,138,1255
Tennessee,Farragut,22260,3509,12324,968,148,1115,18064
Tennessee,Fall Branch,1547,330,736,207,0,131,1404
Tennessee,Waverly,4069,944,1511,504,47,340,3346
Tennessee,Mount Juliet,32882,5487,15393,2892,401,826,24999
Tennessee,Gordonsville,1703,380,685,212,4,78,1359
Tennessee,Humboldt,8226,1781,3055,773,200,667,6476
Tennessee,Beersheba Springs,516,126,234,28,14,39,441
Tennessee,Sewanee,2352,1737,407,103,0,54,2301
Tennessee,Dickson,15294,4218,5145,1988,257,914,12522
Tennessee,Dyersburg,16559,3621,5932,2042,475,1350,13420
Tennessee,Ripley,8023,2235,2041,1188,232,468,6164
Tennessee,Clarksburg,540,123,235,35,1,23,417
Tennessee,Oakland,7707,1156,4226,408,19,242,6051
Tennessee,Byrdstown,1036,225,361,133,26,106,851
Tennessee,Milledgeville,316,51,113,65,22,27,278
Tennessee,Middle Valley,12097,2259,5747,1302,155,507,9970
Tennessee,Harrison,7555,1670,3500,755,60,450,6435
Tennessee,Rural Hill,1888,286,1165,80,0,67,1598
Tennessee,Rossville,844,159,475,68,13,28,743
Tennessee,Sweetwater,5870,913,2424,781,136,455,4709
Tennessee,Fairmount,2418,396,1270,96,35,127,1924
Tennessee,Lake City,2148,568,588,410,54,204,1824
Tennessee,Eva,93,0,36,47,0,10,93
Tennessee,Fairfield,245,99,45,0,0,44,188
Tennessee,Fairgarden,400,0,255,17,0,34,306
Tennessee,Falling Water,1309,248,538,128,1,111,1026
Tennessee,Fincastle,1276,222,449,180,48,182,1081
Tennessee,Flat Top Mountain,308,52,149,47,4,29,281
Tennessee,Elgin,303,25,160,66,9,13,273
Tennessee,Flintville,640,108,215,73,0,93,489
Tennessee,Grimsley,1219,154,572,96,0,29,851
Tennessee,Hillsboro,251,15,96,69,10,33,223
Tennessee,Lakewood Park,714,112,129,236,33,31,541
Tennessee,Lone Oak,1125,103,606,106,28,81,924
Tennessee,Lyles,1173,168,541,96,0,90,895
Tennessee,Mooresburg,832,126,375,127,5,105,738
Tennessee,Graball,206,47,102,8,0,5,162
Tennessee,Mowbray Mountain,1699,204,936,185,18,86,1429
Tennessee,Dodson Branch,1260,310,598,136,0,64,1108
Tennessee,Cottontown,354,101,164,45,0,35,345
Tennessee,Iron City,222,39,80,57,0,8,184
Tennessee,Cornersville,1336,254,489,198,25,89,1055
Tennessee,Bethpage,320,136,53,114,0,8,311
Tennessee,Algood,4065,902,1101,490,112,411,3016
Tennessee,Rockvale,1340,195,700,41,0,36,972
Tennessee,Andersonville,559,222,252,47,0,0,521
Tennessee,Darden,197,11,75,45,29,35,195
Tennessee,Apison,2830,755,1360,213,9,163,2500
Tennessee,Bowman,133,0,88,0,0,10,98
Tennessee,Bransford,220,57,88,10,0,15,170
Tennessee,Castalian Springs,536,91,243,69,26,27,456
Tennessee,Chesterfield,606,125,269,41,0,10,445
Tennessee,Clarkrange,818,163,430,46,0,16,655
Tennessee,Coalfield,2385,418,1125,142,116,143,1944
Tennessee,Bon Aqua Junction,1229,259,576,107,10,44,996
Tennessee,Munford,5998,1060,2573,409,117,447,4606
Tennessee,New Deal,354,42,157,36,0,38,273
Tennessee,Oak Grove CDP (Sumner County),204,51,67,15,0,15,148
Tennessee,Wrigley,503,85,106,68,13,0,272
Tennessee,Finger,359,59,143,35,5,22,264
Tennessee,Scotts Hill,894,195,365,113,28,56,757
Tennessee,Gainesboro,921,217,258,166,68,88,797
Tennessee,Sunbright,395,86,197,44,5,35,367
Tennessee,Wartburg,954,186,325,171,17,90,789
Tennessee,Wildwood,992,183,544,78,14,41,860
Tennessee,Graysville,1726,386,575,259,48,106,1374
Tennessee,Norris,1450,224,652,178,56,165,1275
Tennessee,Bell Buckle,446,90,166,76,3,23,358
Tennessee,Christiana,3237,397,1783,161,29,136,2506
Tennessee,Nashville-Davidson metropolitan government (balance),660062,218507,219660,65309,10860,25586,539922
Tennessee,Midtown,1437,457,682,124,23,45,1331
Tennessee,Helenwood,1008,274,376,157,0,65,872
Tennessee,Eagleville,843,152,342,84,7,52,637
Tennessee,New Union,1389,131,692,77,0,119,1019
Tennessee,Walnut Grove CDP (Sumner County),956,217,537,62,0,44,860
Tennessee,Walland,272,57,154,11,0,27,249
Tennessee,Oak Grove CDP (Washington County),4709,831,1867,541,49,409,3697
Tennessee,Olivet,1652,185,945,102,40,11,1283
Tennessee,Park City,2424,342,929,245,49,210,1775
Tennessee,Parker's Crossroads,337,57,122,49,23,20,271
Tennessee,Pelham,323,90,145,6,0,59,300
Tennessee,Petros,812,252,180,148,16,18,614
Tennessee,Walnut Grove CDP (Hardin County),260,69,147,12,0,16,244
Tennessee,Riceville,1140,239,472,86,77,56,930
Tennessee,Sale Creek,2872,583,1228,386,87,191,2475
Tennessee,Shackle Island,3082,612,1822,73,0,57,2564
Tennessee,Summertown,598,108,220,46,41,20,435
Tennessee,Telford,1161,274,661,29,0,53,1017
Tennessee,Tellico Village,5612,259,4568,182,0,575,5584
Tennessee,Unionville,2063,184,937,274,18,251,1664
Tennessee,Robbins,178,5,122,43,0,8,178
Tennessee,Lobelville,1025,155,499,128,0,104,886
Tennessee,Lynnville,360,84,121,37,0,25,267
Tennessee,Dayton,7340,2186,1911,1011,123,471,5702
Tennessee,Decaturville,1007,222,318,127,23,96,786
Tennessee,Kimball,1697,365,803,83,20,120,1391
Tennessee,Whitwell,1897,546,628,232,34,156,1596
Tennessee,Bluff City,1867,302,717,289,20,135,1463
Tennessee,Normandy,109,15,29,34,4,9,91
Tennessee,Jellico,2289,312,987,274,55,237,1865
Tennessee,Elizabethton,13555,3694,4684,1743,377,1093,11591
Tennessee,Auburntown,216,34,95,27,3,9,168
Tennessee,Roan Mountain,1276,249,586,177,42,96,1150
Tennessee,Fairfield Glade,8564,435,6008,614,122,810,7989
Tennessee,Surgoinsville,2165,420,996,195,50,74,1735
Tennessee,Kingston Springs,2754,663,1267,229,9,118,2286
Tennessee,New Tazewell,2744,484,958,581,103,235,2361
Tennessee,Maryville,28520,6924,11449,2946,343,1631,23293
Tennessee,McEwen,1615,368,662,205,82,111,1428
Tennessee,Woodland Mills,332,42,179,36,0,13,270
Tennessee,Clifton,2684,1092,642,469,137,166,2506
Tennessee,Fayetteville,6987,1739,2126,858,207,923,5853
Tennessee,Lafayette,5055,1000,1904,565,222,341,4032
Tennessee,Chattanooga,177365,58625,55393,19607,3011,11185,147821
Tennessee,Arlington,11689,2260,5515,434,80,254,8543
Tennessee,Ashland City,4608,969,1497,769,216,207,3658
Tennessee,Powells Crossroads,1461,217,745,152,12,68,1194
Tennessee,Covington,8855,2857,2526,820,244,742,7189
Tennessee,Bartlett,58828,11978,27451,4545,742,2922,47638
Tennessee,Crab Orchard,724,154,264,50,22,72,562
Tennessee,Lake Tansi,4343,638,2241,435,88,264,3666
Tennessee,Tusculum,2737,1152,932,186,0,152,2422
Tennessee,Union City,10478,2410,3677,1403,212,672,8374
Tennessee,Church Hill,6681,1181,3141,852,75,595,5844
Tennessee,Henderson,6247,2405,1654,541,110,432,5142
Tennessee,Forest Hills,4968,733,2841,207,19,250,4050
Tennessee,Minor Hill,526,75,178,79,3,20,355
Tennessee,Collegedale,11256,3553,4219,744,90,1065,9671
Tennessee,White House,11513,2082,5622,878,42,479,9103
Tennessee,Goodlettsville,16900,4194,6228,2389,406,838,14055
Tennessee,Columbia,37455,9360,12584,4527,806,2344,29621
Tennessee,Whiteville,4526,2323,799,774,196,129,4221
Tennessee,Hickory Valley,86,17,54,9,2,1,83
Tennessee,Sneedville,1285,272,445,137,22,140,1016
Tennessee,Tracy City,1556,341,629,180,15,86,1251
Tennessee,Altamont,1037,126,400,146,67,109,848
Tennessee,Trenton,4091,1359,1023,615,83,395,3475
Tennessee,Decherd,3151,763,1038,362,39,246,2448
Tennessee,Vanleer,333,76,120,31,14,26,267
Tennessee,Cottage Grove,79,8,37,16,2,3,66
Tennessee,Newbern,3327,510,1294,369,32,181,2386
Tennessee,Viola,104,14,43,21,0,8,86
Tennessee,Ducktown,489,82,175,63,9,107,436
Tennessee,Unicoi,3556,758,1378,422,19,398,2975
Tennessee,Henning,908,293,260,112,51,49,765
Tennessee,Blountville,2813,670,1201,345,130,215,2561
Tennessee,Lakeland,12628,2399,5906,790,158,317,9570
Tennessee,Collierville,49610,8646,26177,2644,392,1385,39244
Tennessee,Gates,667,119,171,107,24,59,480
Tennessee,La Vergne,35237,8296,13221,3487,442,892,26338
Tennessee,Kingston,5821,1184,2460,863,70,452,5029
Tennessee,Rives,285,72,99,21,8,16,216
Tennessee,Obion,1300,353,366,201,12,74,1006
Tennessee,Kenton,1193,248,488,129,40,158,1063
Tennessee,Hollow Rock,785,180,270,91,26,61,628
Tennessee,Maynardville,2724,586,835,395,69,232,2117
Tennessee,Burns,1719,428,602,224,4,146,1404
Tennessee,Harriman,6136,1522,2073,965,104,525,5189
Tennessee,Waynesboro,2552,568,878,292,70,262,2070
Tennessee,Oliver Springs,4489,888,1807,456,53,218,3422
Tennessee,Trimble,495,75,232,61,3,36,407
Tennessee,Belle Meade,2401,268,1468,102,14,86,1938
Tennessee,Wartrace,630,94,233,116,13,33,489
Tennessee,Shelbyville,21319,5406,6498,2368,799,1056,16127
Tennessee,Clinton,9908,1975,3976,1265,230,825,8271
Tennessee,Eagleton Village,5250,1107,1985,545,90,410,4137
Tennessee,Centerville,3555,640,1388,515,73,320,2936
Tennessee,Alexandria,1112,207,505,132,10,55,909
Tennessee,Crossville,11368,2317,3735,1530,440,969,8991
Tennessee,Bruceton,1318,293,476,171,37,137,1114
Tennessee,Ethridge,753,157,251,50,33,41,532
Tennessee,Savannah,6964,1468,2184,1045,115,666,5478
Tennessee,Franklin,75366,15257,35486,6057,535,2385,59720
Tennessee,Morrison,601,170,207,70,8,27,482
Tennessee,Kingsport,53115,10321,21518,7317,1032,3991,44179
Tennessee,Townsend,373,32,203,55,0,51,341
Tennessee,Hornbeak,419,71,183,48,9,32,343
Tennessee,Bulls Gap,696,117,315,99,15,61,607
Tennessee,Alcoa,9633,1967,3598,1269,101,531,7466
Tennessee,Rockford,849,169,414,75,20,46,724
Tennessee,Newport,6757,1176,2210,997,162,643,5188
Tennessee,Ardmore,1293,347,436,180,44,126,1133
Tennessee,Parsons,2263,450,874,279,43,223,1869
Tennessee,South Fulton,2449,622,832,325,106,108,1993
Tennessee,Hunter,2153,211,1015,336,19,121,1702
Tennessee,Jasper,3351,501,1445,286,92,311,2635
Tennessee,Monteagle,1957,311,723,245,72,125,1476
Tennessee,Oneida,3706,792,1339,435,145,184,2895
Tennessee,Garland,339,66,172,30,5,6,279
Tennessee,Samburg,273,28,176,10,9,14,237
Tennessee,Philadelphia,986,256,338,138,35,28,795
Tennessee,Morristown,29547,7347,10249,3524,753,1907,23780
Tennessee,Springfield,16787,4175,6134,1724,274,964,13271
Tennessee,Collinwood,1006,199,416,98,21,64,798
Tennessee,Smithville,4699,1134,1635,549,93,301,3712
Tennessee,Friendsville,742,129,367,84,23,45,648
Tennessee,Berry Hill,1082,757,172,91,11,23,1054
Tennessee,Tazewell,2312,554,761,391,48,267,2021
Tennessee,Woodbury,2735,772,616,377,174,311,2250
Tennessee,Louisville,4133,623,2165,398,59,112,3357
Tennessee,Burlison,337,71,151,41,12,19,294
Tennessee,Winfield,1008,131,409,190,21,73,824
Tennessee,Walterhill,233,43,179,0,0,0,222
Tennessee,Germantown,39164,5402,21961,2209,169,1707,31448
Tennessee,Guys,543,131,189,75,8,50,453
Tennessee,Eastview,1007,202,336,102,4,52,696
Tennessee,Spurgeon,4482,685,2125,560,11,249,3630
Tennessee,Johnson City,66037,20039,23259,7108,1386,3765,55557
Tennessee,Greenbrier,6770,1296,2639,757,71,410,5173
Tennessee,Red Boiling Springs,1516,204,566,132,38,129,1069
Tennessee,Atoka,9139,1575,4369,606,56,324,6930
Tennessee,Oak Hill,4634,560,2712,133,0,201,3606
Tennessee,Mason,1123,463,234,128,30,44,899
Tennessee,Loudon,5687,801,2444,607,101,543,4496
Tennessee,Jacksboro,2250,585,923,270,37,195,2010
Tennessee,Huntsville,1419,412,356,225,37,133,1163
Tennessee,South Pittsburg,3045,685,919,480,92,273,2449
Tennessee,Adams,638,132,241,93,3,21,490
Texas,Weinert,240,65,110,29,2,22,228
Texas,Relampago,325,230,0,60,0,35,325
Texas,Union Valley,367,33,232,8,7,22,302
Texas,Talty,2302,307,1137,168,7,26,1645
Texas,Salineño,129,71,23,13,5,0,112
Texas,Lopeño,184,67,0,0,0,0,67
Texas,Cut and Shoot,1313,292,549,147,28,45,1061
Texas,Encantada-Ranchito-El Calaboz,1438,386,562,52,42,62,1104
Texas,Smiley,608,163,253,42,16,25,499
Texas,China,979,135,501,116,16,63,831
Texas,Roaring Springs,186,41,90,25,3,23,182
Texas,Rosser village,249,57,69,37,2,23,188
Texas,Lindsay,1156,176,583,83,0,64,906
Texas,Nixon,2987,687,1268,142,40,102,2239
Texas,Stanton,2937,544,1124,214,64,139,2085
Texas,Gonzales,7520,1831,2320,802,71,521,5545
Texas,Bacliff,10649,2542,3648,908,294,296,7688
Texas,Denver City,4874,540,2357,360,76,232,3565
Texas,Merkel,2614,359,945,397,107,189,1997
Texas,Kress,808,248,339,35,0,34,656
Texas,Richland Springs,281,34,138,16,3,42,233
Texas,Laredo,257575,68640,84741,16337,6722,9406,185846
Texas,Evadale,1887,498,735,167,5,49,1454
Texas,Buna,1891,501,703,284,42,168,1698
Texas,Tierra Grande,466,96,216,10,0,43,365
Texas,Oak Ridge town (Kaufman County),529,85,251,62,5,18,421
Texas,Jolly,183,13,102,45,0,10,170
Texas,Lampasas,7611,1497,2787,1011,248,546,6089
Texas,Forney,19366,3917,8047,1536,124,438,14062
Texas,Bishop Hills,297,45,155,6,5,9,220
Texas,Ranger,2863,665,711,587,63,276,2302
Texas,Bandera,805,161,304,148,17,122,752
Texas,Lakehills,5288,868,2345,833,104,152,4302
Texas,Cinco Ranch,16977,2833,9150,679,72,371,13105
Texas,Miami,511,127,214,43,6,16,406
Texas,Hemphill,1333,169,520,190,15,120,1014
Texas,Pineland,616,117,248,81,14,55,515
Texas,Jersey Village,7945,1870,3729,1035,54,375,7063
Texas,Southside Place,1596,312,830,71,5,18,1236
Texas,Ranchos Penitas West,1240,178,473,33,8,0,692
Texas,La Presa,244,69,107,0,8,7,191
Texas,Galveston,50039,17058,16159,6360,1276,2481,43334
Texas,Brackettville,1831,282,578,352,100,183,1495
Texas,White Oak,6358,1127,2799,618,66,193,4803
Texas,Coyote Acres,1297,258,525,33,0,0,816
Texas,Comfort,3350,811,1340,225,89,258,2723
Texas,Knox City,1293,277,463,88,20,94,942
Texas,Longview,82256,21000,27860,9119,1829,4534,64342
Texas,Kennard,189,33,70,42,15,14,174
Texas,Paint Rock,411,97,194,14,6,32,343
Texas,Clarendon,1961,522,576,248,79,139,1564
Texas,Caldwell,4302,1098,1615,310,58,243,3324
Texas,Putnam,78,10,31,31,0,0,72
Texas,Guerra,0,0,0,0,0,0,0
Texas,Ingram,1979,423,706,253,68,125,1575
Texas,Moore,369,76,109,136,0,0,321
Texas,Milam,1742,159,784,171,151,79,1344
Texas,Happy,612,152,190,107,0,33,482
Texas,Buffalo Gap,545,130,190,43,34,16,413
Texas,Potosi,2925,412,1497,185,104,68,2266
Texas,Alto,1242,344,465,65,3,82,959
Texas,Prado Verde,243,77,92,11,0,29,209
Texas,Colorado City,3983,830,1631,341,83,192,3077
Texas,Zavalla,734,130,271,88,34,35,558
Texas,Fort Worth,855786,232708,298892,76985,15535,29705,653825
Texas,Doffing,5065,1304,1657,196,234,128,3519
Texas,Faysville,0,0,0,0,0,0,0
Texas,San Carlos,3659,903,1260,137,51,157,2508
Texas,Scissors,3564,1098,929,207,70,136,2440
Texas,Wellman,213,21,119,19,4,0,163
Texas,Lometa,653,136,225,14,27,50,452
Texas,Cottonwood Shores,1524,477,510,190,43,59,1279
Texas,Meadowlakes,2319,319,1180,216,0,188,1903
Texas,Brownsboro,1165,238,539,46,16,33,872
Texas,Malone,319,90,115,9,0,2,216
Texas,Bloomington,1855,529,588,172,62,183,1534
Texas,Tornillo,1110,369,369,31,37,42,848
Texas,Sparks,3935,1129,1410,335,96,123,3093
Texas,Llano Grande,2224,635,1014,74,15,217,1955
Texas,Fort Bliss,10602,3769,3335,241,49,4,7398
Texas,Eustace,912,205,351,111,11,72,750
Texas,Kountze,1979,495,657,234,76,177,1639
Texas,Beasley,606,107,250,48,7,34,446
Texas,Brownfield,9596,2320,3057,1173,337,627,7514
Texas,Alvin,26154,6385,9987,2469,266,1289,20396
Texas,Wallis,1508,232,670,181,6,91,1180
Texas,Decatur,6608,1219,2112,914,146,562,4953
Texas,Deweyville,637,216,277,98,36,10,637
Texas,Texas City,47902,12153,15795,5049,1321,3145,37463
Texas,Yoakum,6233,1525,2274,439,66,407,4711
Texas,Star Harbor,443,53,302,17,4,21,397
Texas,Fort Hancock,1898,418,706,104,38,125,1391
Texas,Malakoff,2960,814,815,398,5,160,2192
Texas,Murchison,484,83,230,39,12,21,385
Texas,Granjeno,387,74,236,16,0,13,339
Texas,Edcouch,3316,773,1156,232,88,214,2463
Texas,Santa Clara,769,120,405,55,13,40,633
Texas,Hico,1518,408,505,164,18,108,1203
Texas,Johnson City,1885,441,701,318,83,106,1649
Texas,Woodbranch,1521,226,815,130,5,73,1249
Texas,Atlanta,5523,952,2042,775,145,430,4344
Texas,Texarkana,37277,9838,11647,4266,1007,2168,28926
Texas,Morgan's Point,314,75,129,27,3,33,267
Texas,Atascocita,79019,16130,33776,6141,1253,1986,59286
Texas,Deer Park,33935,8397,13869,3071,315,1284,26936
Texas,Jacinto City,10747,2618,3876,801,512,378,8185
Texas,Seabrook,13670,3639,4751,2153,145,471,11159
Texas,Sheldon,2116,681,710,130,43,73,1637
Texas,Gregory,2065,649,669,147,96,86,1647
Texas,Mathis,4899,1356,1530,349,132,298,3665
Texas,Wills Point,3571,853,1108,382,87,332,2762
Texas,Winona,526,110,215,77,0,12,414
Texas,Cienegas Terrace,3489,1107,1298,152,0,53,2610
Texas,Austin,935755,334290,312042,84774,13432,23762,768300
Texas,Carl's Corner,180,20,129,6,3,3,161
Texas,Westway,3552,839,1175,209,137,148,2508
Texas,Bedford,49306,11780,19680,6081,915,2539,40995
Texas,Mullin,95,7,18,30,2,23,80
Texas,Bremond,875,270,268,120,22,105,785
Texas,Goldsmith,202,39,96,15,31,14,195
Texas,Argyle,3988,555,2404,219,58,139,3375
Texas,Northlake,2524,608,836,336,33,71,1884
Texas,Glen Rose,2578,293,1206,315,101,225,2140
Texas,Elbert,8,3,5,0,0,0,8
Texas,San Isidro,189,89,39,5,8,16,157
Texas,Los Indios,838,172,323,67,40,55,657
Texas,Benbrook,22961,4312,10459,2451,191,992,18405
Texas,Lake Medina Shores,1449,339,295,511,37,128,1310
Texas,Chapeno,23,7,6,0,0,0,13
Texas,Lake Colorado City,422,42,201,64,0,44,351
Texas,Yznaga,52,0,8,12,26,6,52
Texas,Round Top,90,8,55,16,0,9,88
Texas,Grays Prairie village,270,30,169,14,0,14,227
Texas,Green Valley Farms,423,86,122,16,47,33,304
Texas,West Tawakoni,2189,494,852,350,38,122,1856
Texas,Freer,2714,711,905,181,62,134,1993
Texas,Volente village,590,109,330,59,0,11,509
Texas,Taylor Landing,251,27,157,12,0,9,205
Texas,San Augustine,1815,576,559,142,31,148,1456
Texas,Oak Leaf,1486,303,797,94,3,37,1234
Texas,Little Elm,42889,8928,18209,3213,253,896,31499
Texas,Lavon,3061,470,1411,218,13,78,2190
Texas,Shallowater,2535,403,1123,265,5,60,1856
Texas,DISH,419,38,226,55,3,17,339
Texas,Celina,9354,1443,4666,371,106,154,6740
Texas,Brazos Bend,382,39,267,22,5,8,341
Texas,Edgecliff Village,3002,618,1311,288,17,168,2402
Texas,Westbrook,177,22,95,15,2,11,145
Texas,Morning Glory,432,58,112,69,24,0,263
Texas,Canutillo,5061,1335,1677,290,163,188,3653
Texas,Log Cabin,590,114,231,75,21,60,501
Texas,Enchanted Oaks,316,31,210,17,2,44,304
Texas,Berryville,1203,164,554,133,19,84,954
Texas,Athens,12677,2964,4847,1001,111,731,9654
Texas,Trenton,789,181,319,59,15,76,650
Texas,Ackerly,186,37,65,5,6,10,123
Texas,Daingerfield,2777,483,1132,294,95,143,2147
Texas,Harker Heights,30251,6537,12526,2747,490,1151,23451
Texas,Fruitvale,479,126,161,45,9,25,366
Texas,Lakeway,14677,2086,8449,1030,95,512,12172
Texas,Bruni,294,60,154,27,0,14,255
Texas,Giddings,5043,1440,1389,679,19,290,3817
Texas,Tiki Island village,963,102,729,65,0,51,947
Texas,Paducah,1325,177,496,105,29,120,927
Texas,La Marque,16225,4062,5504,2034,361,1058,13019
Texas,Bolivar Peninsula,2333,563,1096,272,31,59,2021
Texas,Byers,517,99,246,26,2,18,391
Texas,Palestine,18237,4303,7030,1533,432,1052,14350
Texas,Encinal,953,298,285,108,15,52,758
Texas,Hondo,9204,3001,2994,725,224,446,7390
Texas,Hitchcock,7730,1739,2814,638,70,329,5590
Texas,Adrian,116,2,56,26,0,27,111
Texas,Queen City,1634,405,600,189,39,124,1357
Texas,Douglassville,237,53,128,10,0,11,202
Texas,Jourdanton,4319,1145,1222,492,62,189,3110
Texas,White Deer,663,69,306,36,9,53,473
Texas,Ratamosa,266,28,42,25,37,0,132
Texas,Olmito,1243,241,475,108,92,19,935
Texas,Santa Rosa,2830,947,896,100,49,171,2163
Texas,Lakeside town (San Patricio County),320,33,174,43,1,37,288
Texas,Stockdale,1295,263,493,103,15,88,962
Texas,Rosebud,1437,356,457,170,11,115,1109
Texas,Bardwell,623,123,255,55,9,23,465
Texas,Follett,479,110,153,65,9,23,360
Texas,Corral City,6,0,3,0,0,0,3
Texas,Jefferson,2533,595,934,238,25,228,2020
Texas,Uhland,1343,362,539,55,36,37,1029
Texas,Gardendale,2031,388,668,197,34,52,1339
Texas,Naples,1353,236,427,127,64,100,954
Texas,Medina,5296,1253,1507,284,135,49,3228
Texas,Westlake,974,158,513,62,0,13,746
Texas,Camargito,447,119,116,0,33,45,313
Texas,Callender Lake,1300,112,596,196,40,84,1028
Texas,Canyon Creek,1306,197,492,135,53,28,905
Texas,Burton,560,67,188,60,7,46,368
Texas,Buena Vista,54,31,23,0,0,0,54
Texas,Buchanan Lake Village,856,65,502,129,0,119,815
Texas,Bristol,484,215,182,0,0,67,464
Texas,Boys Ranch,509,169,56,5,0,0,230
Texas,Box Canyon,43,1,24,12,2,3,42
Texas,Bonanza Hills,127,38,49,0,0,0,87
Texas,Boling,916,171,350,65,0,75,661
Texas,Bluetown,482,98,203,27,14,8,350
Texas,Campo Verde,105,11,94,0,0,0,105
Texas,Big Thicket Lake Estates,582,154,57,56,56,131,454
Texas,Bee Cave,6521,998,3284,638,0,228,5148
Texas,Barrera,83,24,0,0,0,4,28
Texas,Banquete,389,145,117,68,20,19,369
Texas,B and E,422,54,158,0,39,18,269
Texas,Arroyo Gardens,108,0,53,0,0,44,97
Texas,Anacua,8,8,0,0,0,0,8
Texas,Amistad,23,0,11,3,0,9,23
Texas,Amaya,42,7,15,0,0,10,32
Texas,Amargosa,100,16,84,0,0,0,100
Texas,Amada Acres,0,0,0,0,0,0,0
Texas,Alto Bonito Heights,194,48,63,59,0,12,182
Texas,Alfred,0,0,0,0,0,0,0
Texas,Benjamin Perez,161,0,137,0,0,0,137
Texas,Cape Royale,445,0,364,54,0,27,445
Texas,Carlsbad,574,265,130,17,0,49,461
Texas,Casa Blanca,0,0,0,0,0,0,0
Texas,Los Ybanez,22,8,3,8,2,1,22
Texas,Grand Saline,3105,477,1163,293,68,287,2288
Texas,Edom,245,60,119,24,0,7,210
Texas,Aspermont,908,153,369,74,14,90,700
Texas,Leroy,374,74,176,17,5,18,290
Texas,Hallsburg,483,71,199,60,1,33,364
Texas,Eagle Lake,3685,1206,1052,313,67,131,2769
Texas,Milano,416,88,185,38,11,11,333
Texas,Muenster,1477,297,595,102,3,120,1117
Texas,Perryton,9167,1812,3892,418,170,376,6668
Texas,Post Oak Bend City,420,54,230,28,12,15,339
Texas,Kaufman,7107,1574,2201,836,322,465,5398
Texas,Livingston,5046,1255,1740,659,212,362,4228
Texas,Cross Roads,1202,203,664,104,7,33,1011
Texas,O'Donnell,880,131,422,89,25,23,690
Texas,Paradise,492,67,214,69,7,26,383
Texas,Crane,4051,795,1641,199,147,221,3003
Texas,Yantis,407,80,115,67,36,40,338
Texas,Hawkins,1351,314,418,208,47,80,1067
Texas,Leona,125,35,49,11,0,10,105
Texas,Centerville,1092,184,394,88,26,71,763
Texas,Sundown,1222,260,500,107,29,82,978
Texas,Opdyke West,232,52,71,16,21,5,165
Texas,Lumberton,12610,2040,5934,1183,37,499,9693
Texas,Old River-Winfree,2130,431,838,162,37,173,1641
Texas,Rosenberg,36509,9737,12366,3086,874,1123,27186
Texas,Casas,27,17,10,0,0,0,27
Texas,Shiner,2139,338,1016,207,5,159,1725
Texas,Lake Dunlap,2288,512,888,224,47,103,1774
Texas,Crystal City,7381,2117,2136,548,349,326,5476
Texas,Lawn,313,49,156,26,4,16,251
Texas,Hargill,826,132,260,29,23,85,529
Texas,Gutierrez,84,48,0,36,0,0,84
Texas,Guthrie,154,4,67,29,0,20,120
Texas,Glidden,911,167,327,10,25,0,529
Texas,Garza-Salinas II,570,55,195,13,65,64,392
Texas,Garden City,487,98,259,13,0,13,383
Texas,Garciasville,72,29,0,0,0,0,29
Texas,Gail,245,48,113,19,0,27,207
Texas,Four Points,0,0,0,0,0,0,0
Texas,Fort Clark Springs,1189,364,488,27,14,162,1055
Texas,Flor del Rio,254,46,91,0,0,0,137
Texas,Fronton Ranchettes,234,75,63,7,5,0,150
Texas,H. Cuellar Estates,103,32,50,0,0,10,92
Texas,Fernando Salinas,27,14,0,13,0,0,27
Texas,Falman,15,0,15,0,0,0,15
Texas,Falconaire,180,50,52,0,32,0,134
Texas,Fabrica,748,243,141,73,42,17,516
Texas,Evergreen,53,15,38,0,0,0,53
Texas,Eugenio Saenz,260,75,50,34,8,0,167
Texas,Emerald Bay,1307,179,922,33,0,118,1252
Texas,El Socio,69,11,58,0,0,0,69
Texas,El Rancho Vela,569,33,236,25,0,64,358
Texas,El Quiote,193,43,83,28,0,11,165
Texas,Elmo,1351,327,455,227,0,32,1041
Texas,El Mesquite,0,0,0,0,0,0,0
Texas,Elias-Fela Solis,8,0,8,0,0,0,8
Texas,Fannett,2156,397,1243,118,8,104,1870
Texas,Hillside Acres,0,0,0,0,0,0,0
Texas,Hilltop CDP (Frio County),167,19,148,0,0,0,167
Texas,Hilltop CDP (Starr County),90,50,20,0,0,9,79
Texas,Lake Cherokee,2480,279,1539,178,0,200,2196
Texas,Lake Bryan,1817,283,732,170,38,62,1285
Texas,Laguna Park,1497,214,689,186,49,113,1251
Texas,La Esperanza,58,0,43,0,0,0,43
Texas,La Escondida,232,33,86,0,0,0,119
Texas,La Coma,66,23,20,10,0,0,53
Texas,La Chuparosa,37,0,0,0,11,0,11
Texas,La Casita,0,0,0,0,0,0,0
Texas,La Carla,209,63,52,0,0,0,115
Texas,Knollwood,537,155,207,82,11,45,500
Texas,Lost Creek,1135,269,582,27,10,68,956
Texas,Guadalupe Guerra,62,3,41,0,0,0,44
Texas,Coupland,255,28,123,38,4,0,193
Texas,Kemp,996,174,374,113,22,88,771
Texas,Juarez,1309,480,374,0,17,44,915
Texas,Jardin de San Julian,31,12,12,0,0,0,24
Texas,Ivanhoe,1391,331,423,204,70,135,1163
Texas,Indio,0,0,0,0,0,0,0
Texas,Indian Springs,766,255,242,110,0,17,624
Texas,Iglesia Antigua,218,55,88,23,0,22,188
Texas,Iago,113,17,39,22,0,25,103
Texas,Hull,809,160,372,0,7,17,556
Texas,Horseshoe Bend,710,208,264,58,0,89,619
Texas,Hornsby Bend,7194,1939,2601,726,175,35,5476
Texas,Holly Lake Ranch,2565,310,1691,169,0,171,2341
Texas,Holiday Beach,648,35,366,165,0,57,623
Texas,Hilltop Lakes,783,144,406,192,0,41,783
Texas,El Chaparral,375,126,162,15,4,7,314
Texas,La Pryor,1487,362,484,50,77,130,1103
Texas,El Cenizo,444,129,102,68,0,11,310
Texas,El Brazil,61,12,49,0,0,0,61
Texas,Pinewood Estates,1863,348,1034,27,0,24,1433
Texas,Newton,2165,416,736,351,82,142,1727
Texas,Kendleton,328,121,76,48,10,25,280
Texas,Rendon,13616,2352,6694,1157,85,456,10744
Texas,North Richland Hills,69800,15682,29209,6475,1025,3280,55671
Texas,Lakeside town (Tarrant County),1524,237,881,143,13,96,1370
Texas,Flower Mound,73252,13114,38003,3940,439,1467,56963
Texas,Blue Mound,3398,805,1271,235,63,156,2530
Texas,Newark,1326,283,516,98,41,37,975
Texas,Vinton village,1773,530,516,106,51,51,1254
Texas,Fabens,5946,1538,1936,431,233,206,4344
Texas,Clint,718,169,262,91,20,60,602
Texas,Levelland,13686,3261,5448,837,156,963,10665
Texas,Anthony,5578,1729,1815,511,237,254,4546
Texas,Cuero,8349,1791,3367,958,205,544,6865
Texas,Tool,2227,424,954,355,41,176,1950
Texas,Moore Station,312,159,67,12,15,20,273
Texas,Leonard,2265,441,780,299,26,153,1699
Texas,Ector,903,215,373,78,27,31,724
Texas,White Settlement,17396,4175,5741,2114,434,1251,13715
Texas,Pelican Bay,1620,386,503,181,43,147,1260
Texas,Pantego,2532,429,1115,300,57,333,2234
Texas,Troup,2169,463,752,210,51,79,1555
Texas,Rusk,5563,1881,1797,816,178,240,4912
Texas,Jacksonville,14821,3985,4626,1341,266,1017,11235
Texas,North Pearsall,1211,350,491,136,19,0,996
Texas,Yorktown,1651,381,686,107,8,172,1354
Texas,Dalworthington Gardens,2456,544,1297,133,24,84,2082
Texas,Euless,55047,13676,20931,6611,862,1887,43967
Texas,Cumings,2420,470,1015,0,137,105,1727
Texas,Edgewater Estates,122,35,63,0,0,9,107
Texas,East Alto Bonito,819,161,431,0,58,20,670
Texas,Driftwood,74,9,58,7,0,0,74
Texas,Dorchester,77,12,42,4,2,6,66
Texas,D'Hanis,918,323,360,24,11,81,799
Texas,Del Sol,59,18,41,0,0,0,59
Texas,Delmita,129,71,33,2,8,0,114
Texas,Country Acres,223,65,98,0,0,9,172
Texas,Colorado Acres,118,18,36,0,0,0,54
Texas,Chula Vista CDP (Zavala County),1126,379,265,44,0,127,815
Texas,Chula Vista CDP (Maverick County),3922,814,1572,248,190,148,2972
Texas,Chula Vista CDP (Cameron County),499,37,288,0,0,0,325
Texas,China Spring,990,267,375,51,40,72,805
Texas,Chilton,736,242,173,15,53,25,508
Texas,Penelope,160,9,77,5,13,12,116
Texas,Chaparrito,71,14,13,0,29,0,56
Texas,Cedar Point,806,218,250,115,81,82,746
Texas,Blanco,2550,585,1005,214,144,106,2054
Texas,Normangee,760,146,207,118,20,67,558
Texas,Anton,1123,236,381,125,27,59,828
Texas,South Toledo Bend,476,93,271,51,0,34,449
Texas,Alba,774,157,330,66,13,61,627
Texas,Stowell,1291,364,515,84,34,0,997
Texas,Simonton,640,120,248,81,9,53,511
Texas,Richmond,12084,3499,4078,936,374,528,9415
Texas,Orchard,253,38,129,24,10,14,215
Texas,Fulshear,8014,1173,4285,116,42,121,5737
Texas,El Castillo,137,28,49,0,0,5,82
Texas,Goldthwaite,2153,442,781,238,0,193,1654
Texas,Hutchins,5726,2345,1406,651,158,143,4703
Texas,Plainview,20714,5162,7376,1710,426,1177,15851
Texas,Haskell,3240,1088,1150,322,43,188,2791
Texas,Frankston,1053,232,380,139,14,141,906
Texas,Lamesa,9264,2221,3430,786,142,485,7064
Texas,Muleshoe,5568,1444,1992,422,229,301,4388
Texas,Neylandville,76,3,20,4,15,5,47
Texas,Commerce,9000,4373,2200,674,106,338,7691
Texas,Jewett,1009,209,377,56,31,31,704
Texas,Hallsville,4134,812,1866,260,0,107,3045
Texas,Gorman,1042,253,293,149,4,76,775
Texas,Louise,935,293,335,72,46,41,787
Texas,Woodson,219,53,94,10,0,13,170
Texas,The Colony,42215,11208,16706,4799,607,1171,34491
Texas,Shady Shores,2828,380,1321,300,28,122,2151
Texas,Roanoke,7899,1744,3483,670,242,161,6300
Texas,Krugerville,1600,256,917,130,23,39,1365
Texas,Hickory Creek,4442,853,2212,559,56,131,3811
Texas,Hebron,239,55,114,17,0,10,196
Texas,Denton,133661,51266,43189,11148,1894,4567,112064
Texas,Corinth,21158,3710,10670,1632,40,668,16720
Texas,Emory,1361,291,510,211,30,105,1147
Texas,Kerrville,23216,5146,8698,3069,468,2122,19503
Texas,Rochester,365,52,139,36,27,26,280
Texas,Iraan,1215,300,559,58,22,49,988
Texas,Pyote,126,37,31,15,0,17,100
Texas,Annona,358,101,107,43,15,31,297
Texas,Powell,93,19,44,10,7,8,88
Texas,Blessing,660,265,79,15,22,49,430
Texas,Eagle Pass,29151,7209,10722,1507,1020,1377,21835
Texas,Avery,518,128,135,78,17,47,405
Texas,Cross Timber,356,38,209,18,2,9,276
Texas,Briaroaks,563,102,256,38,1,45,442
Texas,Monahans,7587,1859,2964,614,55,360,5852
Texas,Hempstead,7397,2239,2395,308,147,203,5292
Texas,Bayside,417,82,196,25,2,47,352
Texas,Strawn,680,127,223,118,14,71,553
Texas,West Orange,3399,769,1259,366,79,173,2646
Texas,Mauriceville,3121,542,1418,417,48,113,2538
Texas,Midlothian,23908,4501,11146,1638,305,385,17975
Texas,Gordon,450,107,205,55,9,36,412
Texas,Floydada,2767,576,1187,123,81,163,2130
Texas,Hale Center,2189,470,831,241,48,134,1724
Texas,Rotan,1345,318,500,102,55,168,1143
Texas,Midland,135134,30318,54311,11712,2201,5112,103654
Texas,Edroy,523,143,120,31,22,27,343
Texas,Mobeetie,104,21,57,4,4,1,87
Texas,McKinney,173460,34112,77077,12660,2041,5099,130989
Texas,Holiday Lakes,1060,221,345,100,34,45,745
Texas,Cotulla,4162,1237,1609,224,24,300,3394
Texas,Spur,1089,169,389,180,70,103,911
Texas,Granite Shoals,5057,1156,2168,497,97,162,4080
Texas,Pittsburg,4634,1122,1502,295,111,395,3425
Texas,Copperas Cove,32731,6393,13730,3341,513,1368,25345
Texas,Meadow,685,91,320,33,19,34,497
Texas,Palmview South,5352,968,2533,82,180,374,4137
Texas,Redwood,3429,1040,1305,170,101,137,2753
Texas,Marquez,351,74,127,17,4,36,258
Texas,Silsbee,6640,1259,2346,766,264,562,5197
Texas,Zuehl,307,82,177,36,0,0,295
Texas,Mont Belvieu,5555,1120,2405,334,98,121,4078
Texas,Progreso Lakes,292,28,156,22,3,16,225
Texas,Penitas,4834,1290,1713,70,112,235,3420
Texas,Midway North,5074,1183,1901,184,205,40,3513
Texas,Laguna Seca,297,84,123,0,16,20,243
Texas,La Blanca,2383,493,1067,94,41,34,1729
Texas,Edinburg,94019,26845,31017,5934,2318,2984,69098
Texas,Silverton,709,174,288,68,13,66,609
Texas,Gatesville,12387,3629,3471,2073,832,687,10692
Texas,Canyon Lake,25104,4639,12533,2519,344,1242,21277
Texas,Bulverde,5104,867,2579,337,1,265,4049
Texas,Blue Ridge,1012,175,393,85,36,25,714
Texas,South Point,1598,320,723,22,37,52,1154
Texas,South Padre Island,2839,494,1658,299,16,154,2621
Texas,Solis,451,111,250,9,0,31,401
Texas,Kenefick,411,86,149,82,9,31,357
Texas,Southlake,30840,5003,16326,1087,94,610,23120
Texas,Saginaw,22873,4613,9576,2195,215,1082,17681
Texas,River Oaks,7683,2393,2797,552,114,429,6285
Texas,Pecan Acres,5670,998,2703,308,71,167,4247
Texas,Asherton,832,233,332,43,33,67,708
Texas,Keller,46175,7916,23763,2248,371,1694,35992
Texas,Millican,214,26,130,14,6,10,186
Texas,San Angelo,99634,27440,35202,9909,1899,5078,79528
Texas,Grape Creek,2701,470,1029,449,81,184,2213
Texas,Mexia,7396,2411,2091,796,167,493,5958
Texas,Kosse,767,230,282,63,2,39,616
Texas,Littlefield,6024,1436,2030,640,87,258,4451
Texas,Clifton,3369,675,1295,360,94,416,2840
Texas,Shady Hollow,4272,729,2506,333,0,149,3717
Texas,Coolidge,846,145,331,76,27,55,634
Texas,Arlington,392462,112819,139842,33954,7370,13556,307541
Texas,Lockhart,13548,3429,4837,1504,285,978,11033
Texas,Barton Creek,2928,369,1925,136,15,142,2587
Texas,Hudson Bend,2059,170,1253,225,12,111,1771
Texas,Weston,305,64,169,32,0,15,280
Texas,East Mountain,1311,313,503,119,59,45,1039
Texas,Murphy,20528,3597,10135,920,212,418,15282
Texas,New London,1037,213,408,148,19,70,858
Texas,Henderson,13355,3776,4127,1505,343,981,10732
Texas,Somerset,1720,522,582,130,43,78,1355
Texas,Olmos Park,1999,507,941,108,30,44,1630
Texas,Leon Valley,11306,3228,4224,1191,26,638,9307
Texas,Hollywood Park,3342,357,2088,33,0,299,2777
Texas,Helotes,8895,1930,4218,590,6,483,7227
Texas,Elmendorf,2077,539,663,168,86,105,1561
Texas,Florence,981,306,385,84,8,24,807
Texas,Zapata,4585,1057,1631,504,54,482,3728
Texas,Falcon Mesa,248,167,81,0,0,0,248
Texas,Liberty Hill,1218,236,464,102,29,56,887
Texas,Groveton,1302,336,418,99,58,115,1026
Texas,Stratford,2108,337,1000,147,77,98,1659
Texas,Mingus,208,60,55,33,5,37,190
Texas,Pinehurst,2289,761,600,430,20,183,1994
Texas,Gilmer,5122,1313,1493,549,97,502,3954
Texas,Shamrock,1934,355,842,222,64,91,1574
Texas,Bowie,5059,740,2504,594,76,184,4098
Texas,St. Jo,930,171,410,99,0,45,725
Texas,Emhouse,162,16,63,36,0,9,124
Texas,Bogata,1190,181,414,190,19,145,949
Texas,Angus,515,98,218,33,20,20,389
Texas,Van Vleck,1286,313,676,53,6,103,1151
Texas,Teague,3533,721,1553,331,51,172,2828
Texas,Kirvin,148,37,59,15,0,6,117
Texas,Comanche,4194,847,1614,468,70,371,3370
Texas,Gallatin,334,49,155,28,2,11,245
Texas,Dilley,4318,2214,928,249,102,147,3640
Texas,Orange,18901,4611,6267,2321,587,1166,14952
Texas,Impact,51,9,30,0,0,3,42
Texas,Omaha,880,167,273,129,38,127,734
Texas,Lone Star,1721,350,765,203,27,72,1417
Texas,Zapata Ranch,100,58,17,15,0,10,100
Texas,Sebastian,1772,632,515,130,48,57,1382
Texas,Santa Monica,15,6,9,0,0,0,15
Texas,Seadrift,1446,348,543,144,2,56,1093
Texas,Bovina,1439,436,471,108,62,46,1123
Texas,Ovilla,3800,396,2341,174,19,97,3027
Texas,Appleby,588,70,260,74,11,33,448
Texas,Tulia,4706,1097,1635,424,197,327,3680
Texas,Alamo,19591,3994,7930,896,454,800,14074
Texas,Wilson,402,87,170,21,18,27,323
Texas,Fort Hood,25365,10503,8132,1038,341,33,20047
Texas,Briarcliff village,1576,233,817,189,8,61,1308
Texas,Lake View,303,0,89,55,0,48,192
Texas,Whitehouse,8303,1802,3546,691,136,178,6353
Texas,New Chapel Hill,873,155,399,111,4,41,710
Texas,Lott,724,196,266,71,3,23,559
Texas,Golinda,614,121,256,44,7,21,449
Texas,Pattison,478,110,224,44,15,18,411
Texas,Woodsboro,1626,410,553,138,57,186,1344
Texas,Blackwell,231,55,135,10,0,9,209
Texas,Wellington,2158,464,919,146,58,129,1716
Texas,Temple,73143,16925,27101,7112,1447,3395,55980
Texas,Belton,21123,6653,6454,1802,501,942,16352
Texas,Luling,5779,1387,2202,514,112,340,4555
Texas,Bryan,83199,27587,26519,6879,1921,3180,66086
Texas,La Vernia,1057,194,476,59,0,93,822
Texas,Christoval,401,59,190,61,0,57,367
Texas,Ozona,2943,663,1296,131,23,145,2258
Texas,Leander,46419,9286,19533,3420,388,1301,33928
Texas,Lago Vista,6730,1167,3530,815,22,271,5805
Texas,West Lake Hills,3314,490,1757,290,6,140,2683
Texas,Encino,44,17,0,0,0,18,35
Texas,Earth,1099,193,445,109,20,71,838
Texas,Mustang Ridge,1185,467,365,96,1,17,946
Texas,West Columbia,3896,752,1793,398,0,193,3136
Texas,Elm Creek,2730,657,947,104,0,118,1826
Texas,Godley,1142,201,426,132,30,49,838
Texas,Catarina,162,93,36,5,10,18,162
Texas,Carrizo Springs,5676,1501,1515,639,155,358,4168
Texas,Vidor,10805,2003,4634,1158,180,625,8600
Texas,New Home,743,154,340,31,3,18,546
Texas,Pecos,9814,2640,3809,475,291,587,7802
Texas,Breckenridge,5479,1087,1925,653,132,417,4214
Texas,Tahoka,2602,509,1024,146,85,221,1985
Texas,Taft,3012,785,1086,273,80,120,2344
Texas,Sinton,5556,1209,1744,563,72,425,4013
Texas,Navarro,193,24,83,18,0,19,144
Texas,Frost,755,132,319,71,30,30,582
Texas,Corsicana,23736,5018,9016,1986,393,1475,17888
Texas,Palacios,4629,1058,1712,454,100,307,3631
Texas,Markham,1469,302,725,39,21,21,1108
Texas,Bronte,945,136,426,98,11,103,774
Texas,Venus,3488,1052,1239,333,98,115,2837
Texas,Dodson,158,32,75,7,2,1,117
Texas,Palmer,2053,435,739,156,73,141,1544
Texas,McCamey,2184,460,781,204,38,75,1558
Texas,Geronimo,798,205,382,74,0,14,675
Texas,Lakeside City,1120,126,580,97,2,62,867
Texas,Pearsall,10252,3865,3369,627,123,443,8427
Texas,Dickinson,20529,4550,9012,1853,199,898,16512
Texas,Cushing,527,74,258,40,19,34,425
Texas,Reklaw,456,125,143,38,7,39,352
Texas,Sanderson,759,122,330,71,35,123,681
Texas,Kermit,6614,1331,2707,550,81,225,4894
Texas,Toyah,77,18,45,5,0,3,71
Texas,Red Oak,12366,2856,4854,1068,191,394,9363
Texas,Cantu Addition,116,46,29,8,0,33,116
Texas,Refugio,2847,676,1024,272,102,208,2282
Texas,Joaquin,956,302,356,91,22,62,833
Texas,Eureka,342,79,159,38,8,13,297
Texas,Airport Road Addition,233,22,56,73,0,20,171
Texas,Woodville,2585,526,809,377,44,369,2125
Texas,Spade,120,18,56,0,9,10,93
Texas,Taft Southwest,980,261,318,133,45,91,848
Texas,Payne Springs,789,169,335,65,18,98,685
Texas,Kempner,1173,226,575,100,23,17,941
Texas,Midway South,2842,701,844,136,35,121,1837
Texas,Evant,493,78,205,61,4,35,383
Texas,Quitman,2272,420,865,327,93,184,1889
Texas,Andrews,13525,2589,5456,1185,203,438,9871
Texas,Skellytown,485,62,216,64,6,37,385
Texas,Wyldwood,2923,614,848,237,149,231,2079
Texas,Chillicothe,764,128,331,69,40,46,614
Texas,Edmonson,76,4,27,13,2,7,53
Texas,Alpine,5992,1490,2045,967,88,280,4870
Texas,Richland Hills,8052,1951,3327,926,114,495,6813
Texas,Vanderbilt,424,109,120,8,8,0,245
Texas,Sanford,151,34,42,23,5,20,124
Texas,La Ward,197,39,99,10,4,15,167
Texas,Megargel,243,38,138,20,10,21,227
Texas,Amherst,796,256,324,48,2,62,692
Texas,Mount Enterprise,534,73,281,36,22,36,448
Texas,Flowella,21,15,0,0,0,6,21
Texas,Scenic Oaks,6106,890,2928,433,0,180,4431
Texas,St. Hedwig,1941,417,925,135,9,116,1602
Texas,Cibolo,27963,5977,12569,1821,250,581,21198
Texas,Taylor,16811,3721,6301,2008,595,1012,13637
Texas,Granger,1321,376,516,138,28,96,1154
Texas,Bartlett,2002,595,657,262,42,143,1699
Texas,Wells,708,170,234,82,34,50,570
Texas,Groom,732,89,328,51,0,67,535
Texas,Sour Lake,1998,321,804,255,53,125,1558
Texas,Fairchilds village,854,159,400,62,14,42,677
Texas,Pleasanton,10450,1857,4017,924,197,565,7560
Texas,Borger,12856,2956,4718,1457,282,575,9988
Texas,Airport Heights,44,13,0,0,0,0,13
Texas,Las Lomas,2786,1034,504,198,208,136,2080
Texas,Fronton,260,35,107,38,11,15,206
Texas,Overton,2741,532,990,321,33,97,1973
Texas,Shavano Park,3667,772,1919,209,16,177,3093
Texas,Leakey,656,126,151,76,4,41,398
Texas,Alamo Heights,8193,1665,3974,528,71,299,6537
Texas,Hutto,23980,4665,9791,2007,279,415,17157
Texas,Georgetown,66804,12357,32661,6332,637,4078,56065
Texas,Morales-Sanchez,38,0,18,0,16,4,38
Texas,Moulton,965,171,427,50,6,124,778
Texas,Watauga,24526,5901,9723,2394,399,735,19152
Texas,Haslet,1661,232,942,95,6,51,1326
Texas,Colleyville,26037,3903,14910,1371,120,847,21151
Texas,Homestead Meadows South,6559,1707,2320,624,186,184,5021
Texas,Nordheim,282,60,145,19,2,24,250
Texas,Everman,6252,1654,2137,510,177,234,4712
Texas,Quanah,2557,330,1079,321,58,172,1960
Texas,Lorenzo,1173,310,417,75,15,55,872
Texas,Round Mountain,230,49,128,22,0,9,208
Texas,Boyd,1360,298,665,80,11,56,1110
Texas,Addison,15626,6039,5225,2133,228,301,13926
Texas,Annetta North,598,95,338,29,2,36,500
Texas,Bartonville,1839,299,941,141,14,35,1430
Texas,Westworth Village,2653,581,1028,254,93,184,2140
Texas,Webberville village,468,119,185,48,5,11,368
Texas,Patton Village,1491,423,508,102,83,61,1177
Texas,Estelline,100,9,24,28,0,15,76
Texas,Harper,1012,160,426,56,32,63,737
Texas,Llano,3429,823,957,572,168,222,2742
Texas,Shoreacres,1630,369,701,206,7,76,1359
Texas,Tuscola,683,89,335,50,13,36,523
Texas,Piney Point Village,3419,529,2197,65,0,81,2872
Texas,Missouri City,73573,18305,31055,5947,1619,2908,59834
Texas,Mission Bend,39291,12368,15173,2167,862,1192,31762
Texas,Ranchette Estates,207,32,97,0,0,0,129
Texas,Lyford,2581,740,886,150,86,140,2002
Texas,Point Comfort,757,251,217,60,6,31,565
Texas,Menard,1562,320,692,228,20,74,1334
Texas,Seagoville,16357,4183,5054,2123,518,764,12642
Texas,Lancaster,39162,11098,11652,4175,964,1064,28953
Texas,Irving,238637,65179,89060,17739,4248,6509,182735
Texas,Nassau Bay,4083,886,1895,542,87,161,3571
Texas,Bigfoot,286,20,244,22,0,0,286
Texas,Seagraves,2774,658,951,140,68,91,1908
Texas,Seminole,7460,1191,2958,741,89,455,5434
Texas,Petersburg,1039,212,481,64,24,63,844
Texas,West Odessa,26278,5129,9873,2118,518,1086,18724
Texas,Odessa,118582,29656,41528,10560,2405,5291,89440
Texas,Hamlin,1740,268,709,114,38,93,1222
Texas,Rio Grande City,14415,3991,4131,1208,858,710,10898
Texas,North Escobares,109,6,45,0,38,0,89
Texas,Los Alvarez,281,173,102,6,0,0,281
Texas,Groves,15760,3263,6788,1554,134,972,12711
Texas,Anderson,223,58,87,23,14,13,195
Texas,Bangs,1470,234,626,211,25,125,1221
Texas,Wharton,8718,2751,2627,954,98,585,7015
Texas,Deport,669,113,252,82,14,77,538
Texas,Fritch,2503,730,912,182,46,121,1991
Texas,Grandview,2203,430,799,269,34,130,1662
Texas,Cleburne,29878,6573,11288,3356,771,1668,23656
Texas,Pleasant Valley,323,58,164,42,0,19,283
Texas,Brookshire,5199,1811,1509,378,194,221,4113
Texas,Damon,269,69,68,68,12,13,230
Texas,Hereford,14938,3320,5508,987,458,649,10922
Texas,Seth Ward,2054,568,736,169,67,76,1616
Texas,Tulsita,0,0,0,0,0,0,0
Texas,Annetta,3014,458,1667,160,0,56,2341
Texas,Sanctuary,305,56,131,35,6,20,248
Texas,Rankin,940,152,458,83,4,40,737
Texas,Mason,2109,575,562,237,90,195,1659
Texas,Whitney,2118,497,594,250,52,226,1619
Texas,Mount Calm,331,29,98,78,17,11,233
Texas,Mertens,124,13,55,22,0,8,98
Texas,Garden Ridge,3887,391,2530,123,0,79,3123
Texas,South Mountain,432,83,223,50,9,22,387
Texas,Quitaque,447,92,192,31,6,38,359
Texas,Las Lomitas,133,10,55,16,0,0,81
Texas,Windthorst,334,65,194,14,1,33,307
Texas,Mineral Wells,15041,3958,4845,1472,634,884,11793
Texas,Realitos,280,65,72,46,24,39,246
Texas,New Falcon,330,53,82,23,0,40,198
Texas,Big Lake,3324,789,1338,182,30,101,2440
Texas,New Waverly,1067,328,367,46,40,36,817
Texas,Point,830,189,272,129,24,37,651
Texas,Coyanosa,209,50,116,6,0,0,172
Texas,O'Brien,101,31,41,10,0,14,96
Texas,Henrietta,3018,611,1240,244,114,231,2440
Texas,Dickens,276,40,136,32,0,27,235
Texas,Eldorado,2348,369,1038,157,57,120,1741
Texas,Cooper,2213,497,744,212,44,173,1670
Texas,Iowa Park,6350,883,3139,405,60,349,4836
Texas,Prairie View,6337,5458,342,78,36,97,6011
Texas,Olney,3138,614,1350,295,112,245,2616
Texas,Rio Hondo,2607,576,1013,234,71,178,2072
Texas,El Lago,2760,553,1190,383,26,126,2278
Texas,New Boston,4694,1180,1745,603,137,379,4044
Texas,Garceno,480,52,283,0,0,0,335
Texas,Coldspring,984,269,316,123,24,86,818
Texas,Windcrest,5802,1609,2306,641,51,492,5099
Texas,Grey Forest,428,57,219,74,2,29,381
Texas,Castle Hills,4422,776,1980,396,59,299,3510
Texas,Balcones Heights,3185,956,666,591,178,106,2497
Texas,Haltom City,44275,11718,15301,3936,1019,1445,33419
Texas,Santa Anna,1174,310,367,181,61,49,968
Texas,Lackland AFB,6454,4197,1340,74,0,0,5611
Texas,Kirby,8625,2408,2848,999,156,449,6860
Texas,Hill Country Village,679,156,361,32,0,27,576
Texas,Camp Wood,1041,349,248,179,2,91,869
Texas,Thrall,779,176,269,69,0,34,548
Texas,Matador,805,147,296,65,10,46,564
Texas,Waelder,1282,329,484,106,9,52,980
Texas,Lozano,234,93,46,24,0,0,163
Texas,Primera,4742,1141,1806,219,82,145,3393
Texas,Rancho Viejo,2832,540,1405,130,28,185,2288
Texas,Villa Pancho,457,109,127,0,0,96,332
Texas,Scotland,471,91,187,44,3,30,355
Texas,Austwell,120,19,62,26,2,7,116
Texas,Redford,105,6,18,0,16,5,45
Texas,Presidio,4067,924,1771,129,109,362,3295
Texas,Graford,709,159,319,64,9,29,580
Texas,Rose City,419,84,190,27,4,25,330
Texas,Italy,1858,334,719,237,32,70,1392
Texas,Morgan,509,107,199,44,10,34,394
Texas,Cranfills Gap,368,78,161,39,4,27,309
Texas,Electra,2721,597,1053,454,25,244,2373
Texas,Falcon Lake Estates,995,322,525,14,0,10,871
Texas,St. Paul,790,240,266,116,34,48,704
Texas,Lakeshore Gardens-Hidden Acres,952,197,443,50,0,35,725
Texas,Nacogdoches,33610,14672,8660,2297,722,1460,27811
Texas,Princeton,9765,1948,4324,722,236,321,7551
Texas,Nevada,814,137,412,40,8,30,627
Texas,Big Sandy,1747,472,490,239,37,116,1354
Texas,Gunter,1189,223,453,122,8,135,941
Texas,Plum Grove,588,116,229,74,5,12,436
Texas,Liberty,9103,1483,4245,548,138,390,6804
Texas,Sterling City,994,134,379,125,81,39,758
Texas,Aguilares,0,0,0,0,0,0,0
Texas,Muniz,1443,511,519,97,68,0,1195
Texas,San Saba,3116,850,990,324,106,166,2436
Texas,Coppell,41512,7255,21797,2582,270,1002,32906
Texas,Dallas,1318806,423144,417027,110661,34580,47058,1032470
Texas,Devine,4721,940,1714,519,145,203,3521
Texas,Natalia,1198,369,432,32,19,132,984
Texas,Dalhart,8545,1659,3681,532,129,291,6292
Texas,San Leanna village,563,96,332,45,4,12,489
Texas,Jonestown,2036,348,1050,214,20,110,1742
Texas,Chico,1282,251,504,160,28,27,970
Texas,Manor,8595,1876,2786,796,122,156,5736
Texas,Round Rock,120157,30033,47078,11152,1621,3220,93104
Texas,The Hills village,2559,390,1521,133,0,85,2129
Texas,Big Wells,850,291,246,121,19,50,727
Texas,Avinger,251,42,103,39,0,30,214
Texas,Linden,2088,459,799,252,42,207,1759
Texas,Lefors,637,71,224,116,9,26,446
Texas,Meridian,1621,348,543,238,8,74,1211
Texas,Sanger,8023,1626,3397,753,130,382,6288
Texas,Bridgeport,6406,1942,2258,494,207,252,5153
Texas,Caddo Mills,1731,333,708,170,26,46,1283
Texas,Carrollton,133438,34143,56608,10681,2359,4427,108218
Texas,Riesel,1073,135,463,111,21,44,774
Texas,Dean,490,52,279,34,0,29,394
Texas,Petrolia,720,102,305,101,11,68,587
Texas,Goliad,2084,477,712,206,16,206,1617
Texas,Clear Lake Shores,1140,249,561,167,9,74,1060
Texas,Plains,1180,243,525,72,39,50,929
Texas,Batesville,1274,410,240,87,63,100,900
Texas,Trent,324,85,140,23,2,33,283
Texas,Itasca,1373,197,493,162,84,129,1065
Texas,New Braunfels,74587,15829,31105,6872,1277,3335,58418
Texas,Schertz,38991,7960,16910,3668,494,1683,30715
Texas,Hillsboro,8333,2575,2429,814,210,455,6483
Texas,Calvert,1249,413,355,123,25,92,1008
Texas,Van Horn,1894,565,631,198,50,141,1585
Texas,Port Mansfield,88,4,62,14,0,8,88
Texas,Sun Valley,72,18,13,6,0,4,41
Texas,Crosbyton,1781,457,690,130,58,91,1426
Texas,Marlin,5653,1940,1479,460,245,420,4544
Texas,Beverly Hills,2398,681,705,244,50,92,1772
Texas,Graham,8746,1598,3698,696,91,753,6836
Texas,McAllen,141597,35059,52466,10600,3703,5631,107459
Texas,Angleton,19410,4628,6911,2161,276,1115,15091
Texas,Alice Acres,188,17,74,0,0,31,122
Texas,Roxton,677,207,173,101,29,44,554
Texas,Abram,1979,477,617,221,51,89,1455
Texas,Wylie,49248,9740,20939,3271,930,1272,36152
Texas,La Porte,35386,7808,15339,3545,526,1255,28473
Texas,Taylor Lake Village,3668,663,2021,194,22,144,3044
Texas,Butterfield,4,0,0,4,0,0,4
Texas,West Sharyland,1931,580,697,72,120,30,1499
Texas,El Paso,680354,182693,238324,58010,18067,31095,528189
Texas,San Felipe,809,278,244,83,36,44,685
Texas,Needville,3063,557,1067,514,28,203,2369
Texas,Horizon City,19479,4394,7655,1120,322,298,13789
Texas,Lake Worth,4919,896,1908,679,80,243,3806
Texas,Webster,11165,4096,2725,1479,304,483,9087
Texas,Houston,2295982,741094,747071,178659,57871,83910,1808605
Texas,Savoy,824,140,341,105,16,120,722
Texas,Wilmer,4185,1406,1064,345,156,69,3040
Texas,Pampa,17793,3500,7101,1580,393,1091,13665
Texas,Shenandoah,2817,261,1528,365,39,349,2542
Texas,Aurora,1498,239,597,173,24,65,1098
Texas,Cresson,864,135,396,81,42,61,715
Texas,deCordova,2860,162,1911,115,0,217,2405
Texas,East Bernard,2668,631,975,189,70,182,2047
Texas,Gun Barrel City,6057,1114,2883,710,28,418,5153
Texas,Meadows Place,4677,1011,2198,509,0,272,3990
Texas,Niederwald,505,110,215,54,4,31,414
Texas,Scurry,505,89,225,73,10,17,414
Texas,Iola,260,53,126,25,7,14,225
Texas,Spring Valley Village,4239,590,2223,227,0,165,3205
Texas,Von Ormy,1128,279,345,88,46,34,792
Texas,Weston Lakes,3490,338,2359,149,21,143,3010
Texas,De Kalb,1700,407,574,148,47,211,1387
Texas,Maud,1096,193,388,90,42,69,782
Texas,Port Aransas,4060,613,2050,613,136,284,3696
Texas,Rancho Banquete,838,137,434,15,72,0,658
Texas,Three Rivers,1780,514,682,135,7,67,1405
Texas,Pharr,77835,18494,27403,4306,1893,2996,55092
Texas,San Marcos,61751,35470,12955,3895,805,1438,54563
Texas,Columbus,3612,845,1355,414,17,292,2923
Texas,Port Arthur,55249,15876,17530,4572,1301,2964,42243
Texas,Converse,26246,6282,9283,2575,487,685,19312
Texas,Amarillo,198773,44500,75546,19460,4214,9385,153105
Texas,Timberwood Park,25976,4978,11998,1615,294,609,19494
Texas,Whiteface,302,79,146,15,1,16,257
Texas,Bedias,334,37,177,22,5,27,268
Texas,Escobares,2529,680,637,175,95,74,1661
Texas,Horseshoe Bay,3587,264,2369,439,12,299,3383
Texas,China Grove,1241,328,679,114,4,55,1180
Texas,Lone Oak,683,195,224,99,2,25,545
Texas,Hermleigh,503,80,280,21,5,30,416
Texas,Alvarado,4044,587,1568,410,124,271,2960
Texas,Burleson,44629,7719,19756,3935,827,1564,33801
Texas,Eidson Road,9531,2338,3701,525,223,298,7085
Texas,El Indio,23,0,0,0,0,23,23
Texas,Kerens,1735,363,522,247,44,151,1327
Texas,Ingleside on the Bay,881,113,527,65,13,42,760
Texas,Point Venture village,1194,186,595,134,0,27,942
Texas,Weir,341,78,152,24,3,10,267
Texas,Brushy Creek,20024,4552,9135,1701,80,420,15888
Texas,Siesta Shores,1477,281,378,113,41,59,872
Texas,Cedar Hill,48704,12981,17240,4543,698,1610,37072
Texas,Tatum,1081,168,485,127,2,63,845
Texas,El Refugio,372,100,92,3,24,10,229
Texas,Falcon Village,0,0,0,0,0,0,0
Texas,Roma,11363,2635,4032,554,450,814,8485
Texas,Red Lick,1069,184,513,87,11,35,830
Texas,Wake Village,5435,1132,2117,531,99,215,4094
Texas,Barrett,3691,1244,1317,194,138,190,3083
Texas,Bunker Hill Village,3966,670,2225,101,11,70,3077
Texas,Crosby,2542,584,1124,78,112,65,1963
Texas,Galena Park,11075,3061,3819,584,259,395,8118
Texas,Hilshire Village,873,108,521,41,0,37,707
Texas,Katy,18094,3291,8722,1095,357,713,14178
Texas,Sansom Park,5250,1512,1287,524,162,250,3735
Texas,Trophy Club,11790,1682,6014,871,77,247,8891
Texas,Westover Hills,533,49,336,11,0,37,433
Texas,Hallettsville,2605,664,822,303,57,263,2109
Texas,Lake City,535,128,251,42,4,71,496
Texas,Springtown,2850,521,1308,257,30,96,2212
Texas,Noonday,514,88,267,29,12,49,445
Texas,La Feria,7329,1881,2632,422,230,335,5500
Texas,New Summerfield,800,224,279,20,8,44,575
Texas,Streetman,295,65,137,23,0,26,251
Texas,Valentine,63,12,27,9,0,9,57
Texas,Roby,687,161,220,51,25,49,506
Texas,Lakeport,1120,291,382,123,30,41,867
Texas,Liberty City,2039,322,1044,156,49,124,1695
Texas,Crowell,799,161,331,69,3,109,673
Texas,Aransas Pass,8113,1618,3199,892,208,487,6404
Texas,Cuney,46,16,11,4,0,4,35
Texas,Cross Mountain,3798,642,2019,270,0,61,2992
Texas,Live Oak,15595,4103,5414,1723,294,802,12336
Texas,Canyon,15182,5578,5098,1197,256,614,12743
Texas,Universal City,20265,5020,7656,2537,346,728,16287
Texas,Morton,1937,423,675,129,46,147,1420
Texas,Novice,44,3,16,13,0,12,44
Texas,Shepherd,3296,663,1210,327,67,152,2419
Texas,Terrell Hills,5330,823,2528,305,35,154,3845
Texas,Radar Base,283,130,111,8,17,17,283
Texas,Mansfield,67492,13839,31221,4495,675,1602,51832
Texas,Easton,373,94,143,53,6,29,325
Texas,San Benito,24466,7084,7075,2289,618,1243,18309
Texas,Tierra Bonita,112,81,8,0,0,0,89
Texas,Fort Davis,1029,141,526,133,21,11,832
Texas,Porter Heights,1206,72,793,187,0,41,1093
Texas,Rollingwood,1569,189,857,63,0,53,1162
Texas,Miller's Cove,209,17,87,0,0,0,104
Texas,Garfield,1533,268,696,90,18,65,1137
Texas,Olton,2005,443,729,175,36,150,1533
Texas,Springlake,72,4,45,17,0,2,68
Texas,Groesbeck,4310,1047,1526,399,51,311,3334
Texas,Thornton,665,172,248,42,25,49,536
Texas,Garrison,1243,215,428,84,2,99,828
Texas,Higgins,555,81,199,65,13,55,413
Texas,Dimmitt,4251,867,1471,623,25,174,3160
Texas,Ennis,19196,4551,7278,1572,197,903,14501
Texas,Pecan Plantation,5987,783,3934,297,0,457,5471
Texas,Forsan,224,25,104,27,0,10,166
Texas,Del Rio,35921,8336,14013,2394,663,1920,27326
Texas,Vernon,10685,2554,3914,1387,126,757,8738
Texas,Lucas,7217,1156,3636,299,51,213,5355
Texas,Fair Oaks Ranch,10857,2213,5610,572,94,413,8902
Texas,Jayton,662,107,263,59,8,105,542
Texas,Midway,296,41,105,32,9,14,201
Texas,Toco,104,24,35,4,2,18,83
Texas,George West,2579,750,598,268,108,253,1977
Texas,Edna,5784,1375,2162,484,170,275,4466
Texas,Ganado,2056,516,799,201,12,96,1624
Texas,Lake Bridgeport,410,48,146,54,27,15,290
Texas,Girard,11,0,11,0,0,0,11
Texas,New Fairview,1273,276,540,144,7,62,1029
Texas,Cockrell Hill,4268,1212,1488,241,121,120,3182
Texas,Combine,1832,340,850,144,17,103,1454
Texas,Rowlett,62127,12616,30517,4210,576,1958,49877
Texas,LaCoste,1303,324,519,169,16,83,1111
Texas,Friona,3936,899,1692,124,61,171,2947
Texas,Texline,386,39,181,57,9,20,306
Texas,Mobile City,134,33,31,20,2,5,91
Texas,Balch Springs,25312,6640,8262,1687,511,714,17814
Texas,Chandler,2959,418,1401,325,29,269,2442
Texas,Paloma Creek South,6624,1587,2668,685,28,249,5217
Texas,Paloma Creek,3340,301,1593,213,21,61,2189
Texas,Moraida,41,30,0,0,0,0,30
Texas,Morgan Farm,378,54,185,18,11,28,296
Texas,Murillo,6236,1662,2139,284,111,170,4366
Texas,Myrtle Springs,606,51,324,20,107,60,562
Texas,Narciso Pena,0,0,0,0,0,0,0
Texas,Netos,0,0,0,0,0,0,0
Texas,Nina,20,0,0,8,0,0,8
Texas,Nocona Hills,770,36,544,62,0,69,711
Texas,Oakhurst,378,68,164,146,0,0,378
Texas,Oak Island,379,68,197,24,0,43,332
Texas,Olivia Lopez de Gutierrez,25,0,0,12,0,13,25
Texas,Olmito and Olmito,336,56,114,0,0,6,176
Texas,Orason,32,18,14,0,0,0,32
Texas,Owl Ranch,112,0,66,0,0,14,80
Texas,Pablo Pena,16,0,16,0,0,0,16
Texas,Paisano Park,86,8,53,0,0,0,61
Texas,Palo Blanco,80,21,17,0,0,20,58
Texas,Imperial,285,96,99,16,6,8,225
Texas,Montague,331,84,101,42,9,31,267
Texas,Ballinger,3669,660,1480,513,63,370,3086
Texas,Fort Stockton,8414,1991,3373,527,254,372,6517
Texas,Inez,2604,402,1382,95,18,69,1966
Texas,Victoria,66939,16720,24237,6585,1312,3523,52377
Texas,Browndell,304,78,97,40,0,57,272
Texas,Jamaica Beach,1138,287,491,147,17,60,1002
Texas,Botines,22,0,0,0,0,22,22
Texas,Laredo Ranchettes,72,30,0,0,30,0,60
Texas,Mirando City,381,68,133,15,11,11,238
Texas,Elkhart,1399,276,407,259,19,114,1075
Texas,Ranchitos Las Lomas,308,61,192,33,0,0,286
Texas,Howardwick,395,62,167,40,5,33,307
Texas,Copper Canyon,1235,189,788,58,0,42,1077
Texas,Vega,939,153,473,109,5,33,773
Texas,Van,2649,516,1044,217,52,197,2026
Texas,Winfield,356,69,146,18,4,12,249
Texas,Laughlin AFB,2147,644,1016,34,0,0,1694
Texas,Lockney,1698,363,741,167,30,64,1365
Texas,Hartley,568,58,299,24,10,19,410
Texas,Bastrop,8736,2004,3860,766,233,409,7272
Texas,Marathon,395,54,251,45,3,10,363
Texas,Benavides,1840,624,513,217,23,143,1520
Texas,Cameron Park,6226,1758,2178,227,220,141,4524
Texas,Combes,3031,733,1147,229,49,134,2292
Texas,Laguna Vista,3171,618,1577,347,9,160,2711
Texas,San Pedro,334,68,108,68,0,12,256
Texas,Cleveland,7998,2485,2479,801,155,537,6457
Texas,Bells,1385,264,565,120,16,69,1034
Texas,Collinsville,1653,304,675,164,23,95,1261
Texas,Denison,23820,4534,8981,3264,551,1797,19127
Texas,Howe,2945,643,1167,345,60,96,2311
Texas,Tom Bean,1155,173,459,168,12,59,871
Texas,Ransom Canyon,1056,109,664,96,0,35,904
Texas,Wolfforth,4582,939,1904,447,32,73,3395
Texas,Anna,12271,2233,4970,693,78,391,8365
Texas,Farmersville,3469,526,1500,389,108,333,2856
Texas,Lowry Crossing,1502,290,834,118,8,41,1291
Texas,Retreat,440,48,202,20,11,20,301
Texas,Seven Oaks,74,8,20,29,0,13,70
Texas,Seymour,2844,474,1230,219,83,259,2265
Texas,Mi Ranchito Estate,347,93,25,52,0,0,170
Texas,Mikes,877,143,232,0,168,13,556
Texas,Miguel Barrera,204,3,87,0,0,0,90
Texas,Caney City,134,33,65,12,7,12,129
Texas,Nederland,17371,4146,7223,1473,175,1150,14167
Texas,Rancho Chico,548,213,131,59,0,0,403
Texas,Tradewinds,206,60,74,44,0,0,178
Texas,Tyler,103721,29181,35796,10654,1545,5666,82842
Texas,Cedar Park,72415,15392,30661,5809,778,1970,54610
Texas,Sunset Valley,547,87,287,26,1,19,420
Texas,Ravenna,193,14,83,24,0,36,157
Texas,Falfurrias,4644,1442,1129,348,307,210,3436
Texas,Sudan,942,178,367,97,29,57,728
Texas,Darrouzett,430,62,192,34,1,26,315
Texas,Lipscomb,38,6,24,5,3,0,38
Texas,Manvel,9143,2059,3686,661,39,245,6690
Texas,Sealy,6441,1359,2418,524,242,418,4961
Texas,Danbury,1391,347,582,124,11,92,1156
Texas,Lake Jackson,27377,5656,12278,2055,217,1224,21430
Texas,Iredell,352,57,169,21,4,27,278
Texas,Marble Falls,6382,1416,1769,1046,63,804,5098
Texas,South Alamo,3731,1157,889,139,148,74,2407
Texas,Progreso,5905,1403,2668,177,58,92,4398
Texas,Fayetteville,204,31,118,24,4,16,193
Texas,Channing,265,57,108,28,1,11,205
Texas,Tye,1273,325,470,80,40,58,973
Texas,Goodrich,265,49,136,12,16,7,220
Texas,Ropesville,300,81,105,32,11,25,254
Texas,Bellevue,360,74,141,33,7,30,285
Texas,Dumas,14597,3169,5542,1154,180,598,10643
Texas,Cove,365,98,181,9,12,21,321
Texas,Camp Swift,6553,2022,2187,877,102,285,5473
Texas,Friendswood,39319,6585,19191,2677,443,1790,30686
Texas,Kingsland,6853,1165,3192,617,166,782,5922
Texas,Talco,816,129,267,79,17,49,541
Texas,Pecan Hill,744,179,380,50,9,21,639
Texas,Lindsay,459,110,128,74,34,7,353
Texas,Archer City,1772,386,555,240,30,153,1364
Texas,Maypearl,781,138,303,101,15,22,579
Texas,Palmview,5740,1358,2010,314,323,381,4386
Texas,Richwood,3851,831,1605,255,44,61,2796
Texas,Elsa,7142,1831,2209,400,217,327,4984
Texas,Junction,2436,460,937,327,29,181,1934
Texas,Kingsville,25782,9626,7384,1530,616,1310,20466
Texas,Los Minerales,33,10,23,0,0,0,33
Texas,Los Fresnos,93,8,55,0,8,0,71
Texas,Los Huisaches,13,0,13,0,0,0,13
Texas,Los Lobos,0,0,0,0,0,0,0
Texas,Los Nopalitos,79,11,19,0,0,0,30
Texas,Los Veteranos I,0,0,0,0,0,0,0
Texas,Los Veteranos II,31,0,13,12,0,6,31
Texas,McDade,748,190,241,84,12,24,551
Texas,Macdona,240,14,93,41,0,41,189
Texas,McKinney Acres,1021,284,308,85,39,70,786
Texas,Manchaca,1031,144,425,173,0,30,772
Texas,Manuel Garcia,478,69,224,0,0,5,298
Texas,Manuel Garcia II,0,0,0,0,0,0,0
Texas,Martinez,0,0,0,0,0,0,0
Texas,Matagorda,317,34,157,34,5,46,276
Texas,Mentone,33,3,14,16,0,0,33
Texas,Mesquite,338,94,141,22,0,32,289
Texas,Los Ebanos CDP (Starr County),582,257,132,74,0,20,483
Texas,Rhome,1737,322,721,175,33,104,1355
Texas,Los Ebanos CDP (Hidalgo County),112,0,47,37,0,28,112
Texas,San Elizario,9197,2201,3312,476,228,399,6616
Texas,College Station,110782,57575,30129,4762,737,1993,95196
Texas,Alton,16566,4292,5436,948,364,579,11619
Texas,Heidelberg,1385,274,426,17,27,124,868
Texas,Hidalgo,13760,3633,4978,654,488,407,10160
Texas,Lopezville,3212,849,1300,103,45,91,2388
Texas,Mission,83709,18439,31080,5233,2186,2909,59847
Texas,Monte Alto,2029,589,644,90,102,95,1520
Texas,North Alamo,4447,979,1644,152,39,215,3029
Texas,Palmhurst,2698,658,1243,109,10,160,2180
Texas,Sullivan City,4141,921,1549,194,196,162,3022
Texas,Villa Verde,374,91,137,0,40,106,374
Texas,Bertram,1731,482,688,165,11,83,1429
Texas,Highland Haven,523,38,375,25,3,54,495
Texas,E. Lopez,210,65,79,10,0,0,154
Texas,J.F. Villareal,0,0,0,0,0,0,0
Texas,Lago Vista,39,13,26,0,0,0,39
Texas,Ranchitos del Norte,1083,232,429,0,0,0,661
Texas,Los Corralitos,69,0,69,0,0,0,69
Texas,Alvord,1165,244,435,118,32,24,853
Texas,Reno city (Lamar County),3272,328,1899,316,46,114,2703
Texas,Jacksboro,4383,1345,1563,423,98,228,3657
Texas,Onalaska,2714,400,1088,530,42,73,2133
Texas,Oak Ridge town (Cooke County),177,53,56,22,10,5,146
Texas,Hurst,38986,8719,15846,4124,427,1409,30525
Texas,Briar,4685,920,2070,608,41,476,4115
Texas,Hudson Oaks,2351,347,1262,288,8,57,1962
Texas,Forest Hill,12913,3668,3960,1118,345,584,9675
Texas,Kennedale,7998,1688,3774,590,42,306,6400
Texas,Port Neches,12853,2368,6155,1170,144,559,10396
Texas,Millsap,260,49,126,30,2,9,216
Texas,El Cenizo,3248,860,837,206,137,140,2180
Texas,Rio Bravo,4791,978,1642,210,162,220,3212
Texas,Hudson,4864,921,1636,623,134,218,3532
Texas,Clyde,3801,797,1483,297,25,149,2751
Texas,Flatonia,1556,419,626,185,6,54,1290
Texas,Double Oak,3065,602,1805,103,0,45,2555
Texas,Lakewood Village,479,81,265,58,11,21,436
Texas,Riverside,475,66,178,57,16,82,399
Texas,Oak Grove,779,142,383,49,4,38,616
Texas,Cottonwood,222,39,132,9,8,7,195
Texas,Navasota,7432,2145,2641,445,201,328,5760
Texas,Crockett,6534,1935,1692,693,249,549,5118
Texas,Mount Vernon,2746,643,985,381,20,240,2269
Texas,Abilene,123676,36115,42439,12092,3128,5579,99353
Texas,Lueders,205,22,65,42,11,16,156
Texas,Driscoll,612,219,169,17,4,35,444
Texas,Hungerford,141,0,79,24,0,0,103
Texas,Rocksprings,1401,318,561,92,14,140,1125
Texas,San Diego,4109,1096,996,491,97,348,3028
Texas,Beckville,928,198,334,77,39,53,701
Texas,Gary City,397,75,167,13,0,22,277
Texas,Sabinal,1655,304,543,121,11,146,1125
Texas,Beeville,13044,3004,4455,1255,367,678,9759
Texas,Normanna,138,42,70,3,0,15,130
Texas,Pawnee,151,19,79,11,0,15,124
Texas,Fulton,1451,187,741,155,66,141,1290
Texas,Marshall,23315,5956,8375,2089,417,1434,18271
Texas,Uncertain,59,18,22,9,4,6,59
Texas,Broaddus,269,62,122,16,1,3,204
Texas,Woodcreek,1543,232,776,223,30,155,1416
Texas,Sonora,3330,492,1563,380,55,108,2598
Texas,Snyder,11456,2556,4462,796,241,617,8672
Texas,Arroyo Colorado Estates,567,184,254,12,0,19,469
Texas,Bixby,471,83,262,0,0,0,345
Texas,Lasana,137,10,80,0,12,0,102
Texas,Diboll,5308,1199,1746,685,208,289,4127
Texas,Highland Village,16342,3061,8896,731,75,509,13272
Texas,Justin,3660,572,1689,381,66,186,2894
Texas,Krum,4973,899,2390,481,21,83,3874
Texas,Sandy Hollow-Escondidas,301,90,146,29,0,19,284
Texas,Lake Dallas,7832,1446,3314,917,117,228,6022
Texas,Ponder,1973,341,798,244,23,72,1478
Texas,Lufkin,35874,9058,12479,3271,910,2407,28125
Texas,El Campo,11670,2410,4383,863,239,644,8539
Texas,Blanket,346,69,137,34,9,22,271
Texas,Brownwood,18820,4446,7170,1964,297,1117,14994
Texas,Spring,58756,14809,23646,4524,974,1602,45555
Texas,Lake Brownwood,1383,185,470,143,107,153,1058
Texas,Oak Point,3878,479,2245,301,0,111,3136
Texas,La Paloma-Lost Creek,586,91,223,16,0,3,333
Texas,Warren City,362,56,171,26,5,21,279
Texas,Gladewater,6085,1568,1703,750,122,598,4741
Texas,Crowley,15189,3556,5966,1349,233,326,11430
Texas,Joshua,7106,1144,2876,735,202,459,5416
Texas,Robert Lee,1134,116,601,143,4,65,929
Texas,Bay City,17681,3811,6501,1501,410,1015,13238
Texas,Mildred,474,91,194,39,3,30,357
Texas,Detroit,921,215,303,102,22,48,690
Texas,Heath,8410,1741,4728,236,19,301,7025
Texas,Albany,1840,459,705,145,23,141,1473
Texas,Barstow,522,88,181,43,2,26,340
Texas,Nazareth,300,51,133,19,5,13,221
Texas,Milford,732,142,256,107,24,44,573
Texas,Balmorhea,609,137,240,91,0,32,500
Texas,Texhoma,350,72,127,86,18,35,338
Texas,Trinity,2754,675,858,367,119,228,2247
Texas,Burkburnett,11170,2130,4805,1225,131,831,9122
Texas,Portland,16865,3557,7442,1306,184,681,13170
Texas,Lincoln Park,78,11,27,20,0,5,63
Texas,Doolittle,3531,688,1175,76,151,69,2159
Texas,Kenedy,3433,1177,1041,281,8,266,2773
Texas,Moody,1640,410,534,212,36,89,1281
Texas,Wimberley,2923,339,1670,294,22,272,2597
Texas,Madisonville,4631,786,1692,465,74,405,3422
Texas,Agua Dulce,3061,1015,733,227,55,93,2123
Texas,Rangerville village,47,0,14,33,0,0,47
Texas,North Cleveland,235,40,106,24,3,8,181
Texas,Prosper,19103,2952,9366,734,61,286,13399
Texas,St. Paul,1017,160,519,63,6,31,779
Texas,Ore City,1109,260,326,151,34,80,851
Texas,Union Grove,457,94,203,17,15,36,365
Texas,Havana,411,119,122,73,0,58,372
Texas,La Villa,2655,630,910,163,90,108,1901
Texas,Mercedes,16648,4051,5635,1076,650,823,12235
Texas,Willow Park,5110,736,2916,213,0,161,4026
Texas,Weimar,2356,654,970,98,33,219,1974
Texas,Ross,262,59,119,29,2,28,237
Texas,Karnes City,3367,938,973,313,107,191,2522
Texas,Kyle,39857,8447,16555,3388,426,925,29741
Texas,La Joya,4268,947,1276,282,164,144,2813
Texas,Willis,6408,1678,1792,690,109,180,4449
Texas,Fredericksburg,11157,2012,4969,1002,61,1001,9045
Texas,Fairfield,2922,603,1050,332,44,247,2276
Texas,Moran,290,33,89,66,15,42,245
Texas,Ingleside,10050,2312,4047,908,67,335,7669
Texas,Hackberry,1805,377,753,164,5,44,1343
Texas,Mount Pleasant,16100,4158,5660,1197,442,660,12117
Texas,Center,5319,1858,1200,259,52,478,3847
Texas,Claude,1274,167,680,109,9,77,1042
Texas,Arp,941,197,367,66,10,69,709
Texas,Val Verde Park,2665,467,1088,165,66,149,1935
Texas,Creedmoor,185,48,74,16,5,11,154
Texas,Pflugerville,59757,13766,25936,4660,843,1591,46796
Texas,K-Bar Ranch,588,287,26,151,0,0,464
Texas,Benjamin,200,15,98,11,10,27,161
Texas,De Leon,2470,510,1018,278,24,172,2002
Texas,West University Place,15619,2070,8473,558,93,454,11648
Texas,Humble,15861,4615,4895,2230,558,353,12651
Texas,Hunters Creek Village,4814,727,2684,74,13,181,3679
Texas,Post,5369,1787,2013,365,318,240,4723
Texas,Hamilton,2957,383,1315,245,71,329,2343
Texas,Lindale,5809,1005,2500,643,135,510,4793
Texas,Linn,604,99,196,112,15,63,485
Texas,Loma Grande,99,37,25,0,0,23,85
Texas,Villa del Sol,271,95,110,0,0,0,205
Texas,Nolanville,5330,1221,1926,454,145,96,3842
Texas,Pine Island,1121,171,463,130,18,63,845
Texas,Killeen,143070,32783,54898,11577,2852,3833,105943
Texas,Little River-Academy,1852,388,773,192,20,82,1455
Texas,Troy,2302,422,899,210,28,82,1641
Texas,Quail,10,0,10,0,0,0,10
Texas,Samnorwood,37,0,15,0,0,0,15
Texas,Roscoe,1378,352,642,107,0,34,1135
Texas,Brazos Country,577,95,346,19,11,19,490
Texas,Cashion Community,274,26,146,31,0,24,227
Texas,Hideaway,3097,372,1943,211,48,306,2880
Texas,Jarrell,1299,261,577,142,9,27,1016
Texas,Kurten,454,90,185,47,7,2,331
Texas,Petronilla,145,32,60,4,9,7,112
Texas,Salado village,2897,443,1466,195,56,70,2230
Texas,San Ygnacio,547,94,266,46,38,0,444
Texas,Reid Hope King,1081,226,433,0,0,65,724
Texas,Coleman,4398,509,2016,393,134,395,3447
Texas,Port Isabel,5057,1166,2034,470,90,352,4112
Texas,Santa Maria,732,243,222,49,8,13,535
Texas,Loma Linda,274,0,145,0,0,0,145
Texas,Loma Linda East CDP (Jim Wells County),271,101,170,0,0,0,271
Texas,Loma Linda East CDP (Starr County),0,0,0,0,0,0,0
Texas,Loma Linda West,184,22,58,36,0,0,116
Texas,Loma Vista,271,141,79,0,0,32,252
Texas,Longoria,84,0,0,0,0,84,84
Texas,Loop,359,26,193,0,0,3,222
Texas,Los Altos,116,23,0,0,0,0,23
Texas,Los Angeles,0,0,0,0,0,0,0
Texas,Los Arcos,57,13,17,8,0,9,47
Texas,Los Arrieros,0,0,0,0,0,0,0
Texas,Los Barreras,178,64,53,0,27,0,144
Texas,Nesbitt,117,22,64,2,2,27,117
Texas,Los Centenarios,0,0,0,0,0,0,0
Texas,Cisco,3766,966,1515,425,9,310,3225
Texas,Carbon,296,52,133,15,8,27,235
Texas,Gruver,1380,377,422,95,60,59,1013
Texas,Palm Valley,1706,225,894,149,35,125,1428
Texas,Mesquite,144250,38060,48950,13088,2906,5830,108834
Texas,Eden,2511,1000,929,266,34,131,2360
Texas,Sandia,600,129,339,0,20,0,488
Texas,Allen,99255,20244,45866,7050,653,2250,76063
Texas,Wheeler,1715,263,758,127,39,84,1271
Texas,Canton,3757,633,1593,564,53,349,3192
Texas,Edgewood,1876,405,712,137,43,127,1424
Texas,Bayview,417,54,224,22,3,39,342
Texas,Del Mar Heights,119,47,24,0,0,0,71
Texas,El Camino Angosto,173,109,54,10,0,0,173
Texas,Parker,4534,859,2404,139,9,32,3443
Texas,Indian Lake,709,94,286,58,17,27,482
Texas,Socorro,33923,9936,11186,2411,920,1541,25994
Texas,Dayton,7881,1688,3041,834,204,388,6155
Texas,Highland Park,9145,1197,4923,633,14,352,7119
Texas,Sunnyvale,6284,1431,3261,173,37,129,5031
Texas,Poteet,3429,1090,1185,263,90,199,2827
Texas,Hughes Springs,1823,223,848,144,28,155,1398
Texas,Mertzon,852,211,326,53,0,58,648
Texas,Laguna Heights,3155,707,1054,126,53,146,2086
Texas,Slaton,5995,1128,2044,640,259,359,4430
Texas,Lubbock,250415,82080,82200,22293,4505,10120,201198
Texas,Idalou,2018,458,864,193,0,121,1636
Texas,Lamar,1121,181,541,46,2,75,845
Texas,La Minita,88,7,53,0,0,0,60
Texas,Lantana,9536,1317,5014,388,102,138,6959
Texas,La Paloma Addition,298,108,28,63,0,14,213
Texas,La Paloma Ranchettes,228,67,119,0,0,0,186
Texas,Laredo Ranchettes West,0,0,0,0,0,0,0
Texas,Las Haciendas,0,0,0,0,0,0,0
Texas,Las Palmas,48,0,0,0,0,48,48
Texas,Las Palmas II,1480,485,389,0,78,70,1022
Texas,Las Pilas,0,0,0,0,0,0,0
Texas,Las Quintas Fronterizas,1914,591,512,145,50,42,1340
Texas,La Tina Ranch,920,314,165,121,0,27,627
Texas,Leming,412,74,153,17,0,57,301
Texas,Ames,1247,354,333,116,62,103,968
Texas,Southmayd,1007,176,337,111,36,64,724
Texas,Whitesboro,3961,850,1454,636,0,283,3223
Texas,Whitewright,1717,389,522,253,8,137,1309
Texas,Lolita,819,62,286,124,0,125,597
Texas,La Loma de Falcon,126,30,52,15,8,0,105
Texas,Aubrey,3313,640,1518,284,30,155,2627
Texas,Poynor,302,47,146,13,2,2,210
Texas,Sweeny,3739,804,1387,254,26,350,2821
Texas,Wild Peach Village,1924,442,722,204,71,148,1587
Texas,Melvin,170,39,74,16,1,15,145
Texas,Covington,255,39,99,14,1,28,181
Texas,Bonham,10106,2705,3060,1478,290,774,8307
Texas,Dodd City,337,37,171,34,6,9,257
Texas,Honey Grove,2172,473,847,214,35,154,1723
Texas,San Antonio,1486521,450067,486041,140971,35405,61211,1173695
Texas,Sachse,25133,5416,12462,1389,12,674,19953
Texas,Farmers Branch,35552,9967,14159,3109,641,1396,29272
Texas,Ferris,2612,466,954,206,75,77,1778
Texas,Castroville,2970,750,1195,237,91,185,2458
Texas,Port Lavaca,12303,3092,4412,1504,308,602,9918
Texas,San Perlita,760,212,219,79,19,18,547
Texas,Ralls,1711,304,560,193,42,148,1247
Texas,Bryson,551,160,164,33,15,31,403
Texas,DeSoto,53030,13457,19499,4772,1118,2203,41049
Texas,Bruceville-Eddy,1509,291,639,165,3,69,1167
Texas,Rockwall,43157,8356,20445,3078,346,1629,33854
Texas,Richland,205,38,99,25,4,17,183
Texas,Homestead Meadows North,5665,1176,2419,267,72,174,4108
Texas,Loraine,447,88,140,50,14,55,347
Texas,Dublin,3589,802,1196,362,58,101,2519
Texas,Stephenville,20396,8483,6296,1643,160,611,17193
Texas,Brazoria,3094,719,1171,311,48,236,2485
Texas,Freeport,12098,3228,3787,796,366,448,8625
Texas,Aquilla,148,22,54,27,0,9,112
Texas,Tynan,244,48,99,0,0,17,164
Texas,Carthage,6646,1683,2187,728,139,434,5171
Texas,Uvalde,16277,4488,5260,1256,632,892,12528
Texas,Uvalde Estates,1292,406,498,99,0,68,1071
Texas,Azle,12149,2184,5239,1543,146,687,9799
Texas,Baird,1720,358,628,248,38,140,1412
Texas,Cross Plains,1101,175,351,175,21,94,816
Texas,Nome,405,70,178,36,0,47,331
Texas,Bailey,260,58,68,47,4,19,196
Texas,Oak Valley,430,74,204,50,9,19,356
Texas,Burke,800,182,395,50,18,21,666
Texas,Lake Meredith Estates,357,11,52,232,62,0,357
Texas,Mustang,0,0,0,0,0,0,0
Texas,Blooming Grove,704,125,251,105,21,44,546
Texas,Marfa,1788,381,631,163,25,179,1379
Texas,Wichita Falls,104494,31900,34820,10756,1805,5192,84473
Texas,Wink,739,105,279,86,4,28,502
Texas,Carrizo Hill,965,228,378,60,0,18,684
Texas,Ladonia,675,195,224,60,19,73,571
Texas,Fifth Street,2047,679,712,34,30,19,1474
Texas,Pecan Grove,16651,3024,8493,1231,261,685,13694
Texas,Pine Forest,709,67,412,41,0,43,563
Texas,Pleak village,1475,315,688,83,13,60,1159
Texas,Oak Ridge North,3136,666,1583,226,60,140,2675
Texas,Pinehurst,6157,1178,2214,354,138,262,4146
Texas,Stagecoach,653,125,325,56,0,33,539
Texas,Lytle,2886,744,1198,300,68,169,2479
Texas,Marietta,93,11,55,11,0,10,87
Texas,Hillcrest village,858,146,529,37,6,44,762
Texas,San Juan,36740,9694,12500,2127,1071,1147,26539
Texas,Beach City,2620,525,1287,135,32,68,2047
Texas,Waxahachie,34285,8746,12943,3164,490,1661,27004
Texas,Alma,359,103,190,15,0,30,338
Texas,Thorntonville,601,129,199,55,8,44,435
Texas,Wortham,1176,207,450,100,29,98,884
Texas,Lakeview,70,14,28,7,0,10,59
Texas,Magnolia,2207,532,835,181,28,110,1686
Texas,Montgomery,988,208,370,89,3,34,704
Texas,Wells Branch,12227,3877,3607,1764,505,362,10115
Texas,Martindale,1012,209,460,104,24,49,846
Texas,La Feria North,133,18,27,49,27,0,121
Texas,La Paloma,3504,1089,1340,180,54,136,2799
Texas,Laureles,4788,1404,1607,269,129,206,3615
Texas,Hardin,734,91,275,63,16,83,528
Texas,Pottsboro,2452,382,1004,212,45,74,1717
Texas,Fairview,8665,1228,5128,610,18,345,7329
Texas,Frisco,165700,27841,80422,9535,994,3790,122582
Texas,Holland,1339,318,461,38,65,79,961
Texas,Brundage,0,0,0,0,0,0,0
Texas,Hart,1172,310,371,90,46,71,888
Texas,Bridge City,8004,1481,3674,779,60,276,6270
Texas,Weslaco,39871,9187,13509,3205,800,2054,28755
Texas,Burnet,6216,1429,2419,748,52,523,5171
Texas,Oglesby,736,131,274,80,11,23,519
Texas,Canadian,3138,639,1294,202,56,102,2293
Texas,Agua Dulce,836,142,356,40,12,55,605
Texas,Bishop,3112,928,1091,246,30,173,2468
Texas,Sadler,651,217,188,170,1,16,592
Texas,Daisetta,698,115,370,45,9,20,559
Texas,Dayton Lakes,108,49,31,10,0,0,90
Texas,Devers,434,111,188,16,33,26,374
Texas,Sherman,41149,9931,14292,4467,994,2468,32152
Texas,Buffalo Springs village,488,97,252,54,4,34,441
Texas,Josephine,1243,270,629,67,22,41,1029
Texas,Melissa,8492,2069,4002,293,0,89,6453
Texas,Plano,284579,64288,133101,22181,2931,9806,232307
Texas,Sweetwater,10701,2093,3995,1069,260,736,8153
Texas,Morgan's Point Resort,4401,700,2213,320,29,180,3442
Texas,Rogers,1216,168,488,170,6,93,925
Texas,Keene,6339,1539,2518,417,58,313,4845
Texas,Rio Vista,1039,166,450,55,15,37,723
Texas,Quemado,169,0,133,0,0,36,169
Texas,Sulphur Springs,15948,3339,5945,1712,378,1239,12613
Texas,Premont,2603,743,973,300,34,150,2200
Texas,Cumby,712,176,308,93,6,27,610
Texas,Latexo,387,47,162,66,3,4,282
Texas,Morse,121,21,88,1,0,2,112
Texas,Seven Points,1305,238,508,186,20,125,1077
Texas,Central Gardens,4197,853,2140,533,0,156,3682
Texas,Knippa,642,209,214,52,3,43,521
Texas,Tuleta,344,62,168,17,6,17,270
Texas,Utopia,228,110,37,19,0,9,175
Texas,Blue Berry Hill,625,167,255,47,0,29,498
Texas,Hebbronville,4662,1387,1340,390,94,240,3451
Texas,Pettus,386,70,121,91,11,35,328
Texas,Reno city (Parker and Tarrant Counties),2811,734,1037,306,61,238,2376
Texas,Carmine,177,24,98,16,0,19,157
Texas,Buckholts,435,72,199,38,7,33,349
Texas,Hewitt,14347,2725,7180,998,96,598,11597
Texas,Robinson,11569,2232,5437,845,142,479,9135
Texas,Sierra Blanca,705,114,198,89,0,80,481
Texas,Lipan,402,45,178,46,1,23,293
Texas,Tolar,770,107,399,56,12,42,616
Texas,Big Spring,28367,8344,9085,3266,691,1553,22939
Texas,Childress,6203,2152,2031,490,67,473,5213
Texas,Duncanville,39630,10873,13649,3491,828,1845,30686
Texas,Garrett,1062,192,360,47,48,40,687
Texas,Schulenburg,2893,729,1087,250,59,154,2279
Texas,South Fork Estates,58,0,49,0,0,0,49
Texas,Rockdale,5554,1234,2058,757,35,344,4428
Texas,Bellmead,10431,2678,3357,1439,349,494,8317
Texas,Crawford,732,163,302,47,10,32,554
Texas,Lacy-Lakeview,6629,1612,2148,686,105,369,4920
Texas,Lorena,2026,463,810,206,11,109,1599
Texas,McGregor,5093,1112,1729,401,279,319,3840
Texas,Runge,1040,202,462,37,36,120,857
Texas,Mountain City,732,145,396,32,9,9,591
Texas,Granbury,9593,1579,4001,1295,100,1167,8142
Texas,Hooks,2747,450,1075,264,129,121,2039
Texas,San Patricio,368,43,242,19,11,13,328
Texas,Bullard,3039,504,1213,247,87,91,2142
Texas,Aldine,15822,4782,5345,703,201,551,11582
Texas,Baytown,76581,19910,26985,6991,1529,3262,58677
Texas,Bellaire,18733,2611,10479,728,62,677,14557
Texas,Thorndale,1252,191,574,135,13,128,1041
Texas,Cloverleaf,24953,6454,8733,1382,842,829,18240
Texas,Panhandle,2728,593,1161,272,43,130,2199
Texas,Domino,107,58,16,5,0,11,90
Texas,Early,2923,542,1295,260,10,152,2259
Texas,Scottsville,389,74,133,19,6,30,262
Texas,Waskom,1887,437,712,267,111,132,1659
Texas,Mabank,3194,677,1089,504,101,240,2611
Texas,Terrell,17378,4751,5228,2127,505,978,13589
Texas,Corrigan,1794,476,690,141,23,111,1441
Texas,West Livingston,8134,2472,2801,1192,334,278,7077
Texas,Callisburg,391,77,139,55,7,29,307
Texas,Gainesville,16275,3564,5962,1781,321,882,12510
Texas,Cameron,5455,1095,2056,573,142,377,4243
Texas,Gholson,1039,110,591,120,15,65,901
Texas,Conroe,80893,20754,31319,6610,1728,3495,63906
Texas,Panorama Village,3179,568,1612,157,3,287,2627
Texas,Splendora,1850,396,751,197,48,53,1445
Texas,Circle D-KC Estates,2674,420,1287,277,26,157,2167
Texas,Christine,300,54,156,11,5,13,239
Texas,Bloomburg,562,186,174,51,5,23,439
Texas,McLean,962,162,333,91,20,94,700
Texas,Hedwig Village,2675,613,1269,136,0,65,2083
Texas,Highlands,7432,1990,2486,999,149,421,6045
Texas,Lake Tanglewood village,791,64,561,67,2,41,735
Texas,Hawley,628,94,231,70,10,32,437
Texas,Barry,261,19,127,31,0,14,191
Texas,Dawson,900,194,364,93,24,48,723
Texas,Goodlow,140,30,63,19,1,8,121
Texas,Miles,988,276,395,69,0,38,778
Texas,Winters,2866,653,978,272,44,205,2152
Texas,Tenaha,1402,468,379,107,37,98,1089
Texas,Timpson,1287,271,324,156,89,100,940
Texas,Grandfalls,359,74,139,23,11,35,282
Texas,Wickett,556,84,231,62,16,37,430
Texas,Holliday,1483,318,618,118,35,142,1231
Texas,Pecan Gap,166,23,111,12,5,11,162
Texas,Cuevitas,0,0,0,0,0,0,0
Texas,Abbott,328,49,154,28,0,17,248
Texas,Arcola,2221,508,742,116,61,66,1493
Texas,Four Corners,12465,2818,5441,579,103,424,9365
Texas,Sienna Plantation,16996,3575,8017,614,211,235,12652
Texas,Kilgore,14867,3655,5440,1668,415,887,12065
Texas,Clarksville City,744,97,350,89,14,51,601
Texas,Dell City,216,29,50,14,16,35,144
Texas,Hays,227,48,96,17,9,27,197
Texas,Point Blank,748,106,310,126,2,96,640
Texas,La Grulla,1582,365,592,115,19,113,1204
Texas,La Puerta,520,222,146,21,5,33,427
Texas,Santa Cruz,17,0,17,0,0,0,17
Texas,Pearland,117867,21788,56347,7031,1042,3848,90056
Texas,Leary,619,121,239,82,3,35,480
Texas,Redwater,1152,225,422,144,19,67,877
Texas,Pasadena,154193,38829,53495,12927,4629,5247,115127
Texas,Throckmorton,732,177,349,48,31,50,655
Texas,South Houston,17627,4334,6087,828,594,698,12541
Texas,Buchanan Dam,1466,135,760,289,15,154,1353
Texas,Goree,419,90,159,26,13,17,305
Texas,Oakwood,765,172,190,83,10,84,539
Texas,Mart,1994,517,622,204,46,136,1525
Texas,Valley Mills,1300,232,553,151,18,82,1036
Texas,Woodway,8800,1336,4848,447,76,436,7143
Texas,Buda,14503,2341,6570,1388,79,278,10656
Texas,Dripping Springs,3277,781,1243,281,46,267,2618
Texas,Stafford,18110,5139,7384,1754,314,781,15372
Texas,Sugar Land,118182,23483,61376,5785,921,3808,95373
Texas,Huntington,2320,422,845,239,65,202,1773
Texas,Channelview,41930,10868,14442,3002,984,1373,30669
Texas,Somerville,1594,482,469,110,34,109,1204
Texas,Sunray,1976,322,856,104,32,104,1418
Texas,Waller,2845,537,1074,342,54,93,2100
Texas,Alice,19146,5347,6275,1551,363,1200,14736
Texas,Sunrise Beach Village,943,147,531,125,2,41,846
Texas,Orange Grove,1712,313,666,61,8,112,1160
Texas,Rancho Alegre,1448,406,412,168,63,110,1159
Texas,Westdale,15,0,0,0,0,15,15
Texas,Munday,1184,195,460,104,14,133,906
Texas,Gustine,457,60,190,53,13,14,330
Texas,Stonewall,626,84,314,74,0,63,535
Texas,Memphis,2259,448,878,263,23,181,1793
Texas,Turkey,320,83,153,23,5,15,279
Texas,The Woodlands,109843,18577,55083,7662,777,3416,85515
Texas,Tomball,11644,2702,4050,1419,201,902,9274
Texas,Woodloch,216,53,79,19,8,14,173
Texas,Elgin,9616,2591,3033,896,151,419,7090
Texas,Snook,576,185,188,46,31,19,469
Texas,Smithville,4256,1214,1428,584,33,395,3654
Texas,Cactus,3205,797,1373,61,75,18,2324
Texas,Kemah,2831,765,1165,247,149,50,2376
Texas,Grand Prairie,191104,50691,73162,13897,3873,5710,147333
Texas,Lewisville,104789,28587,38739,9709,2048,3196,82279
Texas,Falls City,935,172,436,50,1,64,723
Texas,Bear Creek village,390,64,226,22,2,18,332
Texas,Grapeland,1725,455,549,195,9,164,1372
Texas,Lovelady,616,105,199,89,3,71,467
Texas,Coahoma,819,86,417,58,15,37,613
Texas,Tira,254,58,91,38,5,10,202
Texas,Anson,2076,268,864,217,23,136,1508
Texas,Stamford,2930,473,1207,269,82,322,2353
Texas,Robstown,11494,3079,2932,1006,380,979,8376
Texas,Spofford,240,89,88,11,0,0,188
Texas,Huntsville,41079,18681,11273,4872,580,1302,36708
Texas,Jasper,7586,1673,2731,481,184,522,5591
Texas,San Leon,5106,1054,2082,681,167,304,4288
Texas,Kirbyville,2558,499,798,335,133,193,1958
Texas,Bayou Vista,1658,292,956,235,7,146,1636
Texas,Santa Fe,13241,2778,6207,942,115,640,10682
Texas,Como,797,130,341,60,7,19,557
Texas,Fowlerton,314,78,169,0,0,0,247
Texas,Brownsville,182679,47202,65034,9705,6059,8715,136715
Texas,Bailey's Prairie village,759,120,399,29,0,54,602
Texas,McLendon-Chisholm,2589,413,1357,130,19,102,2021
Texas,Industry,273,80,153,11,0,13,257
Texas,Bellville,4234,1092,1876,412,0,434,3814
Texas,Bonney village,246,44,105,37,14,0,200
Texas,Brookside Village,1814,417,881,95,33,80,1506
Texas,Clute,11524,2650,4323,1102,299,538,8912
Texas,Iowa Colony village,1056,334,470,85,21,16,926
Texas,Jones Creek village,2192,456,972,155,52,76,1711
Texas,Rice,917,158,361,98,10,37,664
Texas,Oyster Creek,1278,240,444,183,38,80,985
Texas,Quintana,14,1,5,6,1,0,13
Texas,Surfside Beach,593,122,308,73,13,27,543
Texas,Royse City,11746,2580,5318,730,200,302,9130
Texas,Huxley,459,59,251,36,5,37,388
Texas,Palisades village,299,24,148,47,8,22,249
Texas,Nash,3350,630,1194,324,99,155,2402
Texas,Hearne,4467,886,1444,503,230,275,3338
Texas,Brady,5371,1415,1804,692,77,363,4351
Texas,Hubbard,1547,289,612,208,47,67,1223
Texas,Blum,373,82,135,23,14,21,275
Texas,University Park,24954,6538,11122,1227,61,375,19323
Texas,Tioga,890,179,346,125,13,40,703
Texas,Van Alstyne,3682,761,1557,294,90,194,2896
Texas,Odem,2410,513,922,203,77,86,1801
Texas,Lago,480,92,103,19,35,25,274
Texas,New Deal,776,125,294,95,0,36,550
Texas,Chireno,446,98,182,38,19,24,361
Texas,Brenham,16778,5360,4894,1623,455,1168,13500
Texas,League City,100832,20254,45437,8136,909,3098,77834
Texas,Citrus City,3275,744,978,195,113,42,2072
Texas,Donna,16576,3852,5583,881,504,969,11789
Texas,Rocky Mound,81,10,38,20,0,1,69
Texas,Liverpool,541,120,250,43,7,35,455
Texas,New Hope,643,118,340,60,4,19,541
Texas,Eastland,3893,1029,1283,451,83,206,3052
Texas,Abernathy,3074,585,1415,202,58,146,2406
Texas,Fate,11705,1154,6161,347,63,238,7963
Texas,Selma,9895,2061,3844,944,144,201,7194
Texas,Buffalo,1949,323,662,261,36,150,1432
Texas,Paris,24842,5490,8463,3357,636,1888,19834
Texas,Thompsons,212,35,80,48,20,20,203
Texas,Winnie,3482,653,1468,360,77,313,2871
Texas,Riviera,648,176,289,35,34,36,570
Texas,Rosharon,1580,278,793,72,11,122,1276
Texas,Rosita,3471,853,1017,250,136,96,2352
Texas,Salineño North,62,6,26,0,13,4,49
Texas,Sammy Martinez,44,9,10,0,0,0,19
Texas,Sam Rayburn,764,13,454,128,0,80,675
Texas,San Carlos I,63,15,23,0,0,13,51
Texas,San Carlos II,456,107,93,0,27,0,227
Texas,Sandoval,0,0,0,0,0,0,0
Texas,Sand Springs,846,237,256,185,0,66,744
Texas,San Fernando,39,0,17,22,0,0,39
Texas,San Juan,119,58,6,0,0,26,90
Texas,Santa Anna,9,0,0,9,0,0,9
Texas,Santa Rosa,234,59,49,0,0,58,166
Texas,Santel,10,0,10,0,0,0,10
Texas,Sarita,511,78,156,61,22,62,379
Texas,Savannah,6224,1324,2532,455,8,106,4425
Texas,Rivereno,19,0,0,19,0,0,19
Texas,Kingsbury,49,0,25,0,0,8,33
Texas,Ricardo,544,124,221,74,15,25,459
Texas,Redland,1429,226,317,108,129,45,825
Texas,Placedo,575,92,284,70,25,20,491
Texas,Pleasant Hill,744,229,311,53,0,29,622
Texas,Port O'Connor,971,228,428,52,34,41,783
Texas,Powderly,1021,133,513,151,0,116,913
Texas,Preston,2148,368,958,365,50,158,1899
Texas,Pueblo East,0,0,0,0,0,0,0
Texas,Pueblo Nuevo,679,180,235,0,33,0,448
Texas,Quail Creek,1633,474,629,79,34,104,1320
Texas,Quesada,0,0,0,0,0,0,0
Texas,Rafael Pena,0,0,0,0,0,0,0
Texas,Ramireno,69,46,23,0,0,0,69
Texas,Ramirez-Perez,49,26,0,23,0,0,49
Texas,Ramos,406,95,137,18,0,3,253
Texas,Ranchitos East,513,86,155,12,44,0,297
Texas,Rancho Viejo,148,16,63,0,0,0,79
Texas,Randolph AFB,1178,146,539,12,11,6,714
Texas,Redfield,395,72,86,32,0,44,234
Texas,Regino Ramirez,106,17,54,0,0,0,71
Texas,Plantersville,528,129,164,108,15,38,454
Texas,Roman Forest,1555,306,758,159,17,81,1321
Texas,Spring Branch,36,0,20,16,0,0,36
Texas,Valle Verde,0,0,0,0,0,0,0
Texas,Valle Vista,738,376,185,0,0,0,561
Texas,Valley View,944,159,400,118,12,24,713
Texas,Victoria Vera,112,59,0,0,0,24,83
Texas,Villarreal,168,96,72,0,0,0,168
Texas,Warren,817,112,422,82,23,26,665
Texas,Welch,181,31,85,6,0,7,129
Texas,West Alto Bonito,539,146,233,35,0,0,414
Texas,Western Lake,632,130,273,150,16,20,589
Texas,Westminster,787,154,279,126,0,60,619
Texas,Westwood Shores,1524,199,781,160,0,158,1298
Texas,Wildwood,1630,146,934,34,0,37,1151
Texas,Zarate,20,0,0,0,20,0,20
Texas,César Chávez,1374,231,575,141,18,0,965
Texas,Coyote Flats,342,28,202,26,1,17,274
Texas,Providence Village,7053,1171,2794,861,39,88,4953
Texas,Sandy Point,114,25,54,15,9,6,109
Texas,Valle Hermoso,0,0,0,0,0,0,0
Texas,Travis Ranch,3508,599,1469,145,69,144,2426
Texas,Tivoli,640,137,197,58,13,46,451
Texas,Tilden,246,52,74,5,18,17,166
Texas,Seco Mines,459,71,252,0,13,0,336
Texas,Shadybrook,1871,330,923,162,29,112,1556
Texas,Sherwood Shores,1386,141,774,282,9,41,1247
Texas,Siesta Acres,2265,481,1160,127,38,60,1866
Texas,South La Paloma,360,37,138,0,0,56,231
Texas,Spring Gardens,643,236,189,41,0,19,485
Texas,Staples,230,33,135,30,2,15,215
Texas,Study Butte,196,20,97,25,0,15,157
Texas,Pine Harbor,908,94,440,148,7,30,719
Texas,Tanquecitos South Acres,113,41,22,26,0,12,101
Texas,Sunset CDP (Starr County),14,3,7,0,0,0,10
Texas,Sunset Acres,0,0,0,0,0,0,0
Texas,Tanquecitos South Acres II,0,0,0,0,0,0,0
Texas,Terlingua,82,21,39,2,0,20,82
Texas,Thompsonville,198,94,104,0,0,0,198
Texas,Thunderbird Bay,546,26,265,145,0,57,493
Texas,Tierra Dorada,0,0,0,0,0,0,0
Texas,Tierra Verde,428,242,98,21,0,0,361
Texas,Sunset CDP (Montague County),485,105,243,13,0,40,401
Texas,Anahuac,2327,647,912,184,32,146,1921
Texas,Perrin,256,75,101,37,11,10,234
Texas,Pena,70,24,21,0,0,0,45
Texas,Newcastle,584,153,257,22,0,42,474
Texas,Harlingen,65449,16484,22123,4435,1443,3487,47972
Texas,Oak Trail Shores,2981,600,1060,396,40,134,2230
Texas,Spearman,3250,577,1476,193,74,235,2555
Texas,Crandall,3491,795,1644,192,34,112,2777
Texas,Bevil Oaks,1283,234,743,70,0,67,1114
Texas,Booker,1401,322,627,93,17,80,1139
Texas,Concepcion,46,28,9,0,0,9,46
Texas,Skidmore,1168,423,466,104,0,64,1057
Texas,Aledo,3817,764,1484,256,81,83,2668
Texas,Cool,180,40,76,25,6,10,157
Texas,Weatherford,29739,6573,11967,3085,511,1761,23897
Texas,La Grange,4655,1085,1455,572,92,240,3444
Texas,West,2809,605,1063,298,33,316,2315
Texas,Todd Mission,42,7,21,8,0,0,36
Texas,Boerne,14799,2886,6157,1563,158,797,11561
Texas,Bynum,284,63,114,18,21,7,223
Texas,Tehuacana,205,30,84,33,4,15,166
Texas,Franklin,1976,418,687,188,69,100,1462
Texas,Los Fresnos,7707,1621,2783,339,237,374,5354
Texas,Wixon Valley,229,32,93,28,9,11,173
Texas,Rose Hill Acres,455,83,235,42,3,23,386
Texas,Smyer,605,166,210,50,20,19,465
Texas,Mineola,4644,1123,1566,533,45,421,3688
Texas,Campbell,738,101,274,70,16,59,520
Texas,Greenville,26900,6283,9616,2977,733,1406,21015
Texas,Quinlan,1549,349,529,156,58,162,1254
Texas,Wolfe City,1409,290,572,80,9,156,1107
Texas,Marion,870,192,306,121,18,93,730
Texas,Garland,237982,60862,91420,20118,4331,8400,185131
Texas,Grapevine,52486,12932,21517,5845,744,1479,42517
Texas,Richardson,114402,29707,48196,9019,1385,4592,92899
Texas,Lasara,793,227,329,71,0,33,660
Texas,Raymondville,11051,3765,3499,918,387,501,9070
Texas,Chester,333,45,149,37,21,9,261
Texas,Colmesneil,631,75,263,76,0,57,471
Texas,Floresville,7377,1873,2564,836,152,502,5927
Texas,Poth,2151,378,1062,77,45,70,1632
Texas,Walnut Springs,846,185,324,57,18,40,624
Texas,Windom,174,38,69,17,0,17,141
Texas,Coffee City,264,45,130,36,5,32,248
Texas,Trinidad,954,209,324,107,16,89,745
Texas,Rule,597,53,281,69,6,74,483
Texas,Celeste,873,147,340,86,37,41,651
Texas,Glenn Heights,12581,3448,4078,1057,135,535,9253
Texas,Rising Star,957,244,262,152,29,46,733
Texas,Lake Kiowa,2440,227,1588,236,65,158,2274
Texas,Lexington,1454,286,592,208,15,116,1217
Texas,Stinnett,1214,213,593,110,21,81,1018
Texas,Runaway Bay,1784,249,903,180,39,119,1490
Texas,Farwell,1388,228,689,85,11,151,1164
Texas,Charlotte,1605,416,523,94,86,95,1214
Texas,Hawk Cove,522,103,164,88,12,40,407
Texas,McQueeney,2543,415,1074,272,87,231,2079
Texas,Seguin,28357,7663,9466,3099,720,1839,22787
Texas,Palo Pinto,161,62,39,31,6,11,149
Texas,Fresno,24607,6424,8783,1285,535,907,17934
Texas,Sandy Oaks,4396,1173,1409,480,85,49,3196
Texas,Sonterra,2963,527,1348,224,66,68,2233
Texas,La Rosita,56,37,19,0,0,0,56
Texas,Falcon Heights,22,0,22,0,0,0,22
Texas,Serenada,1502,261,894,73,44,25,1297
Texas,Winnsboro,3333,568,892,489,147,274,2370
Texas,New Berlin,689,128,322,35,0,72,557
Texas,Indian Hills,2959,889,1050,47,43,81,2110
Texas,La Homa,12054,3002,4581,441,450,366,8840
Texas,Mila Doce,6394,1568,1847,168,265,313,4161
Texas,Olivarez,4246,893,1172,130,286,145,2626
Texas,Pilot Point,4292,1168,1400,569,85,295,3517
Texas,Corpus Christi,324692,86547,118322,30951,6582,15384,257786
Texas,North San Pedro,890,283,321,110,0,35,749
Texas,Perezville,4612,864,2085,119,153,387,3608
Texas,Annetta South,534,130,293,16,4,8,451
Texas,Oilton,271,84,120,22,0,12,238
Texas,Timbercreek Canyon village,471,74,281,31,0,16,402
Texas,Nocona,2960,477,1178,397,67,287,2406
Texas,La Victoria,131,45,58,28,0,0,131
Texas,Hedley,276,52,107,53,1,34,247
Texas,Rockport,10957,2083,5100,1464,288,514,9449
Texas,Beaumont,118632,35300,38903,11292,2169,5919,93583
Texas,Waco,133964,46699,39924,11338,2377,6055,106393
Texas,East Tawakoni,729,116,308,134,5,38,601
Texas,Blossom,1505,247,643,235,27,83,1235
Texas,Clarksville,3198,966,975,333,128,307,2709
Utah,Henrieville,242,50,113,16,8,15,202
Utah,Stansbury Park,9173,1527,4261,349,150,60,6347
Utah,Dugway,459,82,258,17,0,16,373
Utah,West Valley City,135985,34110,48553,10282,3225,3769,99939
Utah,South Salt Lake,24860,8291,7479,2621,645,942,19978
Utah,South Jordan,68491,12071,31595,3846,590,1243,49345
Utah,Riverton,42680,6851,19432,2097,177,782,29339
Utah,Kingston,156,25,59,10,0,19,113
Utah,Blanding,3685,764,1241,307,70,150,2532
Utah,West Haven,12916,2927,5490,452,275,181,9325
Utah,Scofield,30,6,24,0,0,0,30
Utah,Roy,38238,7496,15044,3923,658,974,28095
Utah,Washington Terrace,9138,1724,3566,988,161,656,7095
Utah,Pleasant View,9806,1965,4611,469,35,124,7204
Utah,Timber Lakes,582,0,382,104,0,0,486
Utah,Pleasant Grove,38066,8414,16101,1768,236,1022,27541
Utah,Highland,18362,3779,8293,349,74,172,12667
Utah,Helper,2051,352,944,258,21,88,1663
Utah,Brian Head,77,21,29,16,0,5,71
Utah,Neola,452,96,188,23,0,12,319
Utah,Altamont,184,30,93,11,0,12,146
Utah,Brigham City,18924,3279,8661,1587,133,852,14512
Utah,Mantua,604,108,343,47,2,24,524
Utah,Farmington,23208,4094,10249,1518,130,278,16269
Utah,West Point,10434,1880,4866,473,102,199,7520
Utah,Enoch,6534,1037,2900,223,11,77,4248
Utah,Beaver,3037,409,1434,128,53,175,2199
Utah,Ephraim,6987,2497,2532,271,61,101,5462
Utah,Fayette,340,8,150,17,8,1,184
Utah,Glendale,236,55,97,20,2,19,193
Utah,Kanab,4529,933,1854,726,18,291,3822
Utah,Clarkston,661,131,320,23,8,25,507
Utah,Cornish,202,64,73,20,0,3,160
Utah,Fairview,1319,184,705,56,0,67,1012
Utah,Moroni,1651,218,885,42,3,27,1175
Utah,North Logan,10457,2794,4233,309,29,317,7682
Utah,Deweyville,395,59,206,27,10,14,316
Utah,North Salt Lake,20020,3914,8802,1434,269,333,14752
Utah,Plain City,6560,1027,2932,435,15,127,4536
Utah,Holden,447,46,203,24,0,17,290
Utah,Riverdale,8727,1710,3987,767,102,360,6926
Utah,Goshen,1108,213,489,27,9,30,768
Utah,Sigurd,523,79,253,31,14,29,406
Utah,Hatch,167,24,76,8,0,20,128
Utah,Holladay,30746,5910,14032,2649,268,1375,24234
Utah,Bluffdale,12114,1854,5237,558,35,194,7878
Utah,Moab,5259,1038,2383,537,131,274,4363
Utah,American Fork,29384,5379,12496,1714,281,813,20683
Utah,West Bountiful,5578,1298,2748,308,12,145,4511
Utah,Eureka,473,67,247,45,6,32,397
Utah,Kaysville,30961,5095,14055,1376,140,620,21286
Utah,Centerville,17221,2635,8240,1333,74,542,12824
Utah,Tremonton,8434,1339,3435,356,41,280,5451
Utah,Elwood,996,150,500,39,7,30,726
Utah,Smithfield,11102,2076,4905,472,49,201,7703
Utah,Lewiston,2104,343,1006,55,6,48,1458
Utah,Avon,231,22,141,4,0,5,172
Utah,Elsinore,750,80,434,88,6,35,643
Utah,Aneth,544,252,76,40,23,8,399
Utah,Manti,3468,559,1705,232,15,78,2589
Utah,Spring City,1062,188,637,50,3,38,916
Utah,New Harmony,180,17,124,5,0,9,155
Utah,Washington,25395,3818,12513,1217,102,806,18456
Utah,Hurricane,16403,3501,7104,1808,162,620,13195
Utah,Torrey,265,14,163,35,0,25,237
Utah,Vernal,10653,2041,3399,1577,93,432,7542
Utah,Rush Valley,549,81,278,57,0,17,433
Utah,Oakley,1442,217,799,61,2,42,1121
Utah,Coalville,1578,292,704,78,36,45,1155
Utah,Sterling,246,41,100,35,3,13,192
Utah,Marysvale,706,162,334,90,0,39,625
Utah,Ogden,86126,21900,30105,10152,1773,2513,66443
Utah,Spring Lake,465,127,212,47,0,10,396
Utah,Cedar Fort,255,49,132,24,2,9,216
Utah,Junction,170,39,77,21,0,18,155
Utah,Springdale,388,97,184,56,7,22,366
Utah,Naples,2800,373,1097,278,11,84,1843
Utah,Fort Duchesne,560,287,96,25,0,17,425
Utah,Summit Park,8273,1739,4102,539,173,132,6685
Utah,Lindon,10826,2242,4815,448,77,275,7857
Utah,Elmo,338,49,154,18,0,45,266
Utah,Hinckley,595,83,265,60,17,20,445
Utah,Portage,240,35,113,17,0,12,177
Utah,Charleston,629,112,360,25,2,20,519
Utah,Wendover,1118,370,257,79,51,42,799
Utah,Maeser,4392,852,1872,244,15,149,3132
Utah,Randlett,143,52,54,8,0,0,114
Utah,Whiterocks,308,97,11,59,0,8,175
Utah,Hildale,2916,870,558,107,32,5,1572
Utah,Leeds,785,131,449,67,7,58,712
Utah,Woodland,181,38,104,10,0,29,181
Utah,St. George,82194,16086,36776,6780,1339,3848,64829
Utah,Paradise,1123,218,522,34,8,17,799
Utah,Peter,650,50,278,23,0,9,360
Utah,Howell,248,38,139,15,0,11,203
Utah,Clearfield,31016,6257,11944,2541,468,748,21958
Utah,Paragonah,444,83,227,30,5,20,365
Utah,Delta,3497,572,1621,272,9,180,2654
Utah,Meadow,265,44,132,10,5,12,203
Utah,Cache,0,0,0,0,0,0,0
Utah,Francis,1187,220,551,61,8,41,881
Utah,Uintah,1525,286,717,114,19,48,1184
Utah,Marriott-Slaterville,2142,426,960,192,21,58,1657
Utah,Erda,2666,638,1181,173,20,77,2089
Utah,Ballard,991,192,385,106,18,22,723
Utah,Santa Clara,7118,1139,3631,310,0,167,5247
Utah,Genola,1255,245,578,60,6,29,918
Utah,Lehi,61508,9183,26619,1932,187,803,38724
Utah,Orem,95428,22692,41104,4406,808,2326,71336
Utah,Provo,116146,44510,42566,4405,1049,1889,94419
Utah,Bicknell,194,20,113,27,0,12,172
Utah,Enterprise,1635,263,785,79,15,22,1164
Utah,Alpine,10430,2133,5244,173,38,154,7742
Utah,Elberta,80,8,45,0,0,8,61
Utah,Mapleton,9509,1817,4602,187,17,163,6786
Utah,Springville,32603,5796,13528,1694,275,690,21983
Utah,Vineyard,4873,1320,1595,123,33,19,3090
Utah,Farr West,6836,1359,3281,396,34,251,5321
Utah,Harrisville,6356,1310,2962,337,17,51,4677
Utah,Huntsville,776,136,397,61,0,31,625
Utah,Oak City,715,80,375,22,6,15,498
Utah,Parowan,2965,501,1468,181,54,171,2375
Utah,Price,8281,1765,3041,949,122,412,6289
Utah,Garden City,586,124,134,13,36,38,345
Utah,Cottonwood Heights,34170,7554,15981,3021,151,1373,28080
Utah,Fairfield,136,24,79,11,2,2,118
Utah,Apple Valley,799,118,385,53,9,34,599
Utah,Daniel,1092,280,490,41,19,32,862
Utah,Dutch John,133,6,98,0,0,0,104
Utah,Interlaken,109,74,30,5,0,0,109
Utah,Millcreek,60557,15454,24286,5495,743,3018,48996
Utah,Ivins,8211,1141,4336,786,47,351,6661
Utah,Cedar Highlands,153,50,103,0,0,0,153
Utah,Beryl Junction,44,0,15,6,0,23,44
Utah,Bluebell,249,33,130,18,0,0,181
Utah,Bonanza,0,0,0,0,0,0,0
Utah,Carbonville,1432,177,695,214,48,64,1198
Utah,Central,679,32,411,66,40,29,578
Utah,Clear Creek,14,14,0,0,0,0,14
Utah,Copperton,1041,208,497,39,0,85,829
Utah,Ophir,20,2,11,4,0,2,19
Utah,Herriman,35640,6298,14936,1522,438,591,23785
Utah,Independence,213,49,89,1,0,0,139
Utah,Central Valley,654,95,351,29,12,16,503
Utah,Laketown,214,15,123,20,0,3,161
Utah,Redmond,712,138,339,80,0,49,606
Utah,Salina,2526,467,1100,254,25,118,1964
Utah,Cove,424,56,176,48,8,25,313
Utah,Hyde Park,4467,992,1857,205,36,97,3187
Utah,Richmond,2622,342,1144,197,39,81,1803
Utah,Bear River City,720,121,383,31,2,18,555
Utah,Cedar Hills,10252,2398,3977,336,136,180,7027
Utah,Eagle Mountain,29919,3766,12198,920,303,173,17360
Utah,Elk Ridge,3460,643,1593,83,6,46,2371
Utah,Hanksville,248,60,104,27,3,15,209
Utah,Hooper,8458,1634,4099,296,0,197,6226
Utah,Mona,1542,216,658,49,3,75,1001
Utah,Saratoga Springs,27347,3907,11295,798,187,193,16380
Utah,Woodland Hills,1380,217,721,33,6,25,1002
Utah,Bryce Canyon City,201,75,43,25,0,4,147
Utah,Hideout,1123,245,373,39,30,11,698
Utah,Boulder,178,68,78,21,0,3,170
Utah,Castle Dale,1532,207,678,96,20,61,1062
Utah,Roosevelt,6955,1194,2807,398,62,180,4641
Utah,Oljato-Monument Valley,931,424,264,10,8,28,734
Utah,Silver Summit,4210,908,2012,198,37,57,3212
Utah,Peoa,257,13,146,67,25,6,257
Utah,Pine Valley,245,43,138,0,0,8,189
Utah,Randolph,755,169,294,25,17,21,526
Utah,Snyderville,6352,1227,3192,530,9,36,4994
Utah,Spring Glen,1063,142,480,122,35,97,876
Utah,Summit,260,54,134,7,30,6,231
Utah,Sutherland,23,0,23,0,0,0,23
Utah,Teasdale,150,0,83,0,6,5,94
Utah,Thatcher,712,84,327,52,0,10,473
Utah,Thompson Springs,146,67,54,0,0,0,121
Utah,Veyo,620,68,402,26,0,0,496
Utah,Wanship,606,184,275,31,0,7,497
Utah,West Wood,802,123,392,25,0,16,556
Utah,Wolf Creek,1247,219,659,174,0,14,1066
Utah,Toquerville,2031,255,1010,81,29,60,1435
Utah,Magna,27454,6807,10033,2470,550,813,20673
Utah,Sandy,95420,19994,43657,7146,1027,2952,74776
Utah,Grantsville,10566,1628,4165,883,180,253,7109
Utah,Oasis,19,0,19,0,0,0,19
Utah,Newcastle,324,12,211,101,0,0,324
Utah,Mountain Green,3732,445,1959,86,16,0,2506
Utah,Marion,657,158,321,26,0,6,511
Utah,West Mountain,1069,216,508,45,8,0,777
Utah,North Ogden,18943,3748,8587,1083,65,526,14009
Utah,Manila,175,41,57,13,2,7,120
Utah,Mayfield,368,39,196,21,0,21,277
Utah,East Carbon,1341,229,488,259,13,71,1060
Utah,Wellington,1491,204,627,164,16,67,1078
Utah,Circleville,691,80,308,14,24,86,512
Utah,Murray,49118,11689,19531,5556,963,2419,40158
Utah,Dammeron Valley,849,52,562,91,0,59,764
Utah,Tooele,33805,6929,13325,3066,442,1184,24946
Utah,Deseret,219,30,106,7,0,0,143
Utah,Eden,757,140,398,0,39,41,618
Utah,Emigration Canyon,1828,337,1132,36,0,28,1533
Utah,Enterprise,907,231,385,19,0,0,635
Utah,Flaming Gorge,75,3,40,8,5,0,56
Utah,Fremont,241,98,74,16,0,18,206
Utah,Hoytsville,364,8,227,25,0,21,281
Utah,Jensen,130,0,54,0,0,19,73
Utah,Kenilworth,230,21,66,113,22,8,230
Utah,Liberty,1213,173,667,65,28,21,954
Utah,Echo,71,36,35,0,0,0,71
Utah,South Ogden,17010,3088,7745,1515,174,781,13303
Utah,Loa,537,59,246,63,4,26,398
Utah,Syracuse,28342,5033,12753,1103,222,276,19387
Utah,Bluff,142,20,106,0,0,16,142
Utah,Navajo Mountain,345,130,54,9,2,22,217
Utah,White Mesa,120,48,10,4,0,26,88
Utah,Clawson,177,7,115,8,0,2,132
Utah,Ferron,1516,194,746,110,7,89,1146
Utah,Huntington,1926,367,917,163,16,80,1543
Utah,Orangeville,1443,169,768,60,10,35,1042
Utah,Alton,160,24,68,3,0,5,100
Utah,Annabella,792,126,424,26,0,20,596
Utah,Aurora,851,111,509,34,0,30,684
Utah,Glenwood,617,94,283,10,0,17,404
Utah,Koosharem,236,60,107,13,0,8,188
Utah,Mendon,1110,193,555,29,5,23,805
Utah,Richfield,7678,1325,3104,602,79,322,5432
Utah,Benson,1385,270,699,28,0,82,1079
Utah,Hyrum,8065,1562,3471,373,69,98,5573
Utah,Providence,7300,1313,3342,347,89,239,5330
Utah,Wellsville,3698,664,1632,157,30,85,2568
Utah,Antimony,86,8,53,8,0,9,78
Utah,Morgan,4138,585,2056,172,7,107,2927
Utah,Tropic,596,119,289,20,9,20,457
Utah,Halchita,430,181,50,4,7,4,246
Utah,Cedar City,31009,7942,12586,2256,329,521,23634
Utah,Duchesne,1949,334,781,134,31,93,1373
Utah,Granite,928,149,571,39,18,0,777
Utah,Salt Lake City,195701,67586,66864,17323,2490,6376,160639
Utah,Payson,19699,4198,7968,1136,177,565,14044
Utah,Heber,15056,3473,6133,768,81,173,10628
Utah,Centerfield,1372,161,621,95,15,65,957
Utah,Vernon,369,54,154,12,7,3,230
Utah,Midway,4881,644,2497,450,45,205,3841
Utah,Wallsburg,371,58,184,12,0,9,263
Utah,La Verkin,4268,674,1723,427,73,184,3081
Utah,Salem,7808,1466,3542,276,69,136,5489
Utah,Tabiona,137,18,72,10,0,5,105
Utah,Spanish Fork,38673,6944,15949,1845,361,612,25711
Utah,Logan,50478,16816,18764,2769,473,987,39809
Utah,Spanish Valley,573,94,165,18,0,99,376
Utah,Nephi,5761,1014,2585,390,33,204,4226
Utah,Fielding,494,60,230,39,11,19,359
Utah,Castle Valley,449,75,284,49,0,24,432
Utah,Garden,220,47,116,0,0,34,197
Utah,Riverside,879,141,467,52,0,17,677
Utah,Fountain Green,1133,225,531,66,5,62,889
Utah,Tselakai Dezza,113,37,47,2,0,2,88
Utah,Lake Shore,680,129,405,30,0,24,588
Utah,Santaquin,11154,1839,4648,414,90,122,7113
Utah,Montezuma Creek,412,134,75,30,4,23,266
Utah,Cleveland,595,93,265,20,0,41,419
Utah,Emery,295,38,153,23,2,16,232
Utah,Big Water,590,138,170,80,0,72,460
Utah,Joseph,387,112,183,30,2,8,335
Utah,Monroe,2475,325,1245,231,5,98,1904
Utah,Millville,1911,275,986,63,0,42,1366
Utah,Nibley,6655,1140,2835,193,32,36,4236
Utah,River Heights,2002,375,994,78,3,66,1516
Utah,Snowville,144,27,82,12,0,3,124
Utah,Fruit Heights,6100,1126,3281,209,0,122,4738
Utah,White City,5527,838,2541,418,99,284,4180
Utah,Layton,75106,14644,33108,4376,947,1503,54578
Utah,Clinton,21618,3940,9875,1311,92,442,15660
Utah,West Jordan,113089,25075,46349,8689,1375,2552,84040
Utah,Plymouth,302,26,143,20,3,20,212
Utah,Woods Cross,11287,2725,4874,584,71,145,8399
Utah,Myton,537,99,195,71,13,28,406
Utah,Green River,851,232,368,36,12,34,682
Utah,Woodruff,228,23,93,20,0,3,139
Utah,Escalante,810,122,422,79,23,40,686
Utah,Kanosh,577,123,300,16,0,10,449
Utah,Fillmore,2521,475,1110,151,5,108,1849
Utah,Monticello,2546,641,920,204,14,53,1832
Utah,Kanarraville,280,52,168,21,0,16,257
Utah,Cannonville,294,84,118,16,14,16,248
Utah,Panguitch,1773,280,771,174,7,102,1334
Utah,Halls Crossing,0,0,0,0,0,0,0
Utah,La Sal,388,87,90,120,4,27,328
Utah,Mexican Hat,0,0,0,0,0,0,0
Utah,Orderville,615,123,300,11,9,20,463
Utah,Amalga,581,92,276,24,1,8,401
Utah,Leamington,316,10,158,10,0,15,193
Utah,Newton,765,133,371,39,13,13,569
Utah,Corinne,634,99,319,38,0,36,492
Utah,Garland,2487,313,1138,171,9,72,1703
Utah,Honeyville,1538,324,684,30,0,56,1094
Utah,Perry,4828,717,2412,73,8,64,3274
Utah,South Willard,1908,330,945,96,29,25,1425
Utah,Willard,1805,242,912,109,2,61,1326
Utah,Bountiful,43792,8420,19614,3021,244,1767,33066
Utah,South Weber,7159,1273,3492,101,41,191,5098
Utah,Sunset,5229,1062,1865,596,168,191,3882
Utah,Trenton,428,53,205,28,2,9,297
Utah,Wales,332,69,154,14,0,3,240
Utah,Lynndyl,95,15,44,1,1,13,74
Utah,Alta,388,294,51,21,2,2,370
Utah,Palmyra,467,113,276,26,0,15,430
Utah,Draper,47402,9680,21555,2839,316,718,35108
Utah,Benjamin,1017,165,534,13,0,38,750
Utah,Virgin,530,116,278,40,3,19,456
Utah,Rockville,319,86,143,52,5,18,304
Utah,Park City,8296,2546,3755,512,76,188,7077
Utah,Kamas,2438,491,888,153,33,67,1632
Utah,Henefer,781,172,349,53,0,20,594
Utah,Lyman,337,50,184,37,4,6,281
Utah,Scipio,312,31,189,15,0,18,253
Utah,Taylorsville,60294,14423,23279,5490,854,2078,46124
Utah,Midvale,32893,8652,11749,3155,614,945,25115
Utah,Kearns,37748,9086,14368,2518,569,1030,27571
Utah,Levan,877,170,389,72,2,57,690
Utah,Rocky Ridge,1054,327,198,25,1,13,564
Utah,Gunnison,3388,1318,922,602,106,36,2984
Utah,Mount Pleasant,3365,809,1483,173,32,135,2632
Utah,Minersville,867,181,429,75,0,20,705
Utah,Samak,323,41,111,90,9,24,275
Utah,Milford,1651,171,768,141,22,59,1161
Utah,Stockton,722,146,369,63,11,21,610
Vermont,Alburgh village,529,180,189,48,21,20,458
Vermont,North Westminster,199,99,41,30,0,21,191
Vermont,Proctorsville,375,94,120,87,27,20,348
Vermont,Chelsea,381,62,111,68,6,28,275
Vermont,Hinesburg,773,215,240,96,1,37,589
Vermont,Cabot,186,26,66,38,3,8,141
Vermont,Worcester,47,5,19,10,0,3,37
Vermont,Windsor,2157,614,620,244,34,195,1707
Vermont,Wilmington,298,51,77,102,0,21,251
Vermont,Williamstown,997,145,423,235,0,85,888
Vermont,Wells,446,130,222,22,0,17,391
Vermont,Websterville,522,165,123,106,0,12,406
Vermont,Waitsfield,150,53,60,23,0,0,136
Vermont,Stowe,282,65,109,51,11,46,282
Vermont,South Royalton,616,183,117,147,0,75,522
Vermont,Rochester,308,94,143,12,2,27,278
Vermont,Richmond,391,205,99,63,0,6,373
Vermont,Readsboro,260,68,101,23,6,12,210
Vermont,Shelburne,505,66,216,132,0,29,443
Vermont,Randolph,2225,661,993,232,0,103,1989
Vermont,Quechee,231,20,102,8,0,0,130
Vermont,Putney,474,191,134,76,13,34,448
Vermont,Plainfield,413,118,143,70,0,13,344
Vermont,Troy,25,3,14,8,0,0,25
Vermont,Pittsford,602,181,272,76,32,24,585
Vermont,Springfield,4181,1108,1444,560,25,235,3372
Vermont,Jacksonville village,214,52,106,31,0,7,196
Vermont,Wilder,1577,422,588,254,10,59,1333
Vermont,Essex Junction village,10395,2873,4191,1084,16,327,8491
Vermont,Vergennes,2612,659,1030,345,22,187,2243
Vermont,Brattleboro,6771,2009,2037,1231,146,355,5778
Vermont,North Bennington village,1709,850,481,129,7,88,1555
Vermont,Winooski,7232,3193,2184,485,79,357,6298
Vermont,South Burlington,18975,5276,8134,1978,172,1059,16619
Vermont,Waterbury village,1748,502,645,158,24,90,1419
Vermont,Perkinsville village,108,20,44,20,0,9,93
Vermont,Hyde Park village,432,106,178,66,3,10,363
Vermont,Swanton village,2371,553,842,369,41,207,2012
Vermont,St. Johnsbury,5882,1345,2217,828,124,440,4954
Vermont,Castleton,1327,1185,70,19,0,53,1327
Vermont,Cavendish,133,50,57,14,0,3,124
Vermont,Chester,798,198,416,94,13,43,764
Vermont,Concord,268,82,80,46,3,11,222
Vermont,Coventry,34,0,16,14,0,0,30
Vermont,Danville,399,122,161,34,0,13,330
Vermont,Dorset,250,54,152,12,0,11,229
Vermont,East Barre,627,191,249,62,0,61,563
Vermont,East Burke,66,25,21,7,0,0,53
Vermont,East Middlebury,439,31,237,58,0,22,348
Vermont,East Montpelier,44,0,14,17,0,0,31
Vermont,Canaan,330,96,146,19,0,30,291
Vermont,Enosburg Falls village,1340,386,404,155,7,101,1053
Vermont,South Barre,1182,233,607,69,14,104,1027
Vermont,Burlington,42513,22952,10098,3092,340,1573,38055
Vermont,Brandon,1323,285,575,117,0,75,1052
Vermont,Island Pond,771,202,281,85,20,71,659
Vermont,Fair Haven,2280,562,891,273,17,83,1826
Vermont,Poultney village,1552,755,416,102,6,65,1344
Vermont,Arlington,1358,189,654,79,46,150,1118
Vermont,Bennington,8836,2600,2775,1353,95,855,7678
Vermont,Manchester Center,2033,573,765,122,32,98,1590
Vermont,Jericho village,1430,195,662,116,23,99,1095
Vermont,North Troy village,744,229,229,56,10,44,568
Vermont,Morrisville village,2183,491,884,244,13,200,1832
Vermont,West Brattleboro,2650,615,1039,360,0,89,2103
Vermont,Ludlow village,745,252,235,104,8,55,654
Vermont,Middlebury,6855,3619,1506,626,36,423,6210
Vermont,Barre,8711,2521,2367,1794,72,454,7208
Vermont,West Burke village,325,75,96,68,20,19,278
Vermont,Saxtons River village,494,150,172,37,5,11,375
Vermont,White River Junction,2290,660,804,330,9,105,1908
Vermont,Albany village,211,21,118,4,0,0,143
Vermont,Derby Line village,758,227,302,60,0,39,628
Vermont,Wallingford,932,150,401,176,6,56,789
Vermont,West Rutland,2151,552,933,176,15,105,1781
Vermont,Orleans village,897,272,324,80,0,38,714
Vermont,Barton village,529,133,178,82,13,74,480
Vermont,Old Bennington village,178,27,101,25,3,1,157
Vermont,Johnson village,1532,828,296,154,5,21,1304
Vermont,Fairlee,249,39,86,50,0,9,184
Vermont,Glover,320,52,95,61,13,58,279
Vermont,South Shaftsbury,589,152,195,61,0,54,462
Vermont,Greensboro,105,9,63,12,0,18,102
Vermont,Northfield,1945,564,621,256,20,168,1629
Vermont,Ascutney,451,63,193,102,0,24,382
Vermont,Barnet,160,42,48,38,0,12,140
Vermont,Beecher Falls,204,41,109,17,0,20,187
Vermont,Benson,257,86,84,27,0,26,223
Vermont,Bethel,674,211,243,36,0,33,523
Vermont,Cambridge village,219,67,86,30,3,3,189
Vermont,Montpelier,7547,2191,2750,965,117,442,6465
Vermont,Newbury village,339,52,131,50,1,27,261
Vermont,Lyndonville village,1314,484,317,220,29,76,1126
Vermont,Jeffersonville village,793,264,230,78,18,23,613
Vermont,Westminster village,282,27,176,22,3,20,248
Vermont,Manchester village,741,98,352,129,0,123,702
Vermont,Graniteville,969,302,354,163,14,46,879
Vermont,Norwich,664,129,284,106,9,2,530
Vermont,Newfane village,134,28,64,8,0,8,108
Vermont,Bellows Falls village,2985,881,804,542,59,201,2487
Vermont,Wells River village,396,92,151,61,5,31,340
Vermont,Marshfield village,288,79,87,24,1,17,208
Vermont,Newport,4331,1279,1348,776,24,268,3695
Vermont,Rutland,15577,4175,5994,2012,238,1032,13451
Vermont,Fairfax,928,217,343,89,73,0,722
Vermont,Richford,1620,405,543,287,0,81,1316
Vermont,Woodstock village,1517,374,528,141,46,105,1194
Vermont,Bristol,1746,452,697,206,0,159,1514
Vermont,Bradford,528,167,175,83,5,15,445
Vermont,Milton,2217,438,976,111,8,135,1668
Vermont,Lowell,150,36,66,6,10,10,128
Vermont,Newport Center,302,108,105,36,0,0,249
Vermont,North Hartland,145,43,66,20,0,16,145
Vermont,North Springfield,548,163,62,120,0,151,496
Vermont,Irasburg,115,32,41,13,8,5,99
Vermont,Hartland,242,83,65,80,0,0,228
Vermont,Greensboro Bend,258,43,91,17,0,16,167
Vermont,Hardwick,1313,194,573,116,47,76,1006
Vermont,Derby Center village,585,160,197,78,0,57,492
Vermont,St. Albans,6824,1928,2302,858,45,338,5471
Vermont,Groton,384,104,159,37,7,22,329
Village of Islands village; Florida,Islamorada,6473,1178,3343,906,53,388,5868
Virginia,Cumberland,234,56,154,24,0,0,234
Virginia,Crosspointe,5879,1391,3246,116,18,112,4883
Virginia,County Center,3373,700,1307,227,91,95,2420
Virginia,Countryside,10042,2621,4528,799,109,136,8193
Virginia,Concord,974,111,539,83,45,43,821
Virginia,Cluster Springs,710,188,376,24,18,104,710
Virginia,Clover,280,53,151,39,0,23,266
Virginia,Churchville,191,30,112,24,0,0,166
Virginia,Quantico,519,171,180,70,19,19,459
Virginia,Yorkshire,9582,2513,3707,723,164,200,7307
Virginia,Boston,891,317,139,60,16,39,571
Virginia,Irvington,349,31,228,36,2,29,326
Virginia,Portsmouth,95311,28925,28427,10153,3088,5616,76209
Virginia,Bensley,6327,2608,1384,649,136,211,4988
Virginia,Scottsburg,383,22,179,15,12,8,236
Virginia,Belle Haven,6877,1893,2767,708,70,184,5622
Virginia,Burke,42722,9129,21511,2213,422,1265,34540
Virginia,Dunn Loring,9155,1799,4578,403,140,354,7274
Virginia,Hybla Valley,16325,4237,6231,1157,421,343,12389
Virginia,Rural Retreat,1644,272,801,140,43,123,1379
Virginia,Bridgewater,5983,1888,2414,342,59,473,5176
Virginia,Sugar Grove,745,170,258,77,46,27,578
Virginia,Pulaski,8794,1963,3462,1008,449,541,7423
Virginia,Elkton,2823,693,1226,206,71,227,2423
Virginia,Coeburn,1669,304,662,150,41,138,1295
Virginia,Chester Gap,985,180,272,200,52,72,776
Virginia,Cherry Hill,19731,5300,7231,1318,643,478,14970
Virginia,Carrsville,129,8,43,48,0,20,119
Virginia,Charles City,64,18,19,11,0,10,58
Virginia,Bobtown,268,50,171,0,0,11,232
Virginia,Blue Ridge Shores,926,354,291,90,28,48,811
Virginia,Bland,445,131,155,63,11,10,370
Virginia,Blairs,844,111,524,34,11,30,710
Virginia,Big Island,191,0,80,54,0,30,164
Virginia,Bethel Manor,4110,375,1982,14,0,22,2393
Virginia,Bracey,1101,93,709,131,21,93,1047
Virginia,Brambleton,20081,2718,9826,867,150,194,13755
Virginia,Brandermill,14421,2740,7258,1425,116,572,12111
Virginia,Brightwood,1299,270,566,55,54,122,1067
Virginia,Pembroke,1056,174,422,158,6,112,872
Virginia,Broadlands,13704,2376,6467,561,91,287,9782
Virginia,Chase Crossing,272,28,221,0,0,9,258
Virginia,Buckhall,17238,3849,8443,748,255,475,13770
Virginia,Bull Run Mountain Estates,1287,363,580,86,0,31,1060
Virginia,Burke Centre,18236,4552,8391,1263,160,441,14807
Virginia,Callaghan,258,72,108,37,0,41,258
Virginia,Calverton,113,56,37,9,0,0,102
Virginia,Camptown,861,258,225,72,18,86,659
Virginia,Captains Cove,1266,213,761,54,0,31,1059
Virginia,Carrollton,6131,1328,2864,539,81,103,4915
Virginia,Boswell's Corner,1106,244,539,31,8,31,853
Virginia,Cascades,11670,2742,5280,821,214,384,9441
Virginia,Catlett,260,147,87,0,0,0,234
Virginia,Cats Bridge,166,57,82,13,0,14,166
Virginia,Central Garage,1472,190,665,224,14,74,1167
Virginia,Buckingham Courthouse,94,0,69,0,0,0,69
Virginia,Port Royal,194,40,66,32,0,4,142
Virginia,Lowes Island,11111,2213,5408,571,88,388,8668
Virginia,Stanardsville,307,44,112,47,11,31,245
Virginia,McKenney,493,148,174,49,5,49,425
Virginia,Dublin,2655,741,855,474,184,127,2381
Virginia,Shenandoah,2888,654,1019,366,26,157,2222
Virginia,Lake Monticello,10210,1650,5378,834,64,476,8402
Virginia,Castlewood,2058,346,750,310,80,177,1663
Virginia,Dryden,1282,238,533,157,28,20,976
Virginia,Hillsville,2671,625,1071,349,157,178,2380
Virginia,Collinsville,7031,1800,2793,827,220,500,6140
Virginia,Highland Springs,15855,5630,4259,1490,471,798,12648
Virginia,Union Hall,1091,87,757,65,0,92,1001
Virginia,Ferrum,2233,1474,505,56,0,108,2143
Virginia,Eastville,206,68,68,14,4,10,164
Virginia,South Hill,4411,1381,1150,422,71,460,3484
Virginia,Chase City,2401,840,593,235,134,218,2020
Virginia,Ewing,127,16,29,20,7,55,127
Virginia,Exmore,1521,346,453,318,53,130,1300
Virginia,La Crosse,638,156,173,28,47,96,500
Virginia,Williamsburg,14788,8161,3361,1098,195,656,13471
Virginia,Selma,397,68,123,70,0,77,338
Virginia,Dumbarton,9036,2896,2469,1060,301,290,7016
Virginia,Dillwyn,541,146,172,39,12,63,432
Virginia,Warsaw,1704,415,560,283,72,115,1445
Virginia,Claremont,323,45,171,25,19,38,298
Virginia,Rocky Mount,4747,1160,1549,536,79,588,3912
Virginia,Sherando,612,170,310,16,17,54,567
Virginia,Dooms,1074,158,513,91,21,102,885
Virginia,Capron,139,17,71,18,1,12,119
Virginia,Merrimac,2127,494,664,285,15,286,1744
Virginia,Christiansburg,22049,4295,9736,2384,357,1224,17996
Virginia,Montross,430,78,157,55,2,59,351
Virginia,Waynesboro,21926,5391,7697,2245,715,1425,17473
Virginia,Groveton,16843,4100,7239,1030,257,558,13184
Virginia,Franconia,19725,5726,7974,1538,313,643,16194
Virginia,Kilmarnock,1478,314,533,224,24,197,1292
Virginia,Rose Hill CDP (Fairfax County),22011,5262,9681,1448,333,884,17608
Virginia,Waverly,2051,576,694,235,44,102,1651
Virginia,Laurel,17470,6156,5315,1825,548,656,14500
Virginia,Cheriton,508,140,192,27,26,75,460
Virginia,Mineral,507,114,209,43,22,32,420
Virginia,Windsor,2700,537,979,344,73,217,2150
Virginia,West Springfield,23202,5343,10611,1695,276,838,18763
Virginia,Bailey's Crossroads,24570,7890,8304,1554,464,1189,19401
Virginia,Clintwood,1434,284,504,211,48,217,1264
Virginia,Aquia Harbour,6805,1249,3614,554,74,191,5682
Virginia,Pearisburg,2669,571,1018,318,92,70,2069
Virginia,Fort Belvoir,8091,1008,3397,203,13,6,4627
Virginia,Ettrick,5159,2912,996,296,195,161,4560
Virginia,Sudley,17612,4493,6056,1598,640,519,13306
Virginia,Brodnax,283,88,111,35,9,7,250
Virginia,Cape Charles,1145,232,489,120,58,88,987
Virginia,Mantua,7520,1562,3397,496,60,461,5976
Virginia,Lebanon,3249,863,1034,388,160,431,2876
Virginia,East Highland Park,15592,5557,4184,2002,326,950,13019
Virginia,Cedar Bluff,1081,210,513,104,39,65,931
Virginia,Weyers Cave,2171,432,904,219,117,77,1749
Virginia,Tappahannock,1925,620,541,204,36,144,1545
Virginia,Manassas Park,16423,4197,6263,1523,549,418,12950
Virginia,Hollins,14257,3297,6345,1282,252,1149,12325
Virginia,Monterey,125,27,58,15,0,18,118
Virginia,Goshen,333,63,110,62,4,29,268
Virginia,Duffield,79,24,30,4,5,10,73
Virginia,Greenville,1675,332,689,197,14,41,1273
Virginia,Pimmit Hills,6506,1386,2963,304,69,301,5023
Virginia,Newington,13080,2705,6291,774,139,221,10130
Virginia,Lorton,20691,5004,8717,1347,387,587,16042
Virginia,Herndon,24520,6801,10065,1660,325,482,19333
Virginia,Virgilina,104,8,55,9,0,13,85
Virginia,Wyndham,10151,1824,5339,264,48,324,7799
Virginia,Chesapeake,237820,56912,99759,19591,4455,9727,190444
Virginia,Front Royal,15240,4269,4493,1772,650,1024,12208
Virginia,Parksley,679,174,224,84,32,48,562
Virginia,Sandy Level,571,174,247,44,0,64,529
Virginia,Horse Pasture,2136,320,658,345,70,235,1628
Virginia,Brookneal,871,245,270,70,31,124,740
Virginia,Haysi,571,259,149,74,29,26,537
Virginia,Clinchco,303,66,101,34,12,35,248
Virginia,Yorktown,215,52,98,56,0,9,215
Virginia,Chilhowie,1855,346,766,190,49,237,1588
Virginia,Roanoke,99621,29089,30558,12603,2332,6293,80875
Virginia,Bull Run,15683,4266,5262,1302,523,467,11820
Virginia,Matoaca,2517,517,810,407,34,218,1986
Virginia,Twin Lakes,1494,202,698,94,21,61,1076
Virginia,Belspring,120,0,65,0,0,29,94
Virginia,Clifton Forge,3603,936,1039,507,45,441,2968
Virginia,Winchester,27789,8163,9152,3018,555,1637,22525
Virginia,Vinton,8074,1817,3085,1101,124,613,6740
Virginia,Saltville,2621,480,983,249,60,171,1943
Virginia,Laymantown,2012,203,1255,84,0,79,1621
Virginia,Verona,3964,1230,1328,387,232,210,3387
Virginia,Forest,10298,2031,5128,866,175,451,8651
Virginia,Woodbridge,4400,955,1923,459,40,166,3543
Virginia,Danville,41512,11916,12849,4242,1616,3228,33851
Virginia,Colonial Beach,3555,520,1186,725,28,330,2789
Virginia,Wolf Trap,16911,3053,9399,430,104,470,13456
Virginia,Vienna,16488,3071,7931,873,155,702,12732
Virginia,Salem,25519,6913,9566,3066,407,1570,21522
Virginia,Fort Hunt,16858,2422,8950,679,72,762,12885
Virginia,South Boston,7828,2790,2022,678,317,719,6526
Virginia,Woodlawn CDP (Fairfax County),23406,7365,7469,1615,462,410,17321
Virginia,Columbia,78,24,42,5,2,1,74
Virginia,Tysons,23749,6944,9785,2072,327,784,19912
Virginia,Mount Hermon,4137,684,2369,307,33,123,3516
Virginia,Palmyra,123,45,59,11,0,0,115
Virginia,Opal,719,208,267,61,15,42,593
Virginia,Oak Hall,108,54,54,0,0,0,108
Virginia,Oak Grove,2468,478,1276,99,0,100,1953
Virginia,Nottoway Court House,166,46,81,6,22,11,166
Virginia,New River,396,98,123,92,26,27,366
Virginia,New Kent,385,72,207,0,54,0,333
Virginia,Bon Air,17764,4779,6556,1858,481,1044,14718
Virginia,Newington Forest,12476,2599,6015,729,97,289,9729
Virginia,New Church,203,44,93,0,0,14,151
Virginia,New Baltimore,9831,1627,4782,566,132,363,7470
Virginia,Nelsonia,581,112,323,13,0,50,498
Virginia,Nellysford,1447,147,894,151,33,108,1333
Virginia,Neabsco,16947,4408,7510,1118,231,326,13593
Virginia,Nathalie,57,0,57,0,0,0,57
Virginia,Mount Sidney,501,67,305,0,17,0,389
Virginia,New Hope,757,131,245,25,0,95,496
Virginia,Parrott,420,44,123,53,35,45,300
Virginia,Pennington Gap,1974,318,624,347,108,291,1688
Virginia,Weber City,1534,375,561,165,30,225,1356
Virginia,Stanley,1730,432,668,197,56,117,1470
Virginia,Woodstock,5192,942,1628,676,118,547,3911
Virginia,Alexandria,156505,51782,57393,13879,3402,4862,131318
Virginia,Wytheville,8000,1932,3002,1003,139,791,6867
Virginia,Great Falls,15394,2697,8775,405,81,579,12537
Virginia,Centreville,75452,18912,34027,4453,758,1771,59921
Virginia,Annandale,43729,13154,16623,3082,943,1784,35586
Virginia,Culpeper,18113,4957,5949,1344,561,660,13471
Virginia,Chatham,1210,322,465,121,47,117,1072
Virginia,Blacksburg,44245,29003,8731,1663,237,894,40528
Virginia,New Castle,187,60,52,28,14,7,161
Virginia,Grundy,911,274,285,50,24,97,730
Virginia,Blue Ridge,3237,563,1736,234,80,200,2813
Virginia,Fort Chiswell,888,204,335,80,48,34,701
Virginia,Stuarts Draft,9716,1499,4764,695,342,546,7846
Virginia,Patrick Springs,1808,275,943,172,66,169,1625
Virginia,Stuart,1499,335,460,225,69,285,1374
Virginia,Lawrenceville,1380,768,131,149,31,57,1136
Virginia,Rustburg,1477,343,477,207,88,108,1223
Virginia,Gate City,2406,443,1032,253,64,119,1911
Virginia,Pamplin City,79,12,43,4,5,1,65
Virginia,Westlake Corner,1002,70,676,116,7,32,901
Virginia,Crimora,1999,352,829,200,64,117,1562
Virginia,Craigsville,816,134,314,96,27,113,684
Virginia,Raven,1666,369,501,197,39,295,1401
Virginia,Branchville,112,19,39,22,3,9,92
Virginia,Clifton,275,38,175,19,0,1,233
Virginia,Louisa,1724,426,540,210,40,155,1371
Virginia,Hamilton,537,117,251,47,4,31,450
Virginia,Hopewell,22408,6310,6801,2275,498,1646,17530
Virginia,Crozet,6526,769,3017,723,102,417,5028
Virginia,Crewe,2448,586,901,350,50,118,2005
Virginia,Blackstone,3438,725,1427,204,140,239,2735
Virginia,Stanleytown,1297,239,614,158,7,111,1129
Virginia,Chatmoss,1405,363,651,66,81,123,1284
Virginia,Hampton,135583,41042,44772,14945,3395,7272,111426
Virginia,Benns Church,528,107,186,33,2,147,475
Virginia,Passapatanzy,1449,327,554,190,12,23,1106
Virginia,Piney Mountain,1390,318,463,153,12,120,1066
Virginia,Whitesville,123,31,57,0,16,0,104
Virginia,Wattsville,855,127,349,118,38,65,697
Virginia,Warm Springs,31,0,31,0,0,0,31
Virginia,Warfield,81,0,35,35,11,0,81
Virginia,Wakefield,11782,2344,6256,471,99,390,9560
Virginia,University of Virginia,8487,6877,1062,109,50,55,8153
Virginia,University Center,4060,1606,1342,353,34,55,3390
Virginia,Union Level,195,52,32,55,0,25,164
Virginia,Spotsylvania Courthouse,4679,949,1890,545,96,141,3621
Virginia,Thynedale,158,52,22,31,0,53,158
Virginia,Templeton,205,59,113,13,0,20,205
Virginia,Temperanceville,259,96,124,25,0,0,245
Virginia,Tasley,531,176,50,43,21,14,304
Virginia,Sussex,264,32,89,16,31,11,179
Virginia,Sugarland Run,12576,3427,5443,545,101,214,9730
Virginia,Wintergreen,502,30,371,27,38,36,502
Virginia,Woodburn,8462,2277,3781,586,77,258,6979
Virginia,Woodlake,7299,1376,3346,583,140,172,5617
Virginia,Woodlawn CDP (Carroll County),2110,350,1029,139,82,131,1731
Virginia,Belmont Estates,2012,441,791,15,15,111,1373
Virginia,Belmont,6629,1217,3245,158,83,97,4800
Virginia,Belview,973,174,484,90,0,73,821
Virginia,Bealeton,4646,1288,1917,295,89,167,3756
Virginia,Bayside,273,131,50,0,0,22,203
Virginia,Basye,920,211,444,157,0,57,869
Virginia,Baskerville,72,3,46,0,0,0,49
Virginia,Stone Ridge,12990,1627,6175,605,194,188,8789
Virginia,Augusta Springs,209,102,64,34,0,9,209
Virginia,Ashburn,50290,10246,23240,3308,488,1547,38829
Virginia,Arrington,710,104,304,3,50,37,498
Virginia,Arcola,963,132,577,30,20,0,759
Virginia,Apple Mountain Lake,1334,227,605,129,55,34,1050
Virginia,Amelia Court House,889,95,275,91,69,128,658
Virginia,Allisonia,114,27,16,25,16,10,94
Virginia,Yogaville,124,33,58,6,22,5,124
Virginia,Atlantic,950,101,451,62,158,96,868
Virginia,Pastoria,979,75,277,31,25,115,523
Virginia,Sterling,30403,8435,12154,1887,720,1009,24205
Virginia,Springville,1326,293,735,60,20,45,1153
Virginia,Saluda,691,206,250,50,33,78,617
Virginia,Ruckersville,1321,234,616,156,20,39,1065
Virginia,Rockwood,7712,1715,3637,886,125,344,6707
Virginia,Riverview,775,180,301,82,40,18,621
Virginia,Riverdale,737,111,372,65,0,55,603
Virginia,Rivanna,1707,210,1158,87,0,91,1546
Virginia,Riner,1149,105,610,35,19,30,799
Virginia,Ravensworth,2245,415,1220,162,17,75,1889
Virginia,Quinby,226,14,138,17,0,40,209
Virginia,Quantico Base,5213,1846,1802,76,31,10,3765
Virginia,Pungoteague,245,78,106,49,0,12,245
Virginia,Prince George,2129,372,715,224,60,120,1491
Virginia,Prices Fork,1198,159,505,140,99,57,960
Virginia,Potomac Mills,6468,1485,2900,424,68,53,4930
Virginia,Plum Creek,1339,481,265,111,63,237,1157
Virginia,Savageville,50,12,0,0,0,38,50
Virginia,Sandston,7056,1931,1948,1056,222,342,5499
Virginia,Sanford,91,0,44,32,0,0,76
Virginia,Savage Town,21,0,0,0,21,0,21
Virginia,Sperryville,244,40,134,10,0,31,215
Virginia,Southside Chesconessex,106,0,96,0,0,10,106
Virginia,South Run,6308,1100,3451,263,18,203,5035
Virginia,South Riding,31071,4920,15209,1322,294,722,22467
Virginia,Southern Gateway,3724,1186,1393,233,25,49,2886
Virginia,Snowville,51,16,19,0,0,10,45
Virginia,Skyland Estates,1055,294,436,184,0,27,941
Virginia,Stafford Courthouse,3786,1231,1487,262,125,55,3160
Virginia,Shipman,285,163,21,61,23,17,285
Virginia,Shenandoah Retreat,660,169,182,203,10,16,580
Virginia,Shenandoah Farms,3807,579,1832,331,52,85,2879
Virginia,Shawneeland,1633,222,902,127,27,51,1329
Virginia,Seven Mile Ford,595,114,242,89,0,68,513
Virginia,Sedley,400,74,153,71,0,42,340
Virginia,Scotland,110,0,84,0,0,7,91
Virginia,Schuyler,98,21,15,24,0,23,83
Virginia,Shenandoah Shores,939,263,324,89,10,27,713
Virginia,Wise,3047,814,1251,416,29,215,2725
Virginia,Tazewell,4327,899,1871,379,47,331,3527
Virginia,Gloucester Courthouse,2361,419,1069,181,31,293,1993
Virginia,Deltaville,1050,224,490,69,13,81,877
Virginia,Deerfield,127,84,0,24,0,8,116
Virginia,Deep Creek,42,0,0,13,0,0,13
Virginia,Dahlgren Center,649,161,294,11,7,0,473
Virginia,Smithfield,8324,1796,3830,541,107,424,6698
Virginia,Courtland,1958,480,702,130,78,175,1565
Virginia,Dranesville,11802,2524,6226,477,8,307,9542
Virginia,Ridgeway,1047,208,386,82,43,74,793
Virginia,Bassett,959,273,396,52,7,107,835
Virginia,Lexington,7110,4395,1442,485,28,330,6680
Virginia,Virginia Beach,450135,112082,185361,40480,9192,18588,365703
Virginia,Fairfax,23865,6307,10450,1227,322,943,19249
Virginia,Charlotte Court House,583,154,212,81,16,32,495
Virginia,Staunton,24452,6116,9395,2769,465,1840,20585
Virginia,Oak Level,658,100,244,63,25,118,550
Virginia,Draper,388,153,163,44,15,0,375
Virginia,Dulles Town Center,5023,1431,1924,277,234,64,3930
Virginia,East Lexington,916,294,349,146,0,14,803
Virginia,Gasburg,618,8,421,31,0,0,460
Virginia,Gargatha,162,24,78,13,0,21,136
Virginia,Free Union,249,73,123,24,0,0,220
Virginia,Franklin Farm,18727,3417,9827,849,192,449,14734
Virginia,Floris,8305,1627,4495,163,47,257,6589
Virginia,Flint Hill,398,17,179,63,0,38,297
Virginia,Fairview,156,30,21,17,0,88,156
Virginia,Fair Oaks,33700,10234,14064,2312,522,870,28002
Virginia,Fair Lakes,8314,2464,3375,646,159,207,6851
Virginia,Fairfax Station,11934,2989,6037,600,117,408,10151
Virginia,Esmont,857,212,302,45,41,24,624
Virginia,Enon,4310,759,1920,332,157,86,3254
Virginia,Emory,1306,837,340,6,11,18,1212
Virginia,Elliston,886,461,234,0,0,0,695
Virginia,Ebony,202,99,61,0,0,29,189
Virginia,Timberville,2613,662,869,330,78,107,2046
Virginia,George Mason,9711,5871,2405,196,36,198,8706
Virginia,Stephens City,1989,504,697,195,34,87,1517
Virginia,Drakes Branch,896,264,132,81,41,77,595
Virginia,Troutdale,167,30,75,26,8,13,152
Virginia,Independence,1139,223,354,180,42,142,941
Virginia,Glen Lyn,91,8,43,6,6,9,72
Virginia,Phenix,228,47,83,19,0,37,186
Virginia,Lovettsville,2544,507,1030,156,34,55,1782
Virginia,Radford,17630,10064,3511,1421,288,806,16090
Virginia,Middleburg,620,105,222,110,41,31,509
Virginia,Lynchburg,80131,32357,23056,6537,1302,3742,66994
Virginia,Alberta,350,96,119,51,13,26,305
Virginia,Burkeville,520,126,166,90,20,62,464
Virginia,Scottsville,535,144,168,55,20,42,429
Virginia,Poquoson,12039,2435,5895,918,55,656,9959
Virginia,New Market,2341,514,939,339,77,205,2074
Virginia,Edinburg,1261,307,556,105,17,67,1052
Virginia,Dungannon,321,52,97,56,12,17,234
Virginia,Falls Church,14067,3370,5946,1072,170,533,11091
Virginia,Hillsboro,175,54,87,6,0,3,150
Virginia,Purcellville,9709,2093,4548,495,160,237,7533
Virginia,Dayton,1567,317,732,115,10,76,1250
Virginia,Appalachia,1469,383,419,170,49,123,1144
Virginia,Surry,311,64,149,13,0,21,247
Virginia,The Plains,194,45,80,35,4,9,173
Virginia,Middletown,1516,370,567,131,34,49,1151
Virginia,Abingdon,8020,1811,2914,1081,297,826,6929
Virginia,Floyd,658,194,273,44,12,30,553
Virginia,Bristol,16843,3487,6701,2000,531,1237,13956
Virginia,Fieldale,1116,313,176,165,13,163,830
Virginia,Manassas,41457,10341,17041,2622,646,1287,31937
Virginia,Haymarket,1629,300,798,74,13,20,1205
Virginia,Boydton,377,103,164,38,4,18,327
Virginia,Fancy Gap,103,6,38,15,0,44,103
Virginia,Toms Brook,407,47,144,50,6,13,260
Virginia,Orange,4935,1370,1397,693,281,284,4025
Virginia,Fincastle,411,112,168,41,22,24,367
Virginia,Newport News,180145,55939,59165,17192,4987,7382,144665
Virginia,Glenvar,1066,106,434,75,7,326,948
Virginia,Gratton,1088,272,517,46,23,53,911
Virginia,Meadow View,1307,322,433,178,19,97,1049
Virginia,Metompkin,515,46,113,0,73,91,323
Virginia,Middlebrook,87,36,0,0,0,0,36
Virginia,Midland,56,3,36,7,0,0,46
Virginia,Modest Town,171,22,74,28,0,47,171
Virginia,Montvale,536,113,246,32,18,71,480
Virginia,Meadowbrook,19532,5598,7336,1786,279,974,15973
Virginia,Moorefield Station,1369,478,490,83,16,26,1093
Virginia,Mountain Road,762,197,212,115,16,164,704
Virginia,West Falls Church,29154,8650,11841,2070,453,810,23824
Virginia,Lancaster,56,14,5,37,0,0,56
Virginia,Pantops,3569,803,1352,510,10,471,3146
Virginia,Powhatan,342,0,247,39,0,52,338
Virginia,Bedford,6527,1772,2315,503,57,612,5259
Virginia,Motley,896,177,438,105,0,67,787
Virginia,Maurertown,995,201,539,25,30,67,862
Virginia,Mathews,589,135,224,130,11,45,545
Virginia,Massanetta Springs,5517,903,2965,257,50,408,4583
Virginia,Lovingston,574,180,107,128,46,42,503
Virginia,Loudoun Valley Estates,7528,979,3838,328,23,89,5257
Virginia,Long Branch,8225,1563,3968,505,71,532,6639
Virginia,Lee Mont,27,10,0,0,0,17,27
Virginia,Laurel Hill,8194,1967,3647,489,57,306,6466
Virginia,Lansdowne,12696,2501,5833,824,145,689,9992
Virginia,McMullin,436,91,229,41,0,50,411
Virginia,McNair,20771,5229,8791,1212,261,351,15844
Virginia,Makemie Park,309,72,32,75,27,5,211
Virginia,Manchester,10807,2963,3864,1121,161,734,8843
Virginia,Mappsburg,69,23,27,7,0,0,57
Virginia,Mappsville,367,271,0,0,96,0,367
Virginia,Marshall,2088,534,806,73,57,67,1537
Virginia,Marumsco,40741,10888,14523,3402,1224,938,30975
Virginia,Mason Neck,1969,415,906,92,62,116,1591
Virginia,Southampton Meadows,399,52,212,0,49,34,347
Virginia,Goochland,779,114,424,45,6,35,624
Virginia,Buchanan,1179,173,501,203,3,75,955
Virginia,Onancock,1227,318,481,111,28,133,1071
Virginia,Hollymead,8393,1623,3578,750,178,491,6620
Virginia,Hiwassee,350,53,218,19,0,15,305
Virginia,Henry Fork,1511,374,432,139,63,109,1117
Virginia,Horntown,494,56,138,0,42,77,313
Virginia,Heathsville,112,16,96,0,0,0,112
Virginia,Hayfield,4335,890,2065,218,42,167,3382
Virginia,Hot Springs,567,232,78,57,1,115,483
Virginia,Harriston,1255,452,466,101,37,62,1118
Virginia,Hanover,164,11,109,34,0,10,164
Virginia,Hampden-Sydney,1716,1456,198,37,0,0,1691
Virginia,Gwynn,391,116,240,35,0,0,391
Virginia,Greenbush,199,63,62,8,0,17,150
Virginia,Greenbriar,8575,2083,3769,543,126,310,6831
Virginia,Greenbackville,0,0,0,0,0,0,0
Virginia,Harborton,258,77,129,0,0,0,206
Virginia,Independent Hill,9499,2011,4639,329,70,247,7296
Virginia,Innsbrook,8549,1745,4269,350,114,182,6660
Virginia,Ivanhoe,437,130,135,44,25,40,374
Virginia,Onley,809,92,281,93,55,46,567
Virginia,Daleville,3261,657,1790,132,40,233,2852
Virginia,Lake Wilderness,2708,582,1127,286,21,62,2078
Virginia,Lake of the Woods,7649,1236,3952,770,115,395,6468
Virginia,Lake Land'Or,4193,802,1621,517,109,116,3165
Virginia,Lake Holiday,1788,182,1041,124,0,61,1408
Virginia,Lake Caroline,1850,366,816,218,0,137,1537
Virginia,Lafayette,906,314,147,130,19,35,645
Virginia,King William,325,74,128,21,0,14,237
Virginia,Kingstowne,17172,4378,7512,1399,199,592,14080
Virginia,Kings Park West,14077,3777,6563,699,132,397,11568
Virginia,Kings Park,5064,1104,2285,241,107,149,3886
Virginia,King George,5028,1027,2142,433,100,161,3863
Virginia,King and Queen Court House,162,0,111,14,11,0,136
Virginia,Ivy,511,27,248,15,14,16,320
Virginia,Cloverdale,3501,691,1525,401,18,176,2811
Virginia,Jarratt,845,234,279,73,18,50,654
Virginia,Atkins,817,205,333,128,31,56,753
Virginia,Adwolf,1673,328,810,105,43,117,1403
Virginia,Painter,272,62,79,12,14,23,190
Virginia,Chincoteague,2899,429,1637,193,10,353,2622
Virginia,Bloxom,447,94,182,56,10,22,364
Virginia,Berryville,4293,950,1586,366,165,417,3484
Virginia,Lunenburg,187,21,166,0,0,0,187
Virginia,Richlands,5439,1048,2288,483,178,568,4565
Virginia,Petersburg,31827,12258,6960,3421,1176,2188,26003
Virginia,West Point,3301,626,1621,228,22,227,2724
Virginia,Jolivue,890,213,336,152,0,48,749
Virginia,Madison Heights,11483,2916,4117,1264,317,735,9349
Virginia,Pocahontas,301,53,119,43,4,46,265
Virginia,Gretna,1310,284,499,133,26,177,1119
Virginia,Glade Spring,1429,192,619,176,21,155,1163
Virginia,Damascus,709,118,266,99,8,51,542
Virginia,Reston,60335,16030,25524,5699,840,1893,49986
Virginia,Linton Hall,41088,7990,18797,1872,399,641,29699
Virginia,Loch Lomond,4601,1426,1757,289,40,247,3759
Virginia,Mount Jackson,2451,657,891,222,26,115,1911
Virginia,Fishersville,8252,1918,3664,536,105,675,6898
Virginia,Newsoms,283,77,120,30,11,20,258
Virginia,Kenbridge,1015,256,273,151,63,83,826
Virginia,Troutville,455,97,185,68,5,55,410
Virginia,Saxis,216,42,82,37,6,31,198
Virginia,Mount Crawford,400,92,198,29,6,12,337
Virginia,Grottoes,2756,474,1431,234,59,52,2250
Virginia,Gloucester Point,9294,1898,4234,919,185,481,7717
Virginia,Urbanna,474,74,230,49,11,55,419
Virginia,Victoria,2043,561,680,212,104,136,1693
Virginia,Hallwood,258,58,80,37,12,12,199
Virginia,Bluefield,4984,1279,1777,606,46,500,4208
Virginia,Hurt,1478,279,699,153,54,81,1266
Virginia,Washington,95,27,35,25,0,8,95
Virginia,Richmond,223787,99397,50727,22664,5650,10812,189250
Virginia,Wakefield,1022,269,363,85,31,81,829
Virginia,Tangier,524,73,306,33,0,59,471
Virginia,Gordonsville,1708,496,605,178,29,144,1452
Virginia,Strasburg,6585,1325,2629,697,50,377,5078
Virginia,Iron Gate,262,54,124,22,4,19,223
Virginia,Merrifield,17789,6602,7094,1356,220,189,15461
Virginia,Fort Lee,5409,953,2104,201,51,85,3394
Virginia,Charlottesville,47042,21489,12981,4020,747,1425,40662
Virginia,Big Stone Gap,5326,1652,1876,441,155,389,4513
Virginia,Dendron,340,96,154,28,6,16,300
Virginia,Idylwood,18431,5740,7575,1104,207,431,15057
Virginia,Villa Heights,633,102,392,83,0,41,618
Virginia,Emporia,5381,1549,1431,624,113,501,4218
Virginia,Suffolk,89160,20655,37314,6636,2069,4163,70837
Virginia,Massanutten,2472,621,1073,202,58,113,2067
Virginia,Glasgow,1487,365,570,111,9,131,1186
Virginia,Fredericksburg,28469,10694,8416,2618,757,858,23343
Virginia,Fries,479,98,166,55,20,49,388
Virginia,Remington,767,187,220,81,40,43,571
Virginia,Oakton,37185,9205,17029,2443,390,844,29911
Virginia,Springfield,31117,9024,12718,1580,551,2035,25908
Virginia,Rushmere,980,186,496,76,0,87,845
Virginia,Martinsville,13101,3594,4206,1383,252,996,10431
Virginia,Honaker,1330,266,448,183,55,165,1117
Virginia,Cleveland,138,36,38,9,13,18,114
Virginia,Nassawadox,545,129,133,64,33,136,495
Virginia,Dahlgren,3202,791,1249,181,62,138,2421
Virginia,Tuckahoe,48282,10842,20642,3904,787,2454,38629
Virginia,Penhook,878,128,663,39,0,9,839
Virginia,Melfa,386,115,134,34,15,39,337
Virginia,Keller,176,37,80,21,3,14,155
Virginia,Chamberlayne,6186,1540,2743,759,39,372,5453
Virginia,Accomac,451,140,162,35,10,50,397
Virginia,Lyndhurst,1803,373,853,159,39,57,1481
Virginia,Boykins,854,228,406,42,14,44,734
Virginia,Shawsville,1836,431,840,182,2,18,1473
Virginia,Madison,196,91,34,6,3,37,171
Virginia,Fairlawn,2538,624,1225,202,31,150,2232
Virginia,Wachapreague,195,30,76,38,0,32,176
Virginia,Max Meadows,299,74,166,17,0,42,299
Virginia,Vansant,433,72,202,41,20,34,369
Virginia,Buena Vista,6399,1777,2468,621,131,371,5368
Virginia,Luray,4818,1169,1772,494,132,414,3981
Virginia,Occoquan,1155,260,532,127,18,33,970
Virginia,Jonesville,1248,259,460,164,37,87,1007
Virginia,Belle Haven,594,138,207,76,17,19,457
Virginia,Boyce,756,116,344,66,11,35,572
Virginia,Boones Mill,152,21,76,14,4,18,133
Virginia,Amherst,2569,591,984,297,26,298,2196
Virginia,Ivor,495,98,182,63,4,47,394
Virginia,Seven Corners,8576,2599,2888,678,257,427,6849
Virginia,Mount Vernon,12919,2524,6128,862,223,594,10331
Virginia,McLean,47075,7858,24905,1826,289,2342,37220
Virginia,Lincolnia,24808,7852,9536,1809,534,652,20383
Virginia,Chantilly,24559,6095,10883,1382,229,739,19328
Virginia,Claypool Hill,1307,123,772,85,52,107,1139
Virginia,Ashland,7655,3106,2094,884,115,439,6638
Virginia,Mechanicsville,37501,7096,17453,3510,532,2034,30625
Virginia,Falmouth,4928,989,2021,362,100,216,3688
Virginia,Rich Creek,734,189,242,103,10,86,630
Virginia,Harrisonburg,53391,26470,13111,3530,1072,1658,45841
Virginia,Arlington,231803,85527,87177,14868,2424,6344,196340
Virginia,Lakeside,12180,3424,4210,1588,366,586,10174
Virginia,Glen Allen,16454,4113,6498,1704,258,469,13042
Virginia,North Shore,3263,336,2162,212,0,131,2841
Virginia,Galax,6638,1030,2712,863,240,584,5429
Virginia,Nickelsville,342,69,142,35,10,31,287
Virginia,Farmville,8076,4826,1487,310,172,569,7364
Virginia,Fairview Beach,450,56,77,143,82,0,358
Virginia,North Springfield,7644,2171,3103,581,94,321,6270
Virginia,Lake Barcroft,9823,2298,4657,657,129,351,8092
Virginia,Huntington,13135,4451,5137,1284,224,360,11456
Virginia,Franklin,8211,1879,2640,958,298,691,6466
Virginia,White Stone,317,85,122,38,7,28,280
Virginia,Halifax,1314,323,564,96,64,123,1170
Virginia,Chester,22144,5488,8654,2185,652,918,17897
Virginia,Bellwood,6157,1885,1625,745,193,293,4741
Virginia,Norfolk,245592,92720,71312,22387,7354,9602,203375
Virginia,Bowling Green,1266,199,494,192,20,99,1004
Virginia,Norton,3990,692,1345,780,172,170,3159
Virginia,Round Hill,693,174,335,41,4,20,574
Virginia,Leesburg,52125,11179,23455,3545,657,1378,40214
Virginia,Pound,928,182,415,108,29,41,775
Virginia,Timberlake,12973,2691,5736,1156,229,948,10760
Virginia,Cave Spring,25793,5468,11520,2932,485,1246,21651
Virginia,Marion,5787,1277,1979,900,286,502,4944
Virginia,Laurel Park,542,123,241,28,13,80,485
Virginia,Narrows,2087,431,673,345,82,166,1697
Virginia,Keysville,1007,305,235,114,19,84,757
Virginia,Covington,5582,999,2599,498,120,465,4681
Virginia,Stony Creek,144,26,61,19,5,4,115
Virginia,Short Pump,27526,5646,13021,1610,209,775,21261
Virginia,Montrose,7810,3090,1403,898,237,435,6063
Virginia,St. Paul,914,230,335,148,39,97,849
Virginia,Low Moor,240,60,35,68,0,73,236
Virginia,Altavista,3442,971,1040,477,73,324,2885
Virginia,Warrenton,9873,1993,3927,1184,210,499,7813
Virginia,Triangle,9116,2427,3314,861,161,256,7019
Virginia,Colonial Heights,17593,4195,6494,1712,426,1325,14152
Virginia,Montclair,20494,4071,9642,1306,269,701,15989
Virginia,Lake Ridge,44430,10137,18790,3319,789,1464,34499
Virginia,Dumfries,5224,1218,1437,509,199,60,3423
Virginia,Dale City,73545,18422,29775,4765,1719,2308,56989
Virginia,Cana,1926,340,939,61,16,120,1476
Virginia,Clinchport,54,22,8,5,0,8,43
Virginia,St. Charles,89,11,29,12,0,8,60
Virginia,Nokesville,1641,400,759,126,17,100,1402
Virginia,Gainesville,15928,3060,7370,831,96,323,11680
Virginia,Clarksville,1332,304,516,110,46,88,1064
Virginia,Rose Hill CDP (Lee County),654,231,258,51,18,52,610
Virginia,Keokee,375,32,182,52,19,46,331
Virginia,Broadway,3855,848,1594,408,24,157,3031
Virginia,Appomattox,1851,448,593,140,73,182,1436
Virginia,Dante,608,109,143,41,39,141,473
Washington,Hatton,189,42,47,14,13,4,120
Washington,Suquamish,4310,950,1772,570,52,223,3567
Washington,Lake Ketchum,916,123,561,0,20,13,717
Washington,Lochsloy,2664,549,1322,326,6,111,2314
Washington,Centerville,90,12,42,12,0,15,81
Washington,Waller,7894,1601,3463,1070,119,449,6702
Washington,Prosser,6076,1338,2526,546,73,335,4818
Washington,Port Angeles,19615,5684,6380,2775,185,1083,16107
Washington,Inchelium,328,111,85,51,7,19,273
Washington,Lyle,455,84,129,67,0,99,379
Washington,Centralia,16932,4099,5552,2378,367,1219,13615
Washington,Toledo,602,137,271,55,8,27,498
Washington,Cathcart,2665,356,1540,262,38,151,2347
Washington,Lake Roesiger,609,99,212,167,0,35,513
Washington,Warm Beach,2699,439,1460,223,0,121,2243
Washington,Kelso,11983,3223,3718,1617,370,553,9481
Washington,Roosevelt,161,48,51,33,5,4,141
Washington,Longview Heights,3619,851,1605,399,76,130,3061
Washington,Tukwila,20198,6352,7080,1647,420,934,16433
Washington,Lakeland North,12820,3683,5172,981,150,448,10434
Washington,Mirrormont,3717,660,1880,213,42,197,2992
Washington,Newcastle,11559,2187,6016,852,49,309,9413
Washington,Pacific,7177,2084,2573,694,130,248,5729
Washington,Redmond,63197,13186,31579,3712,327,1424,50228
Washington,Riverbend,2302,496,1212,170,12,53,1943
Washington,North Bonneville,1155,283,522,120,10,72,1007
Washington,Normandy Park,6678,1261,3193,685,45,548,5732
Washington,Kettle Falls,1616,255,597,232,43,143,1270
Washington,Beaux Arts Village,394,68,194,23,2,17,304
Washington,Black Diamond,4434,797,2161,465,51,113,3587
Washington,Kirkland,88079,20322,41865,7293,940,2700,73120
Washington,Medina,3260,478,1903,99,0,112,2592
Washington,Vashon,10036,1778,4837,1286,173,583,8657
Washington,White Center,15852,4705,5288,1619,438,424,12474
Washington,Ames Lake,1597,259,939,136,0,0,1334
Washington,Baring,202,53,79,49,3,13,197
Washington,Woods Creek,5907,958,2938,491,61,155,4603
Washington,College Place,9136,2288,3593,940,200,388,7409
Washington,Mansfield,337,52,176,58,7,12,305
Washington,Coulee Dam,1230,286,489,148,4,58,985
Washington,Springdale,395,91,140,54,8,18,311
Washington,Bryn Mawr-Skyway,18347,5207,7222,1399,221,980,15029
Washington,Tenino,1695,330,579,260,39,112,1320
Washington,Sedro-Woolley,11579,3030,4257,1331,166,458,9242
Washington,Shelton,9996,2995,2486,1291,213,769,7754
Washington,Banks Lake South,256,56,114,3,4,3,180
Washington,Grand Coulee,1046,245,384,175,6,48,858
Washington,Moses Lake,22663,5309,6961,3004,367,1244,16885
Washington,Moses Lake North,4124,1454,860,594,145,84,3137
Washington,Easton,368,46,203,82,5,26,362
Washington,Snoqualmie Pass,316,80,160,31,2,11,284
Washington,Vantage,23,0,23,0,0,0,23
Washington,Desert Aire,2964,534,1199,195,43,60,2031
Washington,Woodway,1189,194,645,69,0,39,947
Washington,Okanogan,2570,787,778,289,25,128,2007
Washington,Pomeroy,1289,172,642,153,30,66,1063
Washington,Waitsburg,1188,257,493,139,4,119,1012
Washington,Ferndale,13622,3199,5806,1184,194,500,10883
Washington,Lynden,13862,2394,6377,1277,35,802,10885
Washington,Castle Rock,2968,710,987,329,142,93,2261
Washington,Grayland,609,151,178,137,38,68,572
Washington,Humptulips,153,31,53,23,0,46,153
Washington,Cashmere,3139,678,1318,272,11,157,2436
Washington,East Wenatchee,13817,3229,5099,1415,212,527,10482
Washington,Peaceful Valley,4032,1001,1416,427,57,156,3057
Washington,Custer,140,66,35,0,22,17,140
Washington,Maple Falls,159,0,93,0,0,50,143
Washington,Nooksack,1678,209,762,92,33,48,1144
Washington,Deer Park,4026,739,1443,625,9,157,2973
Washington,Aberdeen,16359,4471,5363,1943,245,893,12915
Washington,Brewster,2591,613,928,91,43,85,1760
Washington,DuPont,9379,1248,4375,756,58,332,6769
Washington,Northport,318,64,115,38,22,26,265
Washington,Lake Morton-Berrydale,11295,2092,5704,839,82,379,9096
Washington,Minnehaha,12092,2604,5247,1326,206,227,9610
Washington,Vancouver,178413,44697,66899,20908,3206,8726,144436
Washington,Anacortes,16725,2949,8113,1823,202,1069,14156
Washington,Hamilton,298,49,172,41,0,14,276
Washington,Manchester,5471,1056,2437,561,54,184,4292
Washington,Ephrata,8050,1660,3236,681,107,381,6065
Washington,Coulee City,572,93,229,71,27,25,445
Washington,Artondale,13172,2360,7109,838,67,460,10834
Washington,Ahtanum,3416,552,1441,286,99,88,2466
Washington,Fox Island,3692,571,2042,263,23,180,3079
Washington,Ravensdale,1873,471,787,92,127,45,1522
Washington,Shoreline,56020,13871,23945,5984,735,2583,47118
Washington,Snoqualmie,13317,1527,7098,514,0,196,9335
Washington,Kenmore,22546,5162,10719,1855,135,520,18391
Washington,Carbonado,727,154,311,48,3,36,552
Washington,Kent,128057,37918,48491,9751,1670,4704,102534
Washington,Rockport,49,23,17,0,0,9,49
Washington,Concrete,703,182,243,120,10,33,588
Washington,Hockinson,5001,637,2771,363,6,164,3941
Washington,Forks,3782,835,1339,422,22,184,2802
Washington,Brush Prairie,2820,630,1152,283,0,151,2216
Washington,La Center,3172,535,1566,203,0,102,2406
Washington,Meadow Glade,2906,540,1385,217,22,129,2293
Washington,Orchards,23020,4911,9269,2258,257,844,17539
Washington,Edison,123,0,123,0,0,0,123
Washington,Ridgefield,7178,1351,3553,418,41,166,5529
Washington,Woodland,5912,1070,2360,493,116,279,4318
Washington,Grand Mound,3189,787,1252,202,25,155,2421
Washington,Yelm,8772,1588,3479,809,86,265,6227
Washington,Rosalia,568,108,203,64,0,61,436
Washington,Lake McMurray,143,28,86,11,0,18,143
Washington,Big Lake,1641,269,896,152,46,92,1455
Washington,Venersborg,4349,702,2507,132,16,102,3459
Washington,Colville,4777,1178,1859,513,57,355,3962
Washington,Lakeland South,13849,2863,6533,1126,90,436,11048
Washington,Skykomish,114,26,30,42,4,12,114
Washington,Summitview,1047,223,538,23,0,28,812
Washington,Toppenish,8906,2473,2940,407,244,181,6245
Washington,Goldendale,3446,607,1367,572,67,277,2890
Washington,Bellevue,142242,33023,69638,9389,1044,4930,118024
Washington,North Omak,618,275,171,17,21,45,529
Washington,Twisp,1153,245,481,192,23,16,957
Washington,Harrah,643,187,214,40,19,24,484
Washington,Algona,3191,921,1067,296,50,123,2457
Washington,Bridgeport,2526,668,829,111,66,61,1735
Washington,Union Hill-Novelty Hill,22034,2705,12116,1232,92,821,16966
Washington,Woodinville,12026,2914,5537,898,75,520,9944
Washington,Elmer City,345,95,125,43,6,19,288
Washington,Riverside,309,90,95,41,2,16,244
Washington,Winthrop,407,71,151,68,9,21,320
Washington,Burien,51326,14385,19577,4704,868,1799,41333
Washington,Renton,101054,29245,38365,9483,1525,3575,82193
Washington,Parkland,37185,11657,11949,4360,479,1372,29817
Washington,Port Orchard,13788,3370,5591,1053,266,784,11064
Washington,Covington,20447,4806,9169,1821,131,625,16552
Washington,Duvall,7811,1460,3711,431,81,135,5818
Washington,Fall City,2313,421,1188,183,8,74,1874
Washington,Federal Way,96110,27264,35528,8831,1879,3517,77019
Washington,Maple Heights-Lake Desire,3682,670,1998,298,29,129,3124
Washington,Maple Valley,25953,3715,12199,1794,97,685,18490
Washington,Edgewood,10599,2240,5355,825,93,250,8763
Washington,Mercer Island,25492,4292,13194,1757,117,1210,20570
Washington,Camas,22615,4219,10990,1777,191,564,17741
Washington,Washougal,15484,3074,7221,1260,150,562,12267
Washington,Yacolt,1575,336,615,114,14,52,1131
Washington,Lamont,64,13,34,9,0,3,59
Washington,St. John,567,76,279,76,6,31,468
Washington,Lake Cavanaugh,180,0,153,18,9,0,180
Washington,Starbuck,111,6,67,22,2,14,111
Washington,Fife,9968,2697,3425,1142,118,226,7608
Washington,Frederickson,22935,5058,9449,1660,449,634,17250
Washington,Dayton,2682,423,1244,322,33,239,2261
Washington,Alder,150,15,77,14,0,0,106
Washington,Alderton,3280,519,1538,364,6,67,2494
Washington,Allyn,2497,643,1328,126,0,77,2174
Washington,Altoona,62,0,62,0,0,0,62
Washington,Amanda Park,127,39,44,12,0,8,103
Washington,Anderson Island,1187,140,764,153,15,61,1133
Washington,Addy,109,26,0,17,0,36,79
Washington,Bangor Base,6336,2338,2341,69,21,0,4769
Washington,Barstow,137,8,71,4,0,15,98
Washington,Belfair,4435,1135,1497,706,76,114,3528
Washington,Bethel,3787,924,1712,265,22,119,3042
Washington,Bothell East,10682,1531,5564,567,15,237,7914
Washington,Bothell West,20307,3445,10055,1622,149,496,15767
Washington,Boulevard Park,3723,1181,1524,266,48,198,3217
Washington,Barney's Junction,178,60,36,34,0,17,147
Washington,Boyds,73,0,49,0,0,0,49
Washington,Granger,3687,1216,929,221,50,53,2469
Washington,North Fort Lewis,5701,2063,1799,187,35,0,4084
Washington,Friday Harbor,2554,742,794,411,29,157,2133
Washington,Conconully,203,47,111,30,0,10,198
Washington,Bothell,44994,10186,20383,3616,514,1704,36403
Washington,Cottage Lake,23955,3944,13181,1292,67,575,19059
Washington,Lake Forest Park,13378,2605,6824,1136,79,432,11076
Washington,North Bend,6830,1321,3258,522,111,151,5363
Washington,Spokane Valley,96070,21260,39389,11072,1053,5171,77945
Washington,Carson,2703,655,1158,184,17,106,2120
Washington,Colfax,2878,575,1167,454,7,270,2473
Washington,Liberty Lake,9382,1388,4305,905,117,399,7114
Washington,Electric City,983,138,445,174,10,25,792
Washington,LaCrosse,371,71,171,74,3,29,348
Washington,Prescott,308,65,121,55,3,7,251
Washington,Rainier,2346,537,839,290,41,80,1787
Washington,North Yelm,3201,809,1096,316,15,260,2496
Washington,Chelan,4070,946,1727,542,154,139,3508
Washington,Bryant,2003,347,1140,68,16,86,1657
Washington,Bunk Foss,3872,661,1996,344,6,63,3070
Washington,Danville,56,21,9,17,0,0,47
Washington,Dash Point,1019,155,520,133,3,47,858
Washington,Deep River,159,12,88,27,7,14,148
Washington,Disautel,16,7,0,0,0,9,16
Washington,Donald,0,0,0,0,0,0,0
Washington,Duluth,1563,296,762,77,26,105,1266
Washington,Curlew Lake,436,77,318,10,0,0,405
Washington,Eastmont,21686,4728,10185,1815,131,841,17700
Washington,Fife Heights,2333,536,1096,180,8,87,1907
Washington,Fairwood CDP (King County),19428,4198,9119,1495,135,681,15628
Washington,Fairwood CDP (Spokane County),8554,1621,3496,802,115,523,6557
Washington,Fern Prairie,2140,544,977,218,19,43,1801
Washington,Fobes Hill,3052,578,1341,439,51,81,2490
Washington,Four Lakes,482,33,263,128,0,34,458
Washington,Enetai,2110,391,899,308,21,107,1726
Washington,Buena,1206,31,366,166,30,45,638
Washington,Curlew,112,21,37,22,0,10,90
Washington,Cowiche,867,273,249,25,0,0,547
Washington,Burley,2119,462,847,269,22,68,1668
Washington,Canterwood,3018,412,1867,154,0,172,2605
Washington,Canyon Creek,3520,640,1618,346,42,95,2741
Washington,Cavalero,5320,953,2387,442,0,146,3928
Washington,Chain Lake,4942,745,2563,316,14,106,3744
Washington,Chelan Falls,30,0,30,0,0,0,30
Washington,Crocker,1180,248,665,85,0,19,1017
Washington,Chico,2840,461,1484,267,12,72,2296
Washington,Clayton,423,45,166,40,30,0,281
Washington,Clear Lake CDP (Pierce County),940,243,483,57,1,52,836
Washington,Clear Lake CDP (Skagit County),906,177,405,117,16,33,748
Washington,Clearview,3932,656,1829,378,69,126,3058
Washington,Cliffdell,121,47,48,25,0,0,120
Washington,Clover Creek,6902,1635,2842,829,36,234,5576
Washington,Clallam Bay,341,165,90,61,0,25,341
Washington,Clarkston,7360,1928,2083,1336,135,415,5897
Washington,Markham,118,25,43,15,0,0,83
Washington,Rock Island,1195,248,389,144,20,56,857
Washington,Spanaway,32150,7319,13266,2846,464,1057,24952
Washington,Summit,8435,1526,4062,831,172,476,7067
Washington,Tacoma,210103,63007,71480,24824,3816,8997,172124
Washington,Geneva,2655,608,1198,307,15,60,2188
Washington,Sumas,1757,361,669,226,12,46,1314
Washington,Cheney,11962,6985,2724,789,65,253,10816
Washington,Roy,692,84,324,91,2,38,539
Washington,Ocean Park,1695,180,977,310,37,80,1584
Washington,Benton City,3315,801,1308,382,50,126,2667
Washington,Kennewick,80204,18462,30079,7461,1290,3827,61119
Washington,Burbank,3333,647,1710,229,17,170,2773
Washington,Garrett,1449,175,749,109,0,42,1075
Washington,Kendall,0,0,0,0,0,0,0
Washington,Republic,1340,321,357,213,18,110,1019
Washington,Darrington,1178,266,373,229,32,60,960
Washington,Clinton,922,88,530,111,1,21,751
Washington,Gleed,2634,628,1258,157,25,90,2158
Washington,Eatonville,2945,478,1283,362,26,182,2331
Washington,Cle Elum,2834,694,888,536,83,124,2325
Washington,Cathlamet,747,196,288,82,16,43,625
Washington,Lacey,47852,11414,19691,4468,642,2150,38365
Washington,Carlsborg,725,186,281,181,0,77,725
Washington,River Road,894,243,443,97,0,16,799
Washington,Bingen,606,147,221,57,26,41,492
Washington,McChord AFB,3265,584,1488,49,15,9,2145
Washington,Dallesport,1602,261,546,255,0,232,1294
Washington,Chinook,289,9,169,40,0,9,227
Washington,Quincy,7531,2278,2388,250,233,144,5293
Washington,Wilson Creek,215,21,67,48,18,41,195
Washington,Cusick,78,23,33,9,3,10,78
Washington,Metaline,135,29,55,24,0,5,113
Washington,Metaline Falls,187,28,86,38,4,9,165
Washington,Maryhill,40,0,30,0,0,0,30
Washington,Almira,276,27,125,27,4,17,200
Washington,Walla Walla East,1929,247,1193,51,0,65,1556
Washington,Birch Bay,9037,1378,4889,838,248,368,7721
Washington,Terrace Heights,8273,1728,3955,755,62,353,6853
Washington,Zillah,3118,861,1243,236,45,117,2502
Washington,Nile,116,0,82,8,0,8,98
Washington,Long Beach,1431,409,446,280,22,84,1241
Washington,Chehalis,7404,2183,2315,970,86,429,5983
Washington,Napavine,1720,268,738,243,42,70,1361
Washington,Bainbridge Island,24060,3682,12393,2179,142,967,19363
Washington,Alderwood Manor,9257,2633,3928,734,116,395,7806
Washington,May Creek,600,79,324,84,72,15,574
Washington,Mukilteo,21264,4329,10635,1782,54,704,17504
Washington,Stanwood,6973,1382,2683,649,96,379,5189
Washington,West Richland,14187,2808,6363,1130,81,299,10681
Washington,Reardan,584,106,215,50,0,41,412
Washington,West Pasco,1478,277,654,113,0,56,1100
Washington,Esperance,4213,1051,1860,490,45,67,3513
Washington,Westport,2091,489,715,373,52,94,1723
Washington,McCleary,2075,375,829,215,31,150,1600
Washington,Longview,37092,8449,12860,5416,948,2536,30209
Washington,Fairfield,554,75,245,63,4,42,429
Washington,Pasco,71858,17680,25351,5133,1126,1792,51082
Washington,South Bend,1592,298,584,227,64,110,1283
Washington,Gold Bar,1911,418,895,193,21,86,1613
Washington,Lake Bosworth,1007,237,509,10,9,97,862
Washington,Maltby,12350,2446,6329,814,62,506,10157
Washington,Tokeland,291,62,168,15,1,26,272
Washington,Granite Falls,3575,543,1486,425,139,95,2688
Washington,Lake Stevens,31778,6619,13237,3037,438,622,23953
Washington,Lynnwood,37671,9963,14180,4119,590,1951,30803
Washington,Machias,910,242,419,85,10,38,794
Washington,North Marysville,176,22,122,22,0,10,176
Washington,Snohomish,9875,2242,3717,1493,85,408,7945
Washington,Startup,663,176,281,106,0,47,610
Washington,Kalama,2557,580,1084,322,28,188,2202
Washington,Nisqually Indian Community,666,195,210,58,6,34,503
Washington,Farmington,115,18,63,7,0,3,91
Washington,Endicott,308,50,136,29,9,12,236
Washington,Mount Vista,8703,1621,4250,770,185,309,7135
Washington,Wollochet,6390,908,3137,622,70,412,5149
Washington,Browns Point,1088,156,561,186,11,42,956
Washington,Dollars Corner,724,77,502,17,30,39,665
Washington,Kayak Point,1726,464,884,146,0,65,1559
Washington,Port Gamble Tribal Community,931,225,283,214,6,21,749
Washington,Mattawa,4567,1385,1392,199,71,30,3077
Washington,Willapa,182,8,93,21,12,14,148
Washington,Millwood,1686,375,640,250,11,82,1358
Washington,Glenwood,226,29,74,13,12,19,147
Washington,Quilcene,480,154,187,58,9,40,448
Washington,Olympia,50836,15622,17993,6819,603,2437,43474
Washington,Colton,446,80,234,31,0,20,365
Washington,Tekoa,742,103,367,64,10,59,603
Washington,Bucoda,689,166,262,59,22,32,541
Washington,Tieton,1541,401,490,99,39,65,1094
Washington,Alger,147,16,55,13,24,31,139
Washington,Wilderness Rim,1457,245,910,73,0,41,1269
Washington,Wauna,4323,848,2160,506,71,170,3755
Washington,Southworth,2073,380,1130,161,15,111,1797
Washington,Stansberry Lake,2768,414,1093,310,24,61,1902
Washington,Steptoe,177,32,119,7,5,5,168
Washington,Summit View,7621,2654,2498,794,159,147,6252
Washington,Sunday Lake,655,88,318,103,0,38,547
Washington,Torboy,48,9,21,7,0,0,37
Washington,Whidbey Island Station,1930,1651,264,5,10,0,1930
Washington,Swede Heaven,952,128,565,118,15,30,856
Washington,Tanglewilde,6581,1422,2602,731,125,220,5100
Washington,Twin Lakes,71,18,32,17,0,4,71
Washington,Union,412,43,276,41,0,39,399
Washington,Upper Elochoman,100,33,48,19,0,0,100
Washington,Valley,164,47,61,8,2,29,147
Washington,Vaughn,552,107,337,27,1,16,488
Washington,Tampico,250,54,129,8,0,16,207
Washington,South Creek,2716,669,1091,521,98,117,2496
Washington,Marblemount,0,0,0,0,0,0,0
Washington,Bremerton,40220,13204,13108,5644,694,1917,34567
Washington,Newport,2142,370,770,309,7,249,1705
Washington,Lake Shore,7909,1419,3971,672,46,265,6373
Washington,Oakesdale,447,93,212,38,2,21,366
Washington,Fircrest,6711,1423,2684,842,45,282,5276
Washington,Skokomish,655,275,137,58,18,23,511
Washington,Clyde Hill,3295,535,1786,146,6,94,2567
Washington,George,706,159,278,30,7,21,495
Washington,Arlington,19154,3690,8817,1534,100,971,15112
Washington,Town and Country,4728,985,1948,597,58,219,3807
Washington,Sprague,452,88,219,68,0,16,391
Washington,Thorp,246,53,81,51,11,21,217
Washington,Elbe,54,0,0,54,0,0,54
Washington,Barberton,6941,1031,3748,401,22,222,5424
Washington,Othello,7980,1774,2778,403,205,129,5289
Washington,Buckley,4680,1121,1708,670,50,215,3764
Washington,Mount Vernon,34504,8020,13335,3618,405,1330,26708
Washington,Kittitas,1548,323,503,172,28,77,1103
Washington,Royal City,1517,488,535,19,10,20,1072
Washington,Kingston,2307,412,1140,337,18,99,2006
Washington,Ellensburg,19799,10592,4581,1537,132,576,17418
Washington,South Cle Elum,582,157,216,111,12,30,526
Washington,Ione,406,104,159,47,1,32,343
Washington,Graham,28194,5415,12805,2020,250,743,21233
Washington,Prairie Ridge,12550,3063,5091,1160,228,358,9900
Washington,Soap Lake,1445,237,534,211,31,128,1141
Washington,Puyallup,40305,10197,15404,5083,560,2015,33259
Washington,Wilkeson,440,82,209,47,10,17,365
Washington,Cherry Grove,725,33,306,17,1,5,362
Washington,Conway,0,0,0,0,0,0,0
Washington,Tumwater,22500,5798,9272,2526,150,902,18648
Washington,Bay View,659,32,386,146,0,20,584
Washington,Hartline,172,48,67,12,3,2,132
Washington,University Place,32907,8025,13707,3314,330,1285,26661
Washington,Skamokawa Valley,304,44,169,61,30,0,304
Washington,Sisco Heights,2518,477,1320,189,36,78,2100
Washington,Silver Firs,22052,4604,10301,1410,183,396,16894
Washington,Oak Harbor,22820,4765,9690,1920,327,834,17536
Washington,Neah Bay,1032,314,243,129,9,44,739
Washington,Naselle,412,81,140,40,0,70,331
Washington,Basin City,1045,380,417,0,31,0,828
Washington,Country Homes,6054,3087,1481,579,78,256,5481
Washington,Camano,16427,2648,9142,1617,114,871,14392
Washington,Langley,1186,205,525,187,12,106,1035
Washington,Brinnon,751,153,346,109,7,83,698
Washington,Odessa,946,171,371,117,8,124,791
Washington,Fords Prairie,2352,425,1037,176,0,124,1762
Washington,Mossyrock,697,85,281,78,39,29,512
Washington,Pe Ell,531,134,210,70,0,16,430
Washington,Everett,108941,32426,35941,14306,1899,4655,89227
Washington,West Side Highway,5877,1532,2164,382,24,392,4494
Washington,Sudden Valley,7999,1219,3972,776,99,459,6525
Washington,Brady,885,109,411,0,0,28,548
Washington,Mesa,485,114,183,23,2,5,327
Washington,Otis Orchards-East Farms,6514,1070,3317,547,21,240,5195
Washington,Lind,597,127,191,78,2,21,419
Washington,South Wenatchee,2011,804,331,231,0,56,1422
Washington,Orting,7732,1541,2899,1012,149,350,5951
Washington,Bell Hill,737,59,614,29,0,35,737
Washington,Blyn,22,0,20,2,0,0,22
Washington,Bickleton,83,18,42,6,0,0,66
Washington,Spokane,214804,59475,75431,27745,2656,10095,175402
Washington,Mabton,2156,632,686,89,57,78,1542
Washington,Poulsbo,10301,2185,4538,1077,110,609,8519
Washington,East Cathlamet,563,87,342,21,22,51,523
Washington,Harrington,413,45,210,50,6,22,333
Washington,Wilbur,807,81,390,82,14,80,647
Washington,Deming,227,130,93,0,2,0,225
Washington,Marietta-Alderwood,3708,937,1357,514,0,250,3058
Washington,Naches,705,169,310,42,12,79,612
Washington,Cohassett Beach,772,181,329,38,19,91,658
Washington,Taholah,665,276,137,67,9,37,526
Washington,Moxee,3958,836,1473,198,31,58,2596
Washington,Prairie Heights,4256,957,1725,433,21,110,3246
Washington,Puget Island,836,116,523,50,19,10,718
Washington,Purdy,1682,358,823,138,0,101,1420
Washington,Queets,238,66,45,20,2,22,155
Washington,Qui-nai-elt Village,59,2,30,10,0,0,42
Washington,Raft Island,430,89,253,52,6,0,400
Washington,Porter,229,46,143,0,0,11,200
Washington,Rocky Point,1579,407,680,270,24,101,1482
Washington,Rosedale,4512,1223,1851,561,52,220,3907
Washington,Ryderwood,454,25,255,100,9,65,454
Washington,Santiago,30,12,3,2,0,2,19
Washington,Seabeck,1060,210,573,115,0,43,941
Washington,Sekiu,62,0,41,0,0,0,41
Washington,Shadow Lake,2286,508,1135,183,0,106,1932
Washington,Rosburg,323,30,164,41,0,30,265
Washington,Point Roberts,1191,267,608,153,43,54,1125
Washington,Pine Grove,122,19,84,1,0,0,104
Washington,Picnic Point,8976,1947,4424,745,45,366,7527
Washington,Union Gap,6142,1642,1827,568,202,288,4527
Washington,Wapato,5041,1558,1500,223,156,138,3575
Washington,Yakima,93416,25294,30995,8884,1891,4644,71708
Washington,Connell,5482,1746,1617,755,156,118,4392
Washington,Port Hadlock-Irondale,3574,721,1632,491,27,144,3015
Washington,North Lynnwood,21608,6250,8338,2426,204,403,17621
Washington,North Puyallup,1722,429,699,309,0,121,1558
Washington,Northwest Stanwood,135,38,53,16,0,2,109
Washington,Onalaska,807,107,249,122,77,42,597
Washington,Orient,135,14,65,19,0,15,113
Washington,Outlook,363,256,13,0,0,0,269
Washington,Oyehut,0,0,0,0,0,0,0
Washington,Pacific Beach,472,223,136,0,0,50,409
Washington,Packwood,315,60,188,33,0,0,281
Washington,Parker,88,28,35,8,0,17,88
Washington,Leavenworth,2260,599,843,270,16,159,1887
Washington,Gorst,222,16,114,66,0,26,222
Washington,Sunnyslope,3815,471,2188,150,37,136,2982
Washington,Stevenson,1503,370,511,237,20,121,1259
Washington,Port Angeles East,3328,553,1650,362,70,216,2851
Washington,La Conner,819,124,287,191,11,106,719
Washington,Parkwood,6700,1429,2887,607,62,434,5419
Washington,Midland,9208,2379,3170,1148,131,485,7313
Washington,Battle Ground,19932,4426,7906,1828,168,816,15144
Washington,Finley,5984,1181,2452,528,165,321,4647
Washington,Warden,2744,668,980,189,51,79,1967
Washington,Marrowstone,926,81,552,83,6,65,787
Washington,White Salmon,2485,649,1054,200,8,136,2047
Washington,Ocean City,224,78,71,27,0,0,176
Washington,Krupp,51,27,13,5,0,0,45
Washington,White Swan,996,330,173,73,30,23,629
Washington,Salmon Creek,21299,4710,10040,1860,137,701,17448
Washington,Albion,716,186,320,74,0,5,585
Washington,Everson,2641,545,1088,155,46,106,1940
Washington,Winlock,1725,432,661,139,50,57,1339
Washington,Palouse,955,125,499,120,23,40,807
Washington,Grandview,11124,2614,3913,620,333,243,7723
Washington,Des Moines,31518,8053,12414,3037,513,1834,25851
Washington,Marysville,67567,14858,28537,6712,562,2959,53628
Washington,Junction City,0,0,0,0,0,0,0
Washington,Felida,8311,1089,4525,563,49,312,6538
Washington,Klickitat,430,92,181,44,4,18,339
Washington,Bay Center,212,23,107,24,0,35,189
Washington,Silverdale,21071,5276,9154,1766,392,1004,17592
Washington,Lebam,120,0,76,11,0,27,114
Washington,Sequim,7100,1418,2628,1222,39,959,6266
Washington,Lyman,479,72,198,61,0,51,382
Washington,Roslyn,644,157,212,104,14,75,562
Washington,Arlington Heights,2573,534,1161,152,107,155,2109
Washington,Walla Walla,32731,11176,10125,3889,638,1512,27340
Washington,Greenwater,27,0,0,14,0,13,27
Washington,Amboy,2022,243,866,86,0,41,1236
Washington,Auburn,79110,20213,29718,7775,854,2883,61443
Washington,Three Lakes,3560,616,1848,275,69,110,2918
Washington,Freeland,1994,350,893,206,65,263,1777
Washington,Lakewood,59606,14903,22666,6819,1491,2891,48770
Washington,Steilacoom,6270,1292,2986,690,25,176,5169
Washington,Erlands Point-Kitsap Lake,3338,729,1310,537,70,121,2767
Washington,Indianola,3536,752,1617,378,56,146,2949
Washington,Tracyton,5933,1526,2147,605,116,280,4674
Washington,Sumner,9898,2635,3451,1410,159,424,8079
Washington,Bonney Lake,20313,3924,9279,1644,168,660,15675
Washington,Morton,1120,184,474,120,15,95,888
Washington,Brier,6819,1264,3751,500,20,217,5752
Washington,Richland,55043,12545,23427,5137,543,2317,43969
Washington,Davenport,1717,345,745,211,40,119,1460
Washington,Kahlotus,183,34,95,21,0,0,150
Washington,Edmonds,41770,10758,18383,4417,342,2164,36064
Washington,Malden,265,58,92,35,5,25,215
Washington,Vader,923,187,343,71,23,61,685
Washington,Hunts Point,432,67,243,36,0,16,362
Washington,Ronald,164,14,139,11,0,0,164
Washington,Ashford,98,59,0,39,0,0,98
Washington,Mill Creek,20164,4531,9658,1421,239,845,16694
Washington,Montesano,3927,1128,1322,535,49,241,3275
Washington,Washtucna,241,39,117,18,0,30,204
Washington,Nespelem Community,244,104,46,24,0,15,189
Washington,Copalis Beach,546,226,56,209,0,13,504
Washington,SeaTac,28925,8351,10362,2701,729,1083,23226
Washington,Lakeview,909,173,463,69,0,67,772
Washington,Five Corners,18559,3955,7567,1684,390,543,14139
Washington,Rochester,3232,679,1357,326,41,108,2511
Washington,Garfield,551,105,179,127,3,40,454
Washington,Pullman,33050,19733,7755,1473,211,316,29488
Washington,Uniontown,382,41,221,20,5,7,294
Washington,Burlington,8743,1951,3278,1019,175,430,6853
Washington,Cascade Valley,1894,230,903,329,35,104,1601
Washington,Lewisville,1671,179,951,69,10,74,1283
Washington,Tonasket,1057,154,405,84,23,167,833
Washington,Omak,4794,937,1694,581,138,211,3561
Washington,Nespelem,193,75,48,27,3,10,163
Washington,Wallula,361,49,99,22,0,0,170
Washington,Blaine,5172,827,2320,674,89,224,4134
Washington,Glacier,105,38,31,36,0,0,105
Washington,Airway Heights,8285,3015,2208,1383,299,198,7103
Washington,Oroville,1968,547,628,238,40,119,1572
Washington,Pateros,601,162,191,62,0,24,439
Washington,Touchet,509,80,251,63,0,10,404
Washington,North Sultan,232,67,112,9,0,8,196
Washington,Sultan,5040,1378,1859,607,34,242,4120
Washington,Verlot,475,119,195,67,0,0,381
Washington,Creston,262,40,153,15,7,18,233
Washington,Trout Lake,632,73,340,86,0,29,528
Washington,Wishram,499,152,143,63,16,31,405
Washington,Ilwaco,940,166,387,119,15,107,794
Washington,Oso,277,19,177,0,0,23,219
Washington,Raymond,2882,831,908,454,29,123,2345
Washington,Ocean Shores,5814,797,2739,1167,176,362,5241
Washington,Neilton,309,51,155,24,0,11,241
Washington,Chewelah,2620,601,1066,271,37,231,2206
Washington,Marcus,142,20,73,35,0,10,138
Washington,East Renton Highlands,11745,2391,5743,1059,122,371,9686
Washington,Enumclaw,11768,2676,4306,1685,177,598,9442
Washington,Hobart,7182,1526,3498,611,41,240,5916
Washington,Lake Marcel-Stillwater,1335,162,916,64,0,34,1176
Washington,Oakville,738,142,305,90,0,36,573
Washington,Milton,7543,1888,2957,1000,26,435,6306
Washington,Tanner,885,183,421,84,0,11,699
Washington,Yarrow Point,1168,182,707,74,0,27,990
Washington,Aberdeen Gardens,299,57,107,19,11,42,236
Washington,Cosmopolis,1493,358,613,124,16,159,1270
Washington,Elma,3245,744,1334,422,18,54,2572
Washington,Hoquiam,8454,1767,2948,1376,148,720,6959
Washington,Seattle,708823,273163,252851,60746,7228,21590,615578
Washington,Index,192,54,79,26,2,13,174
Washington,Lake Goodwin,3842,986,2121,286,0,79,3472
Washington,Martha Lake,19954,5107,8448,1751,120,498,15924
Washington,Issaquah,36938,7271,16593,3830,260,1410,29364
Washington,Coupeville,1766,294,814,321,8,181,1618
Washington,Port Townsend,9428,2007,3738,1825,112,581,8263
Washington,Central Park,3072,549,1489,361,0,198,2597
Washington,Sammamish,64049,9454,35479,2354,162,970,48419
Washington,Medical Lake,4937,1242,1988,486,73,187,3976
Washington,Carnation,1767,407,837,128,11,61,1444
Washington,Moclips,0,0,0,0,0,0,0
Washington,Asotin,1105,138,627,139,11,41,956
Washington,Clarkston Heights-Vineland,6403,996,3496,713,52,243,5500
Washington,West Clarkston-Highland,6081,1157,2412,789,123,419,4900
Washington,Entiat,1260,299,529,170,28,27,1053
Washington,Wenatchee,34094,8765,12084,4155,401,1691,27096
Washington,Waterville,1415,227,673,175,5,97,1177
Washington,Satsop,624,107,293,118,1,48,567
Washington,Navy Yard City,3166,1100,792,422,86,187,2587
Washington,East Port Orchard,5331,1215,2102,412,5,315,4049
Washington,Sunnyside,16442,4328,5161,797,189,526,11001
Washington,Monroe,18503,5167,6586,2021,217,566,14557
Washington,Mountlake Terrace,21106,5396,8424,2384,328,743,17275
Washington,Silvana,13,13,0,0,0,0,13
Washington,Port Ludlow,2771,306,1941,274,0,157,2678
Washington,Dixie,211,43,84,31,0,14,172
Washington,Acme,180,80,0,0,49,0,129
Washington,Bellingham,87071,37027,26227,8051,1268,3133,75706
Washington,Elk Plain,14065,3402,6009,1242,155,534,11342
Washington,Fort Lewis,12933,2648,5623,207,83,23,8584
Washington,South Hill,58164,12100,25710,4761,585,1821,44977
Washington,Gig Harbor,9382,1747,4136,701,163,818,7565
Washington,Eschbach,385,83,251,8,0,19,361
Washington,Ruston,1233,334,489,160,10,40,1033
Washington,South Prairie,280,63,103,50,8,19,243
Washington,Selah,7766,1634,2958,713,56,315,5676
Washington,Ritzville,1628,341,590,244,55,122,1352
Washington,Grapeview,906,316,364,124,9,47,860
Washington,Spangle,189,36,69,38,4,11,158
Washington,Home,1164,215,602,187,1,49,1054
Washington,Lofall,2025,361,1118,211,49,95,1834
Washington,Laurier,0,0,0,0,0,0,0
Washington,Larch Way,4257,1192,2071,205,11,82,3561
Washington,Lake Tapps,12771,2887,5917,1260,47,268,10379
Washington,Lake Stickney,10584,3093,4081,771,96,309,8350
Washington,Lake Holm,3254,808,1932,151,13,76,2980
Washington,Lake Cassidy,3511,659,1674,482,11,120,2946
Washington,La Grande,130,13,117,0,0,0,130
Washington,Keyport,422,77,232,24,0,8,341
Washington,Key Center,3823,748,1934,369,65,192,3308
Washington,Ketron Island,0,0,0,0,0,0,0
Washington,Kapowsin,274,78,140,10,0,26,254
Washington,Longbranch,3798,400,1724,598,0,52,2774
Washington,Hoodsport,242,51,148,0,0,22,221
Washington,Hogans Corner,56,0,36,20,0,0,56
Washington,High Bridge,3076,545,1609,319,21,108,2602
Washington,Herron Island,41,0,25,16,0,0,41
Washington,Hazel Dell,21066,5315,8132,2756,436,689,17328
Washington,Hat Island,56,0,56,0,0,0,56
Washington,Hansville,3402,349,1948,341,97,198,2933
Washington,Green Bluff,445,18,319,42,0,0,379
Washington,Grays River,417,54,209,53,3,35,354
Washington,Rockford,437,64,192,68,6,15,345
Washington,Latah,126,27,67,8,0,5,107
Washington,Fairchild AFB,3118,651,1335,25,5,29,2045
Washington,Waverly,94,37,24,13,2,1,77
Washington,Keller,199,74,39,32,10,11,166
Washington,Loomis,125,60,61,4,0,0,125
Washington,Jamestown,281,25,107,64,11,58,265
Washington,Lower Elochoman,363,26,239,7,0,4,276
Washington,Loon Lake,732,111,363,126,12,25,637
Washington,Monroe North,1744,249,905,82,0,51,1287
Washington,Mineral,219,0,46,77,36,60,219
Washington,Methow,81,31,29,11,0,0,71
Washington,Meadowdale,3152,729,1444,315,52,109,2649
Washington,Mead,6870,1086,3419,939,11,303,5758
Washington,Mill Creek East,21523,3301,10568,1375,206,344,15794
Washington,Manson,1374,180,547,212,70,38,1047
Washington,Malott,808,220,303,24,0,0,547
Washington,Malone,430,75,194,0,21,19,309
Washington,Malo,61,0,18,0,0,0,18
Washington,McMillin,1745,259,930,281,0,48,1518
Washington,McKenna,929,29,388,40,30,46,533
Washington,Maplewood,5163,845,2769,499,19,297,4429
West Virginia,Brookhaven,5900,1329,2489,572,48,209,4647
West Virginia,Red Jacket,385,60,205,48,15,12,340
West Virginia,Belmont,1040,226,421,110,3,70,830
West Virginia,MacArthur,1590,263,701,128,49,62,1203
West Virginia,Morgantown,30539,17795,7359,1843,192,878,28067
West Virginia,Newell,1349,324,443,160,60,126,1113
West Virginia,Montrose,170,30,102,11,0,11,154
West Virginia,Granville,2567,530,914,214,0,272,1930
West Virginia,Burnsville,618,105,270,42,12,42,471
West Virginia,Matoaka,188,59,58,16,8,9,150
West Virginia,Oakvale,127,47,12,31,2,6,98
West Virginia,Barrackville,1330,330,616,104,12,66,1128
West Virginia,Pleasant Valley,3172,629,1346,459,7,180,2621
West Virginia,Follansbee,2806,699,1024,290,24,246,2283
West Virginia,Chattaroy,627,62,297,60,19,34,472
West Virginia,Bancroft,482,137,238,40,0,27,442
West Virginia,Franklin,673,98,287,61,0,101,547
West Virginia,Nutter Fort,1431,326,532,238,49,93,1238
West Virginia,Spencer,1997,459,741,360,7,170,1737
West Virginia,Lost Creek,551,144,204,40,6,26,420
West Virginia,McMechen,1915,494,600,304,58,147,1603
West Virginia,Oak Hill,8458,1772,3162,1023,86,698,6741
West Virginia,Shinnston,2601,569,1042,276,67,97,2051
West Virginia,Weston,3993,864,1593,610,0,263,3330
West Virginia,Jane Lew,391,72,183,36,2,19,312
West Virginia,Rupert,894,175,379,132,0,59,745
West Virginia,Beckley,16697,3874,6111,2276,244,1452,13957
West Virginia,Matewan,467,94,158,77,27,58,414
West Virginia,West Milford,613,97,334,49,0,18,498
West Virginia,Ansted,1437,255,610,250,5,51,1171
West Virginia,Smithfield,166,46,34,14,9,37,140
West Virginia,Camden-on-Gauley,190,51,53,32,6,13,155
West Virginia,Hinton,2768,524,1052,445,34,237,2292
West Virginia,Middlebourne,684,162,224,56,7,70,519
West Virginia,Quinwood,144,38,56,19,4,8,125
West Virginia,Brandonville,130,22,39,35,0,14,110
West Virginia,Craigsville,2213,391,961,340,34,224,1950
West Virginia,Albright,311,91,119,32,4,6,252
West Virginia,Northfork,291,60,112,14,5,32,223
West Virginia,Mason,920,241,274,136,4,112,767
West Virginia,Huntington,47420,17109,13268,6334,705,2479,39895
West Virginia,Thurmond,4,0,2,0,0,2,4
West Virginia,Tunnelton,244,41,119,23,0,19,202
West Virginia,Elkins,7115,2023,2259,1066,136,401,5885
West Virginia,Keystone,115,32,51,5,0,6,94
West Virginia,Smithers,1058,262,405,110,0,57,834
West Virginia,Fort Gay,924,137,291,184,8,61,681
West Virginia,Mullens,1564,322,668,149,2,142,1283
West Virginia,Shepherdstown,1605,1290,147,90,8,49,1584
West Virginia,Flatwoods,257,101,94,10,0,14,219
West Virginia,Sutton,1358,212,632,163,16,101,1124
West Virginia,New Cumberland,1252,388,435,186,0,102,1111
West Virginia,Hillsboro,183,38,55,40,2,23,158
West Virginia,Dunbar,7462,1438,2827,1332,181,584,6362
West Virginia,Union,440,68,172,90,7,61,398
West Virginia,Triadelphia,779,114,363,100,8,45,630
West Virginia,Valley Grove village,383,56,164,56,18,18,312
West Virginia,Leon,221,30,105,6,0,18,159
West Virginia,Parsons,1523,343,630,154,12,143,1282
West Virginia,Thomas,609,131,211,106,6,93,547
West Virginia,Wardensville,285,52,143,19,3,13,230
West Virginia,Cedar Grove,625,137,244,43,8,69,501
West Virginia,Sistersville,1311,341,416,201,42,134,1134
West Virginia,Bethlehem village,2522,564,1247,134,46,183,2174
West Virginia,Danville,771,161,283,105,6,108,663
West Virginia,Reedy,114,13,53,19,0,4,89
West Virginia,Teays Valley,13816,2582,6886,985,68,793,11314
West Virginia,Cross Lanes,9619,2068,4409,962,201,262,7902
West Virginia,Point Pleasant,4194,738,1471,553,56,385,3203
West Virginia,Rivesville,1113,293,333,126,10,70,832
West Virginia,Worthington,186,48,58,16,11,26,159
West Virginia,Montgomery,1738,703,451,156,17,109,1436
West Virginia,Tornado,1211,176,601,132,17,78,1004
West Virginia,Blacksville,118,27,41,9,0,0,77
West Virginia,Star City,2196,982,465,281,29,183,1940
West Virginia,Buckhannon,5566,2091,1730,607,154,326,4908
West Virginia,Ceredo,1245,235,519,164,33,112,1063
West Virginia,Wayne,1492,309,502,295,22,101,1229
West Virginia,Philippi,3409,1150,1017,329,45,308,2849
West Virginia,Cheat Lake,9337,2141,4128,946,36,365,7616
West Virginia,Grant Town,582,116,257,40,1,49,463
West Virginia,Davis,631,159,284,74,19,32,568
West Virginia,Athens,1043,636,291,46,0,16,989
West Virginia,Windsor Heights village,331,78,130,37,11,19,275
West Virginia,Grantsville,538,97,172,83,9,39,400
West Virginia,Capon Bridge,453,117,125,53,11,22,328
West Virginia,Bayard,217,42,120,21,1,14,198
West Virginia,Petersburg,2520,664,983,319,23,251,2240
West Virginia,Bradley,1888,661,679,258,0,40,1638
West Virginia,Lester,541,44,225,51,6,45,371
West Virginia,Salt Rock,340,0,240,21,11,68,340
West Virginia,Rossmore,393,136,108,70,0,23,337
West Virginia,Roderfield,24,0,0,12,12,0,24
West Virginia,Sarah Ann,88,20,45,0,0,0,65
West Virginia,Robinette,557,131,165,80,19,66,461
West Virginia,Reader,335,41,195,49,0,44,329
West Virginia,Raysal,598,156,122,46,0,84,408
West Virginia,Rand,1618,389,664,165,48,79,1345
West Virginia,Scarbro,721,116,375,22,16,19,548
West Virginia,Racine,229,82,59,39,0,30,210
West Virginia,Prince,93,0,42,0,0,0,42
West Virginia,Switzer,557,294,99,88,0,34,515
West Virginia,Alum Creek,1744,234,771,227,0,98,1330
West Virginia,West Hamlin,713,105,266,71,20,59,521
West Virginia,Hendricks,286,57,138,26,0,11,232
West Virginia,Anawalt,100,16,44,12,0,12,84
West Virginia,Whitesville,501,118,158,73,13,50,412
West Virginia,Chester,2314,534,683,369,0,248,1834
West Virginia,Rachel,219,63,77,0,11,21,172
West Virginia,Shannondale,3404,940,1389,318,31,143,2821
West Virginia,Shenandoah Junction,413,95,151,32,51,49,378
West Virginia,Shrewsbury,823,228,375,67,0,60,730
West Virginia,Prichard,282,77,170,0,0,20,267
West Virginia,Wallace,412,77,211,14,0,0,302
West Virginia,St. George,161,52,47,29,0,12,140
West Virginia,Parcoal,115,10,70,7,0,8,95
West Virginia,Arbovale,131,8,65,5,5,48,131
West Virginia,Summersville,3408,844,1423,471,17,310,3065
West Virginia,Wolf Summit,157,33,86,26,0,12,157
West Virginia,Whitmer,12,0,0,12,0,0,12
West Virginia,Waverly,402,118,198,28,0,0,344
West Virginia,Vivian,54,0,30,0,0,0,30
West Virginia,Verdunville,590,68,409,21,0,50,548
West Virginia,Valley Head,248,45,157,0,0,46,248
West Virginia,Van,206,71,84,17,0,6,178
West Virginia,Valley Bend,449,46,232,59,0,18,355
West Virginia,Twilight,36,5,0,23,0,8,36
West Virginia,Tioga,101,64,0,11,0,8,83
West Virginia,Stollings,347,9,80,31,0,142,262
West Virginia,Springfield,272,40,122,35,0,45,242
West Virginia,Spelter,370,61,92,37,0,44,234
West Virginia,Bluefield,10022,2587,3360,1235,104,1014,8300
West Virginia,Harman,88,18,21,23,0,14,76
West Virginia,Elkview,1609,331,709,144,18,118,1320
West Virginia,Monongah,1089,246,510,88,33,84,961
West Virginia,Pullman,151,42,46,32,5,21,146
West Virginia,Glenville,1692,748,372,153,14,77,1364
West Virginia,War,825,88,425,50,19,82,664
West Virginia,Ravenswood,3740,834,1360,461,46,296,2997
West Virginia,Richwood,2031,355,814,363,23,162,1717
West Virginia,Terra Alta,1781,368,676,214,24,72,1354
West Virginia,Pinch,2554,237,1491,180,58,178,2144
West Virginia,St. Albans,10442,1993,4332,1262,132,820,8539
West Virginia,Paden City,3132,706,1232,415,50,142,2545
West Virginia,Blennerhassett,3319,734,1328,430,0,251,2743
West Virginia,Boaz,1585,293,803,157,0,64,1317
West Virginia,Lubeck,1258,212,607,171,0,137,1127
West Virginia,Fayetteville,2838,558,1013,583,6,146,2306
West Virginia,Mallory,1049,281,424,42,17,103,867
West Virginia,Mount Hope,1185,237,507,101,15,90,950
West Virginia,Pax,168,47,68,12,0,10,137
West Virginia,Harts,551,106,150,79,39,57,431
West Virginia,Gilbert Creek,1030,110,604,98,32,78,922
West Virginia,Crab Orchard,1904,447,619,190,0,270,1526
West Virginia,Cairo,295,84,112,23,6,26,251
West Virginia,Harrisville,2256,436,955,265,30,174,1860
West Virginia,Parkersburg,30328,7244,10338,4431,629,2266,24908
West Virginia,Keyser,5119,1789,1530,564,57,386,4326
West Virginia,Hamlin,1533,456,464,165,33,211,1329
West Virginia,Wiley Ford,896,243,290,120,0,93,746
West Virginia,Stanaford,1060,195,328,203,0,187,913
West Virginia,Vienna,10446,2076,5012,812,74,789,8763
West Virginia,Mount Gay-Shamrock,1178,148,536,156,12,210,1062
West Virginia,Clendenin,1064,204,353,186,0,109,852
West Virginia,Fairview,409,96,156,23,4,33,312
West Virginia,Addison (Webster Springs),869,195,349,122,8,69,743
West Virginia,Sophia,1220,242,450,125,10,138,965
West Virginia,Benwood,1440,411,469,169,39,103,1191
West Virginia,Bridgeport,8466,1572,4162,847,19,448,7048
West Virginia,Ellenboro,351,50,124,58,0,45,277
West Virginia,Milton,2612,636,905,410,0,229,2180
West Virginia,New Martinsville,5190,1449,1849,545,42,442,4327
West Virginia,Winfield,2636,428,1324,266,7,84,2109
West Virginia,Moundsville,8651,1829,3207,1458,200,886,7580
West Virginia,Hambleton,207,21,114,32,0,21,188
West Virginia,Kermit,257,35,102,47,9,26,219
West Virginia,Man,1009,204,479,102,4,71,860
West Virginia,St. Marys,1994,395,973,166,12,175,1721
West Virginia,Meadow Bridge,347,50,139,53,2,15,259
West Virginia,Pickens,19,0,19,0,0,0,19
West Virginia,Despard,966,211,390,107,9,84,801
West Virginia,Big Chimney,454,15,241,77,0,80,413
West Virginia,Big Creek,116,21,29,0,0,26,76
West Virginia,Big Sandy,148,0,135,0,0,13,148
West Virginia,Birch River,118,34,13,22,0,0,69
West Virginia,Bluewell,2277,670,583,445,28,191,1917
West Virginia,Bolt,893,151,446,106,0,39,742
West Virginia,Boomer,644,308,84,35,16,27,470
West Virginia,Bowden,0,0,0,0,0,0,0
West Virginia,Brandywine,123,35,0,46,4,22,107
West Virginia,Brenton,207,45,100,15,12,35,207
West Virginia,Bruno,1126,219,369,66,21,48,723
West Virginia,Berwind,422,78,65,61,33,59,296
West Virginia,Brush Fork,1499,310,513,229,0,98,1150
West Virginia,Burlington,115,36,55,0,0,0,91
West Virginia,Carolina,569,172,270,51,0,8,501
West Virginia,Cass,38,25,0,13,0,0,38
West Virginia,Century,97,13,68,0,0,0,81
West Virginia,Charlton Heights,309,29,156,18,0,49,252
West Virginia,Chauncey,501,162,230,53,14,0,459
West Virginia,Chelyan,1001,627,148,93,0,68,936
West Virginia,Comfort,227,43,117,0,0,13,173
West Virginia,Corinne,289,14,182,49,27,17,289
West Virginia,Covel,25,0,25,0,0,0,25
West Virginia,Crum,102,15,46,35,0,6,102
West Virginia,Bud,417,90,166,82,25,0,363
West Virginia,Crumpler,162,16,83,21,0,7,127
West Virginia,Bergoo,57,20,27,0,0,10,57
West Virginia,Beards Fork,137,29,80,16,0,12,137
West Virginia,South Charleston,12686,2772,5073,1813,102,659,10419
West Virginia,Oceana,1192,180,451,178,10,145,964
West Virginia,Princeton,5907,1447,1866,819,82,687,4901
West Virginia,Charles Town,5885,1265,2242,723,49,269,4548
West Virginia,Harpers Ferry,283,71,130,26,0,5,232
West Virginia,Durbin,210,59,97,5,0,5,166
West Virginia,Marlinton,1152,271,366,164,33,82,916
West Virginia,Bolivar,1270,358,437,130,21,92,1038
West Virginia,Weirton,18894,4283,7569,2346,303,1482,15983
West Virginia,Romney,2176,581,602,352,28,207,1770
West Virginia,Huttonsville,181,20,74,16,2,20,132
West Virginia,Belva,66,0,46,8,0,12,66
West Virginia,Mill Creek,737,213,243,108,0,42,606
West Virginia,Gassaway,1019,220,353,114,9,112,808
West Virginia,Beverly,687,203,165,92,19,61,540
West Virginia,Womelsdorf (Coalton),315,61,141,32,3,26,263
West Virginia,White Hall,767,218,259,143,1,36,657
West Virginia,Ranson corpora,5058,1412,1850,587,83,146,4078
West Virginia,Accoville,938,259,432,37,0,0,728
West Virginia,Amherstdale,503,142,224,64,0,0,430
West Virginia,Apple Grove,51,0,42,0,0,9,51
West Virginia,Aurora,185,10,83,13,11,0,117
West Virginia,Bartley,54,0,54,0,0,0,54
West Virginia,Bartow,78,0,45,0,0,0,45
West Virginia,Beech Bottom village,645,140,187,91,13,41,472
West Virginia,Cucumber,65,18,18,12,0,17,65
West Virginia,Dailey,28,16,0,12,0,0,28
West Virginia,Deep Water,306,70,183,0,0,0,253
West Virginia,Jefferson,820,185,208,91,2,138,624
West Virginia,Justice,589,101,285,65,13,13,477
West Virginia,Kimberly,148,24,102,22,0,0,148
West Virginia,Kincaid,68,0,59,0,0,9,68
West Virginia,Kistler,244,27,127,9,0,72,235
West Virginia,Kopperston,486,11,312,30,0,63,416
West Virginia,Lashmeet,408,72,136,85,0,15,308
West Virginia,Lavalette,1347,240,552,37,0,83,912
West Virginia,Lesage,1022,191,429,194,0,106,920
West Virginia,Littleton,131,91,25,0,15,0,131
West Virginia,Clarksburg,15830,4310,4968,2254,313,1033,12878
West Virginia,Jacksonburg,41,0,15,10,0,16,41
West Virginia,Pentress,210,22,78,0,0,14,114
West Virginia,Page,79,0,34,26,10,9,79
West Virginia,Omar,468,53,246,0,0,61,360
West Virginia,New Richmond,374,155,0,85,0,92,332
West Virginia,Nettie,609,64,380,81,0,20,545
West Virginia,Neibert,89,0,89,0,0,0,89
West Virginia,Mount Carbon,381,70,183,62,0,11,326
West Virginia,Monaville,251,67,117,20,0,13,217
West Virginia,Middleway,431,73,198,0,14,32,317
West Virginia,Maybeury,93,10,34,18,0,0,62
West Virginia,Matheny,355,36,227,21,0,9,293
West Virginia,McConnell,585,97,363,33,0,23,516
West Virginia,Pageton,141,35,24,36,0,0,95
West Virginia,Itmann,286,103,137,0,0,46,286
West Virginia,Idamay,544,46,316,13,0,56,431
West Virginia,Hometown,576,203,214,58,36,29,540
West Virginia,Dixie,224,44,157,23,0,0,224
West Virginia,East Dailey,789,141,277,61,0,14,493
West Virginia,Eccles,68,0,0,48,0,20,68
West Virginia,Falling Waters,1485,242,851,38,9,49,1189
West Virginia,Falls View,178,0,111,20,0,10,141
West Virginia,Fenwick,162,41,96,13,0,0,150
West Virginia,Ghent,525,114,310,20,0,22,466
West Virginia,Frank,67,5,12,13,16,5,51
West Virginia,Gallipolis Ferry,852,125,431,92,16,22,686
West Virginia,Galloway,81,12,42,16,0,0,70
West Virginia,Glen Ferris,195,7,126,18,0,0,151
West Virginia,Glen Fork,406,50,228,25,0,15,318
West Virginia,Glen Jean,160,80,57,0,11,12,160
West Virginia,Glen White,302,99,100,20,19,0,238
West Virginia,Great Cacapon,307,57,131,54,0,0,242
West Virginia,Green Bank,257,31,110,17,0,6,164
West Virginia,Green Spring,163,51,74,0,0,38,163
West Virginia,Greenview,461,95,166,7,0,51,319
West Virginia,Gypsy,222,81,53,25,0,50,209
West Virginia,Helen,13,0,0,0,0,13,13
West Virginia,Helvetia,80,0,63,0,0,0,63
West Virginia,Henlawson,90,0,45,22,0,23,90
West Virginia,Hepzibah,572,33,361,47,0,56,497
West Virginia,Hico,253,0,147,37,0,0,184
West Virginia,Hilltop,426,111,152,82,0,81,426
West Virginia,Sissonville,4951,904,2238,595,84,232,4053
West Virginia,Marmet,1440,370,492,180,47,153,1242
West Virginia,Huntersville,117,35,63,0,0,19,117
West Virginia,Masontown,618,168,255,89,0,30,542
West Virginia,North Hills,999,141,520,51,5,29,746
West Virginia,Williamstown,2927,372,1490,277,12,326,2477
West Virginia,Culloden,3457,669,1492,454,108,154,2877
West Virginia,Hurricane,6477,1409,2258,734,148,492,5041
West Virginia,Nitro,6201,1338,2432,963,51,227,5011
West Virginia,Iaeger,229,30,108,25,3,23,189
West Virginia,Kimball,130,19,70,12,0,12,113
West Virginia,Hartford City,722,107,321,99,17,30,574
West Virginia,Kingwood,2943,519,1174,281,60,202,2236
West Virginia,Gary,733,156,261,48,13,141,619
West Virginia,Welch,3287,1155,909,474,151,289,2978
West Virginia,Mineralwells,1866,472,935,78,0,63,1548
West Virginia,New Haven,1520,333,557,247,48,136,1321
West Virginia,Kenova,3095,576,1062,394,100,436,2568
West Virginia,Madison,2860,504,1257,344,14,156,2275
West Virginia,Sylvester,208,44,111,5,0,16,176
West Virginia,East Bank,845,194,336,104,23,74,731
West Virginia,Glasgow,755,144,297,75,8,112,636
West Virginia,Westover,4205,1472,1454,442,33,257,3658
West Virginia,Bath (Berkeley Springs),674,205,212,89,13,32,551
West Virginia,Fairmont,18507,5644,6338,2144,206,1024,15356
West Virginia,Farmington,433,140,170,30,0,19,359
West Virginia,Bramwell,320,57,134,52,3,30,276
West Virginia,Junior,388,96,126,55,0,41,318
West Virginia,Clay,556,159,145,87,2,48,441
West Virginia,Inwood,3364,756,1435,331,24,160,2706
West Virginia,Cowen,636,136,225,102,0,54,517
West Virginia,Prosperity,1597,255,896,174,0,136,1461
West Virginia,West Liberty,1728,1347,187,55,41,18,1648
West Virginia,Eleanor,1521,228,701,113,12,168,1222
West Virginia,Friendly,125,23,24,17,2,12,78
West Virginia,Shady Spring,3485,422,1742,303,11,240,2718
West Virginia,Daniels,1929,273,667,332,43,210,1525
West Virginia,Coal City,1810,346,887,132,0,174,1539
West Virginia,Delbarton,520,92,197,90,14,24,417
West Virginia,Fort Ashby,1461,302,786,183,25,92,1388
West Virginia,Mitchell Heights,458,63,245,25,0,33,366
West Virginia,Logan,1790,411,615,298,59,89,1472
West Virginia,Chapmanville,1171,161,478,130,18,155,942
West Virginia,Grafton,5091,1264,1771,739,67,542,4383
West Virginia,Stonewood,1777,432,806,251,12,79,1580
West Virginia,Moorefield,3201,645,1484,246,32,260,2667
West Virginia,Flemington,397,106,165,29,7,19,326
West Virginia,Carpendale,723,130,325,106,4,50,615
West Virginia,Elk Garden,214,56,73,9,6,18,162
West Virginia,Holden,649,134,230,81,0,93,538
West Virginia,Williamson,2883,700,767,517,24,245,2253
West Virginia,West Logan,491,108,157,63,8,51,387
West Virginia,Piedmont,719,189,213,90,26,63,581
West Virginia,Gilbert,408,65,172,87,5,23,352
West Virginia,Beaver,1384,274,868,125,0,23,1290
West Virginia,Mabscott,1466,145,753,137,18,58,1111
West Virginia,Enterprise,953,110,514,103,25,70,822
West Virginia,Hooverson Heights,2561,568,1236,239,41,163,2247
West Virginia,Lumberport,801,140,362,85,16,51,654
West Virginia,West Union,819,184,277,144,6,51,662
West Virginia,Pine Grove,456,149,185,27,0,39,400
West Virginia,Washington,856,161,467,61,0,57,746
West Virginia,Buffalo,1261,251,466,121,41,121,1000
West Virginia,Peterstown,654,114,218,64,27,74,497
West Virginia,Fairlea,1664,292,613,208,29,206,1348
West Virginia,Falling Spring,184,40,102,13,0,10,165
West Virginia,Ronceverte,1970,323,802,277,21,194,1617
West Virginia,Glen Dale,1505,343,610,169,17,150,1289
West Virginia,Lewisburg,3904,904,1589,436,6,261,3196
West Virginia,Alderson,1178,279,410,153,40,90,972
West Virginia,Wellsburg,2624,690,930,272,92,233,2217
West Virginia,Newburg,400,69,204,37,7,14,331
West Virginia,Reedsville,407,66,198,41,12,44,361
West Virginia,Gauley Bridge,669,165,208,69,9,72,523
West Virginia,Powellton,684,238,193,82,0,63,576
West Virginia,Anmoore,645,113,261,86,4,27,491
West Virginia,Salem,1664,555,517,175,0,99,1346
West Virginia,Cameron,609,150,206,85,16,54,511
West Virginia,Rainelle,1245,208,492,197,24,144,1065
West Virginia,White Sulphur Springs,2745,627,930,405,47,180,2189
West Virginia,Ripley,3198,732,1138,391,13,465,2739
West Virginia,Clearview village,595,120,281,35,4,20,460
West Virginia,Wheeling,27190,7808,9147,3423,417,2114,22909
West Virginia,Belle,1230,205,546,182,9,57,999
West Virginia,Bruceton Mills,48,4,24,8,3,1,40
West Virginia,Poca,1045,201,472,138,19,59,889
West Virginia,Sand Fork,223,54,68,28,0,14,164
West Virginia,Barboursville village,4185,1368,977,841,121,317,3624
West Virginia,Pennsboro,1073,352,355,96,30,41,874
West Virginia,Pratt,436,68,225,31,15,30,369
West Virginia,Hedgesville,299,77,105,44,8,10,244
West Virginia,Martinsburg,17497,5017,4398,2540,538,1213,13706
West Virginia,Chesapeake,1899,461,692,213,14,139,1519
West Virginia,Handley,194,61,53,17,0,25,156
West Virginia,Bradshaw,230,37,104,20,7,22,190
West Virginia,Davy,248,56,103,17,1,22,199
West Virginia,Coal Fork,1335,302,597,165,5,92,1161
West Virginia,Ridgeley,654,172,261,68,16,29,546
West Virginia,Rhodell,111,25,53,9,1,4,92
West Virginia,Rowlesburg,461,158,140,48,10,39,395
West Virginia,Charleston,48734,13918,16036,6617,828,3329,40728
West Virginia,Pineville,736,162,329,75,0,62,628
West Virginia,Bethany,1039,844,157,18,0,12,1031
West Virginia,Montcalm,475,85,192,82,0,16,375
West Virginia,Auburn,117,31,46,2,0,7,86
West Virginia,Hundred,302,93,120,36,6,37,292
West Virginia,Cassville,1378,367,675,183,0,29,1254
West Virginia,Elizabeth,809,112,265,115,27,62,581
West Virginia,Piney View,1267,111,712,65,16,98,1002
West Virginia,Paw Paw,535,72,206,62,5,47,392
West Virginia,Mannington,1623,295,771,170,16,140,1392
West Virginia,Pea Ridge,6215,1556,2350,895,70,389,5260
West Virginia,Henderson,342,88,100,37,5,30,260
West Virginia,Belington,1925,270,809,260,16,120,1475
Wisconsin,Rewey village,306,71,120,37,2,11,241
Wisconsin,Oostburg village,2988,520,1533,169,9,118,2349
Wisconsin,Darien village,1795,372,865,92,16,46,1391
Wisconsin,Montreal,748,151,297,128,7,15,598
Wisconsin,Milwaukee,596886,246428,139294,48248,9521,21791,465282
Wisconsin,Alma Center village,444,57,193,43,10,36,339
Wisconsin,Balsam Lake village,777,193,281,146,9,49,678
Wisconsin,Princeton,1233,294,465,146,0,87,992
Wisconsin,Sussex village,10791,2336,4972,800,14,380,8502
Wisconsin,Mount Calvary village,507,96,217,39,6,36,394
Wisconsin,Howards Grove village,3254,508,1836,134,8,94,2580
Wisconsin,Hanover,167,39,65,3,0,9,116
Wisconsin,Hager City,274,65,141,20,0,4,230
Wisconsin,Green Valley,138,24,73,12,0,0,109
Wisconsin,Greenleaf,825,238,315,31,0,29,613
Wisconsin,Greenbush,142,9,57,14,0,8,88
Wisconsin,Grand View,83,23,35,14,0,3,75
Wisconsin,Kewaunee,2859,592,1179,392,31,150,2344
Wisconsin,Evansville,5260,1041,1938,559,46,279,3863
Wisconsin,Luxemburg village,2547,440,1111,209,21,106,1887
Wisconsin,Rockland village,645,121,262,68,4,22,477
Wisconsin,Hustler village,214,49,80,34,0,19,182
Wisconsin,New Post,274,37,135,35,6,24,237
Wisconsin,Amery,2825,370,1220,368,5,283,2246
Wisconsin,Oconomowoc,16579,3493,7155,1471,108,788,13015
Wisconsin,Greendale village,14245,2794,6520,1164,141,878,11497
Wisconsin,Roberts village,1845,328,781,183,5,56,1353
Wisconsin,Centuria village,904,208,278,107,5,50,648
Wisconsin,Alma,735,188,318,76,2,61,645
Wisconsin,Racine,77576,25058,23047,7614,1031,2943,59693
Wisconsin,Edgar village,1572,319,713,107,6,55,1200
Wisconsin,Delavan Lake,2609,465,1394,237,4,128,2228
Wisconsin,Ironton village,243,53,85,32,2,6,178
Wisconsin,Melrose village,509,124,197,51,12,17,401
Wisconsin,Catawba village,124,32,51,25,2,4,114
Wisconsin,Nekoosa,2494,499,927,288,25,203,1942
Wisconsin,Plover village,12686,2761,5576,1053,41,736,10167
Wisconsin,Whiting village,1637,350,683,198,11,210,1452
Wisconsin,Menasha,18075,4011,7234,1987,192,803,14227
Wisconsin,Odanah,0,0,0,0,0,0,0
Wisconsin,Germantown village,19997,3686,9945,1543,100,825,16099
Wisconsin,Hartford,14761,3297,6118,1461,97,744,11717
Wisconsin,Viroqua,4371,652,1849,501,52,512,3566
Wisconsin,Seymour,1497,231,633,226,0,111,1201
Wisconsin,Casco village,556,118,242,46,8,24,438
Wisconsin,West Bend,31649,6457,13287,3620,336,1980,25680
Wisconsin,Cadott village,1423,398,450,231,0,78,1157
Wisconsin,Augusta,1566,290,603,152,6,122,1173
Wisconsin,Stockbridge village,672,170,323,55,0,33,581
Wisconsin,Durand,1787,343,765,188,6,125,1427
Wisconsin,Endeavor village,586,157,200,56,8,24,445
Wisconsin,Como,2477,646,1042,241,46,106,2081
Wisconsin,Hatfield,199,41,100,13,0,6,160
Wisconsin,Arpin village,333,90,125,36,0,22,273
Wisconsin,Reeseville village,712,221,273,70,2,20,586
Wisconsin,Clyman village,375,104,167,49,2,7,329
Wisconsin,Withee village,405,100,173,36,0,24,333
Wisconsin,Oxford village,567,123,201,87,0,33,444
Wisconsin,Westfield village,1327,268,423,177,17,101,986
Wisconsin,Melvina village,52,5,33,2,0,2,42
Wisconsin,Delavan,8338,2099,3042,863,92,353,6449
Wisconsin,Lime Ridge village,176,12,109,8,5,15,149
Wisconsin,Plain village,735,182,319,62,12,48,623
Wisconsin,Waukau,289,57,138,51,0,9,255
Wisconsin,Waumandee,85,26,34,7,0,6,73
Wisconsin,Westboro,159,26,80,13,3,13,135
Wisconsin,Elkhorn,9907,2468,3611,1087,136,522,7824
Wisconsin,Dellwood,614,101,240,134,11,69,555
Wisconsin,Summit village,4846,1063,2280,451,10,218,4022
Wisconsin,Bloomfield village,4704,1295,1996,241,2,187,3721
Wisconsin,Whittlesey,110,6,67,7,0,5,85
Wisconsin,Harrison village,11761,1799,6356,536,0,268,8959
Wisconsin,Winchester,644,113,364,53,3,17,550
Wisconsin,Woodford,39,18,11,4,0,6,39
Wisconsin,Woodruff,764,148,357,67,5,95,672
Wisconsin,North Bay village,207,44,119,10,0,6,179
Wisconsin,Lancaster,3745,975,1499,367,27,170,3038
Wisconsin,St. Joseph,506,174,188,26,5,18,411
Wisconsin,Lily Lake,477,139,215,1,10,25,390
Wisconsin,Post Lake,267,20,160,26,2,35,243
Wisconsin,Hingham,901,145,507,18,0,11,681
Wisconsin,Van Dyne,201,61,103,15,0,10,189
Wisconsin,Tustin,119,9,63,21,0,14,107
Wisconsin,Turtle Lake,286,35,142,48,3,12,240
Wisconsin,Tunnel City,121,8,79,10,0,6,103
Wisconsin,Trego,174,25,83,23,2,19,152
Wisconsin,Townsend,73,28,31,11,0,3,73
Wisconsin,Tilleda,100,29,27,6,0,9,71
Wisconsin,Tichigan,5208,960,2671,536,19,85,4271
Wisconsin,Three Lakes,521,108,307,47,3,27,492
Wisconsin,Thornton,68,11,46,7,0,0,64
Wisconsin,Taycheedah,782,199,483,0,0,26,708
Wisconsin,Summit Lake,154,23,79,20,4,2,128
Wisconsin,Stone Lake,178,37,101,13,0,2,153
Wisconsin,Springfield,97,35,47,15,0,0,97
Wisconsin,Sobieski,364,100,126,27,43,0,296
Wisconsin,Sextonville,407,77,152,53,0,20,302
Wisconsin,Sayner,204,46,113,2,7,12,180
Wisconsin,Saxon,54,9,25,11,0,7,52
Wisconsin,Sandy Hook,305,67,119,50,0,16,252
Wisconsin,Wabeno,370,94,147,53,0,25,319
Wisconsin,St. Peter,1447,239,738,54,0,48,1079
Wisconsin,Waubeka,760,88,385,51,21,29,574
Wisconsin,Spencer village,1808,384,786,154,45,87,1456
Wisconsin,Downing village,245,51,115,30,2,2,200
Wisconsin,Oakdale village,281,66,122,44,1,15,248
Wisconsin,Lodi,3053,647,1293,262,18,190,2410
Wisconsin,St. Francis,9509,3101,3412,1299,42,574,8428
Wisconsin,Hortonville village,2743,585,1190,254,5,131,2165
Wisconsin,Rosendale village,1013,195,484,76,2,37,794
Wisconsin,Cameron village,1903,363,763,236,29,92,1483
Wisconsin,Spring Valley village,1565,297,621,170,10,72,1170
Wisconsin,Maiden Rock village,95,31,33,15,2,1,82
Wisconsin,Mishicot village,1384,232,609,166,12,97,1116
Wisconsin,Kiel,3750,637,1627,319,17,295,2895
Wisconsin,Merrill,9178,2253,3646,1109,85,696,7789
Wisconsin,Niagara,1536,343,583,169,29,98,1222
Wisconsin,Sherwood village,2917,390,1657,163,5,89,2304
Wisconsin,Middle Village,193,60,42,22,5,8,137
Wisconsin,Scandinavia village,418,97,166,47,12,19,341
Wisconsin,Bowler village,405,73,132,52,5,12,274
Wisconsin,Baraboo,12093,3252,4198,1441,268,788,9947
Wisconsin,Suring village,474,117,164,73,5,52,411
Wisconsin,Dorchester village,910,214,342,91,11,48,706
Wisconsin,Pulcifer,112,35,50,10,0,6,101
Wisconsin,Poy Sippi,285,54,105,71,0,18,248
Wisconsin,Port Wing,197,45,95,31,0,10,181
Wisconsin,Lake Tomahawk,201,66,82,23,9,14,194
Wisconsin,Lauderdale Lakes,1103,204,602,87,0,44,937
Wisconsin,Lake Sherwood,379,56,215,49,0,29,349
Wisconsin,Lake Lorraine,237,59,105,50,0,12,226
Wisconsin,Lake Ivanhoe,449,113,182,31,3,16,345
Wisconsin,Lake Camelot,637,41,442,57,7,18,565
Wisconsin,Lake Arrowhead,910,50,652,85,9,74,870
Wisconsin,Krakow,370,58,177,43,0,18,296
Wisconsin,Knowlton,148,3,89,11,2,3,108
Wisconsin,King,1804,257,809,139,2,394,1601
Wisconsin,Kieler,553,98,308,17,0,14,437
Wisconsin,Jump River,24,5,8,4,0,7,24
Wisconsin,Juda,256,54,97,27,4,15,197
Wisconsin,Jim Falls,243,56,120,33,0,10,219
Wisconsin,Iron River,661,187,218,92,0,88,585
Wisconsin,Iron Belt,187,30,76,24,14,10,154
Wisconsin,Humbird,270,54,88,50,2,4,198
Wisconsin,Houlton,212,105,78,15,0,14,212
Wisconsin,Holcombe,198,36,93,31,2,6,168
Wisconsin,Lakewood,296,54,180,27,0,20,281
Wisconsin,Laona,356,84,150,21,0,29,284
Wisconsin,Lebanon,238,55,120,3,0,8,186
Wisconsin,Leopolis,117,40,24,24,0,8,96
Wisconsin,Polonia,557,154,263,39,4,9,469
Wisconsin,Pine River,153,25,84,15,0,8,132
Wisconsin,Pence,141,19,87,2,0,13,121
Wisconsin,Pembine,110,10,43,14,0,8,75
Wisconsin,Pella,154,25,75,24,0,18,142
Wisconsin,Packwaukee,164,40,59,40,3,20,162
Wisconsin,Ogema,140,39,63,22,0,13,137
Wisconsin,Northport,533,134,299,45,0,9,487
Wisconsin,New Odanah,442,158,91,49,0,25,323
Wisconsin,Herbster,81,8,60,11,0,1,80
Wisconsin,Newald,168,17,102,5,0,7,131
Wisconsin,Mountain,263,43,117,34,11,34,239
Wisconsin,Mole Lake,464,147,88,70,18,14,337
Wisconsin,Minocqua,340,103,73,82,0,57,315
Wisconsin,Millston,116,30,55,15,5,11,116
Wisconsin,Mercer,522,161,211,37,0,67,476
Wisconsin,Marengo,115,24,50,3,0,6,83
Wisconsin,Long Lake,55,9,38,5,0,0,52
Wisconsin,Little Sturgeon,224,14,145,30,0,7,196
Wisconsin,Lewis,154,22,59,37,0,11,129
Wisconsin,Navarino,156,35,91,9,2,3,140
Wisconsin,Athens village,1025,195,509,73,10,81,868
Wisconsin,Hayward,2533,687,785,367,25,140,2004
Wisconsin,Hatley village,488,97,264,31,0,18,410
Wisconsin,Caledonia village,24875,4960,13033,1722,160,1047,20922
Wisconsin,Lake Hallie village,6633,1580,3011,371,95,246,5303
Wisconsin,Mount Pleasant village,26738,5399,12698,2386,159,1555,22197
Wisconsin,Suamico village,12470,2117,6642,763,84,357,9963
Wisconsin,Gilmanton,132,30,53,11,0,10,104
Wisconsin,Springbrook,95,12,31,26,2,6,77
Wisconsin,Wiota,117,22,61,3,3,10,99
Wisconsin,Maine village,2306,395,1235,130,7,124,1891
Wisconsin,Somers village,8334,2848,3207,617,148,333,7153
Wisconsin,Windsor village,6899,921,3685,334,12,366,5318
Wisconsin,Fox Crossing village,18788,4565,8221,1576,318,816,15496
Wisconsin,Salem Lakes village,14692,3870,6351,1171,100,544,12036
Wisconsin,Abrams,462,84,263,24,0,14,385
Wisconsin,Allenton,925,180,408,168,0,0,756
Wisconsin,Amberg,200,32,68,46,0,12,158
Wisconsin,Angelica,93,20,46,1,0,15,82
Wisconsin,Argonne,154,51,52,17,0,8,128
Wisconsin,Arkansaw,196,72,90,11,0,12,185
Wisconsin,Arkdale,119,17,79,3,0,8,107
Wisconsin,Kronenwetter village,7665,1494,4117,358,20,219,6208
Wisconsin,Ashippun,1040,200,529,111,0,23,863
Wisconsin,Hobart village,8606,1826,3990,803,74,237,6930
Wisconsin,Richfield village,11623,1945,6538,699,83,411,9676
Wisconsin,Cashton village,986,285,389,72,15,54,815
Wisconsin,Kendall village,518,89,226,62,0,36,413
Wisconsin,Warrens village,499,93,218,45,7,6,369
Wisconsin,Fenwood village,157,34,80,8,1,7,130
Wisconsin,Marathon City village,1378,240,648,97,10,140,1135
Wisconsin,Schofield,2209,662,717,278,48,124,1829
Wisconsin,North Freedom village,637,173,230,61,2,33,499
Wisconsin,Dresser village,1019,221,342,168,13,37,781
Wisconsin,Nelson village,353,84,160,41,1,13,299
Wisconsin,Ellsworth village,3257,830,1381,299,20,132,2662
Wisconsin,Elmwood village,710,108,344,82,11,52,597
Wisconsin,Star Prairie village,716,168,283,75,3,18,547
Wisconsin,Hudson,13650,3335,5700,1394,73,610,11112
Wisconsin,Mondovi,2626,482,1089,420,8,120,2119
Wisconsin,Rock Springs village,342,70,145,30,0,15,260
Wisconsin,Zoar,126,50,41,6,0,0,97
Wisconsin,Arcadia,3013,869,956,169,26,88,2108
Wisconsin,Whitehall,1608,398,579,142,25,148,1292
Wisconsin,Brookfield,38151,6366,20702,1945,190,1992,31195
Wisconsin,Bellevue village,15515,3008,6929,1632,111,815,12495
Wisconsin,Babcock,68,21,23,14,0,10,68
Wisconsin,Baileys Harbor,207,20,127,22,0,23,192
Wisconsin,Bancroft,548,122,242,30,5,11,410
Wisconsin,Drummond,128,36,46,28,0,6,116
Wisconsin,Dunbar,81,11,43,4,2,2,62
Wisconsin,Dyckesville,549,88,293,65,0,19,465
Wisconsin,Edmund,165,44,39,50,3,0,136
Wisconsin,Elcho,278,61,128,43,0,15,247
Wisconsin,Ellison Bay,161,26,118,8,0,4,156
Wisconsin,Emerald,110,21,45,14,5,12,97
Wisconsin,Eureka,594,185,291,23,0,17,516
Wisconsin,Florence,501,100,149,101,0,92,442
Wisconsin,Forest Junction,735,202,319,60,7,17,605
Wisconsin,Franks Field,163,73,34,19,2,9,137
Wisconsin,Gibbsville,509,57,333,13,0,13,416
Wisconsin,Glen Haven,48,14,21,7,0,5,47
Wisconsin,Glidden,323,96,90,43,0,65,294
Wisconsin,Goodman,232,22,105,40,6,23,196
Wisconsin,Gordon,175,36,105,15,0,5,161
Wisconsin,Gotham,186,25,105,9,3,19,161
Wisconsin,Grand Marsh,168,21,70,23,3,9,126
Wisconsin,Rochester village,3784,948,1756,290,0,114,3108
Wisconsin,Downsville,113,34,49,13,0,2,98
Wisconsin,Dodge,117,50,43,8,0,7,108
Wisconsin,Diaperville,37,14,9,10,0,4,37
Wisconsin,Diamond Bluff,175,27,93,16,5,9,150
Wisconsin,Barronett,148,34,54,18,0,3,109
Wisconsin,Birch Hill,370,116,41,62,0,10,229
Wisconsin,Bluffview,555,125,148,52,20,15,360
Wisconsin,Boulder Junction,100,14,51,16,7,3,91
Wisconsin,Bristol village,4993,699,2779,368,35,189,4070
Wisconsin,Brule,227,43,99,18,0,7,167
Wisconsin,Burnett,230,28,113,33,3,11,188
Wisconsin,Butte des Morts,799,137,485,61,0,16,699
Wisconsin,Cable,216,23,79,25,9,28,164
Wisconsin,Montello,1434,414,445,241,40,163,1303
Wisconsin,Caroline,217,55,111,5,0,14,185
Wisconsin,Chain O' Lakes,848,77,537,87,0,94,795
Wisconsin,Chelsea,104,31,44,9,0,2,86
Wisconsin,Chili,180,48,61,9,0,6,124
Wisconsin,Clam Lake,29,2,22,5,0,0,29
Wisconsin,Collins,140,32,69,8,0,4,113
Wisconsin,Cornucopia,92,18,55,10,0,9,92
Wisconsin,Dale,586,90,320,56,0,5,471
Wisconsin,Dalton,230,44,87,24,5,13,173
Wisconsin,Danbury,156,36,44,39,2,6,127
Wisconsin,Cataract,169,36,51,44,0,6,137
Wisconsin,Marquette village,172,37,87,8,0,15,147
Wisconsin,Kingston village,327,65,159,31,1,12,268
Wisconsin,Whitewater,14766,9592,2603,692,186,393,13466
Wisconsin,Oconomowoc Lake village,585,114,337,29,0,14,494
Wisconsin,Wales village,2564,434,1340,140,13,57,1984
Wisconsin,Waukesha,72382,21299,28535,6602,365,2768,59569
Wisconsin,Mequon,23984,4520,12984,1269,48,1121,19942
Wisconsin,Little Round Lake,1190,397,149,141,3,64,754
Wisconsin,Genoa City village,3009,737,1208,248,16,102,2311
Wisconsin,Lake Geneva,7815,1684,3318,914,59,332,6307
Wisconsin,Sharon village,1748,422,722,149,27,71,1391
Wisconsin,Reserve,341,123,81,53,4,24,285
Wisconsin,Forestville village,482,113,223,34,3,8,381
Wisconsin,Superior village,781,166,302,93,3,61,625
Wisconsin,Camp Douglas village,635,122,231,82,6,39,480
Wisconsin,New Auburn village,482,62,208,51,3,26,350
Wisconsin,Howard village,19396,4553,8586,1683,82,846,15750
Wisconsin,Nichols village,272,57,104,42,6,3,212
Wisconsin,Clinton village,2160,609,761,303,44,96,1813
Wisconsin,Peshtigo,3383,780,1144,518,29,328,2799
Wisconsin,Burlington,10758,2359,4353,1101,151,658,8622
Wisconsin,Radisson village,294,117,60,21,8,22,228
Wisconsin,New Berlin,39774,7892,20517,2750,178,2250,33587
Wisconsin,Lannon village,1177,245,556,158,11,36,1006
Wisconsin,Dousman village,2411,480,1043,175,6,249,1953
Wisconsin,Strum village,1098,198,467,109,18,107,899
Wisconsin,Allouez village,13891,3528,6317,1009,113,653,11620
Wisconsin,Arena village,874,207,355,82,2,29,675
Wisconsin,Muscoda village,1443,336,501,167,32,99,1135
Wisconsin,Kohler village,2193,323,1215,156,7,77,1778
Wisconsin,Green Bay,104818,31474,35552,10423,1214,4213,82876
Wisconsin,Hazel Green village,1002,204,451,76,13,64,808
Wisconsin,Pleasant Prairie village,20722,4700,9383,1850,318,968,17219
Wisconsin,Maribel village,369,103,156,25,1,16,301
Wisconsin,St. Nazianz village,803,184,349,112,2,34,681
Wisconsin,Winter village,311,78,101,42,12,31,264
Wisconsin,Plum City village,552,107,203,61,17,67,455
Wisconsin,Deer Park village,283,44,98,48,2,22,214
Wisconsin,Brandon village,906,167,413,78,0,63,721
Wisconsin,Eden village,758,150,354,83,5,21,613
Wisconsin,Fond du Lac,42858,11192,16251,4609,332,2560,34944
Wisconsin,North Fond du Lac village,5066,1035,2253,339,71,317,4015
Wisconsin,Waupun,11296,3102,4256,1135,176,728,9397
Wisconsin,Trempealeau village,1742,393,728,155,21,87,1384
Wisconsin,Kimberly village,6744,1279,2794,670,101,326,5170
Wisconsin,Bayside village,4529,700,2456,320,0,196,3672
Wisconsin,Prescott,4235,898,1890,383,49,185,3405
Wisconsin,Colby,1989,450,766,152,11,143,1522
Wisconsin,Union Center village,195,34,95,25,0,10,164
Wisconsin,Wilson village,220,40,131,14,1,2,188
Wisconsin,Cleveland village,1642,259,838,126,6,54,1283
Wisconsin,Baldwin village,4000,628,1842,241,41,251,3003
Wisconsin,Fountain City,859,197,407,85,3,50,742
Wisconsin,Linden village,512,118,203,62,3,26,412
Wisconsin,Argyle village,875,199,341,93,0,58,691
Wisconsin,Random Lake village,1643,427,701,198,2,66,1394
Wisconsin,Hancock village,385,109,118,66,3,23,319
Wisconsin,Denmark village,2143,385,944,146,33,104,1612
Wisconsin,Twin Lakes village,6070,1475,2632,566,52,288,5013
Wisconsin,Eagle Lake,1084,272,511,114,8,32,937
Wisconsin,Union Grove village,4925,1312,1845,737,0,109,4003
Wisconsin,Waterford village,5437,819,2778,363,10,257,4227
Wisconsin,Two Rivers,11219,2649,4456,1349,64,904,9422
Wisconsin,Whitelaw village,666,138,347,57,2,24,568
Wisconsin,Glenwood City,1295,271,505,165,10,71,1022
Wisconsin,Unity village,350,70,167,22,6,18,283
Wisconsin,Oconto Falls,2826,753,1167,274,0,190,2384
Wisconsin,Cazenovia village,360,85,127,48,2,25,287
Wisconsin,Merrimac village,597,144,237,58,17,25,481
Wisconsin,Wauwatosa,47882,11792,20379,3674,365,2557,38767
Wisconsin,South Milwaukee,21089,5749,7978,2111,285,1338,17461
Wisconsin,North Hudson village,3803,682,1633,349,0,150,2814
Wisconsin,Tomahawk,3201,753,1327,298,28,241,2647
Wisconsin,Cecil village,548,99,313,74,0,28,514
Wisconsin,Gresham village,504,82,183,66,5,20,356
Wisconsin,Mattoon village,443,66,176,40,5,24,311
Wisconsin,Wittenberg village,1074,280,397,126,12,103,918
Wisconsin,Gilman village,379,70,147,52,15,56,340
Wisconsin,Granton village,326,72,131,38,1,13,255
Wisconsin,Gays Mills village,488,130,168,73,2,41,414
Wisconsin,Lynxville village,235,22,96,17,3,12,150
Wisconsin,Mayville,4921,1141,1980,642,15,244,4022
Wisconsin,Walworth village,2822,631,1041,336,51,167,2226
Wisconsin,Kaukauna,15998,4034,6725,1559,73,717,13108
Wisconsin,Coleman village,776,129,340,102,2,27,600
Wisconsin,Pound village,435,97,186,53,2,10,348
Wisconsin,New Glarus village,1951,360,868,229,5,121,1583
Wisconsin,Columbus,5022,1103,2382,375,33,154,4047
Wisconsin,Iron Ridge village,971,234,409,130,2,30,805
Wisconsin,Ripon,7777,2173,2750,916,54,609,6502
Wisconsin,Fox Point village,6688,1304,3438,542,0,184,5468
Wisconsin,Hales Corners village,7666,1703,3494,776,37,410,6420
Wisconsin,Crandon,1994,487,740,259,21,132,1639
Wisconsin,Antigo,7799,1943,2745,1127,48,507,6370
Wisconsin,Sister Bay village,755,104,404,52,23,92,675
Wisconsin,Brodhead,3275,811,1140,406,55,267,2679
Wisconsin,Superior,26346,7912,8830,3221,350,1647,21960
Wisconsin,Milton,5577,1385,2257,603,16,254,4515
Wisconsin,Paddock Lake village,2988,647,1387,351,11,110,2506
Wisconsin,Shullsburg,1289,267,624,107,0,65,1063
Wisconsin,Blanchardville village,819,196,327,130,4,29,686
Wisconsin,Benton village,970,163,485,87,0,65,800
Wisconsin,Wrightstown village,3389,554,1522,232,5,114,2427
Wisconsin,Bohners Lake,2520,478,1259,266,0,78,2081
Wisconsin,Rhinelander,7528,2087,2658,845,0,609,6199
Wisconsin,Belmont village,981,181,424,94,3,45,747
Wisconsin,Lohrville village,340,56,164,39,3,34,296
Wisconsin,Cedar Grove village,2111,450,917,157,5,184,1713
Wisconsin,Adell village,564,119,268,43,1,8,439
Wisconsin,Montfort village,806,126,349,63,8,30,576
Wisconsin,Mineral Point,2560,466,1065,291,24,186,2032
Wisconsin,Cobb village,490,106,269,24,1,16,416
Wisconsin,Avoca village,725,202,282,50,0,41,575
Wisconsin,Wisconsin Rapids,17842,4178,6449,2239,128,1300,14294
Wisconsin,Rosholt village,511,133,194,51,3,24,405
Wisconsin,Amherst Junction village,400,97,199,18,0,4,318
Wisconsin,Wauzeka village,782,132,296,84,5,28,545
Wisconsin,Washburn,2014,354,844,195,47,215,1655
Wisconsin,Fennimore,2575,621,1066,193,14,121,2015
Wisconsin,Bloomington village,764,137,337,59,14,38,585
Wisconsin,Park Falls,2367,547,914,364,4,185,2014
Wisconsin,Bloomer,3503,736,1429,396,0,279,2840
Wisconsin,Chaseburg village,320,54,165,34,1,11,265
Wisconsin,Viola village,742,148,250,116,6,44,564
Wisconsin,Westby,2461,442,994,213,25,166,1840
Wisconsin,Cornell,1733,408,546,208,36,102,1300
Wisconsin,West Baraboo village,1665,422,558,224,20,48,1272
Wisconsin,Neenah,25886,5960,10253,3044,276,1149,20682
Wisconsin,Jefferson,7964,1867,3388,828,82,378,6543
Wisconsin,Fort Atkinson,12429,2777,4877,1471,36,868,10029
Wisconsin,Ontario village,505,121,213,37,2,15,388
Wisconsin,Platteville,12301,7460,2668,571,79,478,11256
Wisconsin,Hollandale village,261,44,141,17,2,3,207
Wisconsin,Weyerhaeuser village,268,70,92,37,8,17,224
Wisconsin,Fredonia village,2395,407,1257,153,29,41,1887
Wisconsin,Independence,1579,417,552,125,6,93,1193
Wisconsin,Monroe,10636,2492,4220,1300,56,708,8776
Wisconsin,Eastman village,419,102,190,17,1,19,329
Wisconsin,Bagley village,333,59,162,43,0,30,294
Wisconsin,Greenfield,37083,9705,14096,4046,369,3001,31217
Wisconsin,Waupaca,5950,1779,1927,764,69,543,5082
Wisconsin,Coon Valley village,825,126,388,72,13,47,646
Wisconsin,Hewitt village,942,118,538,35,2,21,714
Wisconsin,Combined Locks village,3570,681,1849,194,0,143,2867
Wisconsin,Milladore village,316,45,140,29,5,8,227
Wisconsin,Rome,738,106,387,66,0,28,587
Wisconsin,Cross Plains village,4106,751,2034,250,48,114,3197
Wisconsin,Arlington village,796,98,383,66,3,27,577
Wisconsin,Madison,252086,107245,81914,18500,1730,7106,216495
Wisconsin,Buffalo City,893,106,507,93,6,48,760
Wisconsin,Hawkins village,381,73,146,65,4,26,314
Wisconsin,Chippewa Falls,14017,3571,5140,1442,90,1056,11299
Wisconsin,Aniwa village,251,76,71,38,0,20,205
Wisconsin,Oliver village,388,78,172,33,1,24,308
Wisconsin,Readstown village,447,114,160,78,1,30,383
Wisconsin,Boyd village,599,109,260,54,3,27,453
Wisconsin,Genoa village,235,53,107,17,0,23,200
Wisconsin,Janesville,64128,15949,24636,7482,694,3133,51894
Wisconsin,Slinger village,5330,1187,2273,547,0,230,4237
Wisconsin,Bayfield,504,169,210,54,2,33,468
Wisconsin,Woodman village,81,27,31,9,2,4,73
Wisconsin,Patch Grove village,160,35,80,17,0,6,138
Wisconsin,Hillsboro,1318,267,550,122,25,116,1080
Wisconsin,Mount Hope village,203,55,74,17,1,4,151
Wisconsin,Ogdensburg village,188,31,89,36,1,7,164
Wisconsin,Whitefish Bay village,14039,2434,6606,793,93,575,10501
Wisconsin,Shorewood village,13344,4174,5166,1087,101,424,10952
Wisconsin,Weyauwega,1805,369,697,214,50,93,1423
Wisconsin,Newburg village,1118,300,475,123,0,58,956
Wisconsin,Jackson village,7020,1407,2828,962,83,400,5680
Wisconsin,Vesper village,615,113,299,60,11,12,495
Wisconsin,Beloit,36813,10844,10977,3992,777,2010,28600
Wisconsin,St. Cloud village,497,94,269,23,0,40,426
Wisconsin,Campbellsport village,1911,453,748,210,8,95,1514
Wisconsin,Hustisford village,991,204,448,80,3,24,759
Wisconsin,Horicon,3623,920,1330,388,40,148,2826
Wisconsin,Fox Lake,1647,431,602,196,10,102,1341
Wisconsin,Rib Lake village,923,154,340,96,13,83,686
Wisconsin,Medford,4312,879,1789,481,29,338,3516
Wisconsin,Lublin village,101,19,39,20,6,9,93
Wisconsin,Brillion,3133,735,1347,203,0,133,2418
Wisconsin,Stoddard village,904,232,364,100,8,42,746
Wisconsin,Stratford village,1640,383,615,178,10,80,1266
Wisconsin,Manitowoc,32798,7802,13081,3359,348,2482,27072
Wisconsin,De Soto village,331,72,148,39,3,14,276
Wisconsin,Orfordville village,1280,341,520,144,0,70,1075
Wisconsin,Bell Center village,120,33,56,7,2,4,102
Wisconsin,Neillsville,2373,489,992,267,12,235,1995
Wisconsin,Cassville village,875,188,395,72,6,97,758
Wisconsin,Grantsburg village,1343,301,475,132,28,124,1060
Wisconsin,New London,6772,1713,2430,851,150,342,5486
Wisconsin,Iola village,1179,236,420,187,20,145,1008
Wisconsin,Potter village,279,91,125,13,1,9,239
Wisconsin,Hilbert village,1004,217,445,101,0,34,797
Wisconsin,Eau Claire,68086,25662,22662,5584,409,3081,57398
Wisconsin,Pepin village,828,183,325,131,18,62,719
Wisconsin,Prairie du Sac village,4288,602,1980,329,62,282,3255
Wisconsin,Hixton village,455,81,236,49,2,22,390
Wisconsin,Lake Nebagamon village,1005,183,500,110,0,26,819
Wisconsin,Darlington,2330,563,841,219,13,235,1871
Wisconsin,Lake Wissota,2929,374,1632,321,25,147,2499
Wisconsin,Cumberland,2458,512,939,260,25,241,1977
Wisconsin,Butler village,1835,546,627,315,6,78,1572
Wisconsin,Weston village,15093,3534,6549,1298,95,727,12203
Wisconsin,New Holstein,3142,707,1534,189,10,242,2682
Wisconsin,Milltown village,1115,281,396,165,6,46,894
Wisconsin,North Prairie village,2303,485,1164,181,7,75,1912
Wisconsin,Merrillan village,617,118,255,55,10,35,473
Wisconsin,Woodville village,1329,350,470,117,12,88,1037
Wisconsin,Gillett,1104,229,436,178,0,84,927
Wisconsin,Tigerton village,602,143,255,62,2,57,519
Wisconsin,Oak Creek,35843,8556,15703,2974,369,1442,29044
Wisconsin,Ingram village,70,14,35,4,0,9,62
Wisconsin,Plymouth,8540,1491,3609,1032,119,654,6905
Wisconsin,Berlin,5428,1275,2282,418,55,431,4461
Wisconsin,Redgranite village,1991,885,475,390,37,85,1872
Wisconsin,Wild Rose village,798,171,295,74,8,76,624
Wisconsin,Sturtevant village,6611,2531,1934,969,92,306,5832
Wisconsin,Wind Point village,1766,229,1049,100,27,107,1512
Wisconsin,Kellnersville village,346,63,142,56,1,28,290
Wisconsin,Valders village,974,207,426,56,9,58,756
Wisconsin,Elm Grove village,6172,1054,3289,303,26,326,4998
Wisconsin,Little Chute village,11225,2529,5053,1097,33,418,9130
Wisconsin,Merton village,3632,616,1928,149,7,51,2751
Wisconsin,West Milwaukee village,4173,1778,943,616,39,101,3477
Wisconsin,Cedarburg,11501,2195,5756,789,38,743,9521
Wisconsin,West Allis,60250,19854,19709,6905,538,3264,50270
Wisconsin,Ephraim village,280,25,184,25,1,26,261
Wisconsin,Sturgeon Bay,8907,1499,4280,994,136,484,7393
Wisconsin,Poplar village,665,103,302,68,3,30,506
Wisconsin,Solon Springs village,591,114,278,87,20,22,521
Wisconsin,Shell Lake,1348,173,602,121,10,174,1080
Wisconsin,Sun Prairie,32757,8246,13426,2655,203,1362,25892
Wisconsin,Ixonia,1925,277,899,182,9,21,1388
Wisconsin,Palmyra village,1737,434,771,141,40,99,1485
Wisconsin,Tainter Lake,2763,346,1536,309,4,76,2271
Wisconsin,Blue Mounds village,1002,175,428,110,9,33,755
Wisconsin,Fitchburg,28722,8163,11300,2369,415,801,23048
Wisconsin,Cascade village,656,161,293,59,9,27,549
Wisconsin,Mazomanie village,1820,392,819,178,24,52,1465
Wisconsin,Sheldon village,224,28,105,17,8,16,174
Wisconsin,Luck village,1165,209,451,184,16,123,983
Wisconsin,Nelsonville village,94,26,40,7,2,2,77
Wisconsin,Appleton,74234,19690,29731,6491,567,2936,59415
Wisconsin,Winneconne village,2627,421,1184,329,0,105,2039
Wisconsin,Butternut village,426,129,112,60,3,34,338
Wisconsin,Mellen,687,151,291,82,1,75,600
Wisconsin,Kewaskum village,4159,745,1924,420,25,91,3205
Wisconsin,Edgerton,5522,1565,2019,737,34,236,4591
Wisconsin,Footville village,872,208,354,76,13,62,713
Wisconsin,La Farge village,845,166,326,123,0,42,657
Wisconsin,Fairchild village,567,178,142,74,14,36,444
Wisconsin,Altoona,7499,1628,2967,871,74,322,5862
Wisconsin,Algoma,3069,621,1490,263,13,162,2549
Wisconsin,White Lake village,301,95,123,33,0,31,282
Wisconsin,Prairie Farm village,489,117,192,60,2,46,417
Wisconsin,Birchwood village,356,64,93,81,10,36,284
Wisconsin,Cambria village,714,181,269,67,7,15,539
Wisconsin,Friesland village,304,38,152,17,4,16,227
Wisconsin,Portage,10361,3297,3458,1262,97,635,8749
Wisconsin,Wyocena village,778,212,259,92,5,95,663
Wisconsin,Menomonie,16312,8423,3654,1481,102,825,14485
Wisconsin,Rockdale village,226,46,80,14,3,18,161
Wisconsin,Grafton village,11627,2640,5578,867,90,518,9693
Wisconsin,Lake Delton village,2984,826,1215,281,22,151,2495
Wisconsin,La Valle village,354,105,122,25,5,36,293
Wisconsin,Birnamwood village,802,225,291,60,0,65,641
Wisconsin,Turtle Lake village,945,190,291,141,19,71,712
Wisconsin,Shorewood Hills village,2214,436,1120,144,5,86,1791
Wisconsin,Waunakee village,13522,2091,6265,1054,85,636,10131
Wisconsin,Bangor village,1293,217,659,119,11,70,1076
Wisconsin,Clear Lake village,996,224,351,134,11,62,782
Wisconsin,Fremont village,593,112,310,59,10,32,523
Wisconsin,Wausaukee village,516,105,186,69,11,61,432
Wisconsin,Chilton,3848,936,1738,266,11,275,3226
Wisconsin,Chief Lake,506,166,112,59,0,37,374
Wisconsin,Bruce village,738,150,283,110,12,51,606
Wisconsin,Osceola village,2496,538,990,356,3,170,2057
Wisconsin,Clayton village,466,91,153,59,15,14,332
Wisconsin,Thiensville village,3182,802,1332,296,31,277,2738
Wisconsin,Muskego,24868,4544,12873,1446,36,1180,20079
Wisconsin,Frederic village,1037,224,407,122,11,82,846
Wisconsin,Lac La Belle village,287,47,168,6,0,10,231
Wisconsin,Eagle village,2069,407,995,157,9,30,1598
Wisconsin,Saukville village,4456,966,1990,269,25,227,3477
Wisconsin,Shawano,9009,2393,3158,917,66,716,7250
Wisconsin,Wilton village,475,114,137,73,6,26,356
Wisconsin,Tomah,9349,2478,2760,1338,200,605,7381
Wisconsin,Sparta,9656,2464,3728,1152,2,541,7887
Wisconsin,Green Lake,828,160,388,115,0,76,739
Wisconsin,Wonewoc village,732,125,295,89,10,68,587
Wisconsin,Mauston,4375,1228,1497,568,77,303,3673
Wisconsin,Lyndon Station village,478,106,184,71,2,16,379
Wisconsin,Adams,1996,437,635,280,55,208,1615
Wisconsin,Exeland village,225,60,99,18,2,8,187
Wisconsin,Couderay village,73,11,34,15,0,7,67
Wisconsin,St. Croix Falls,1922,380,746,293,21,195,1635
Wisconsin,Webster village,671,188,173,107,13,52,533
Wisconsin,Big Falls village,42,16,13,6,0,7,42
Wisconsin,Embarrass village,548,62,198,81,4,75,420
Wisconsin,Junction City village,428,112,162,40,5,20,339
Wisconsin,Stevens Point,26402,12401,7398,1857,159,1039,22854
Wisconsin,Auburndale village,752,93,343,74,3,32,545
Wisconsin,Biron village,918,153,396,102,0,103,754
Wisconsin,Port Edwards village,1688,267,764,229,18,134,1412
Wisconsin,Ladysmith,3188,620,1120,433,20,428,2621
Wisconsin,Lac du Flambeau,1537,542,370,234,26,67,1239
Wisconsin,DeForest village,9936,2116,4588,677,85,238,7704
Wisconsin,Wheeler village,360,88,149,25,8,18,288
Wisconsin,Ridgeland village,260,56,89,35,0,22,202
Wisconsin,Poynette village,2496,473,1073,278,18,106,1948
Wisconsin,Minong village,427,73,187,64,5,35,364
Wisconsin,South Wayne village,404,90,179,39,3,27,338
Wisconsin,Dallas village,403,64,182,48,4,19,317
Wisconsin,Stanley,3660,1270,941,692,54,140,3097
Wisconsin,Haugen village,334,62,136,37,6,23,264
Wisconsin,Brownsville village,616,137,317,52,2,12,520
Wisconsin,Beaver Dam,16366,4153,5680,2052,197,998,13080
Wisconsin,Prentice village,619,99,250,128,16,26,519
Wisconsin,Steuben village,77,24,26,11,1,4,66
Wisconsin,Soldiers Grove village,569,115,182,63,18,65,443
Wisconsin,Potosi village,698,158,347,60,3,43,611
Wisconsin,Dickeyville village,1227,275,551,100,0,48,974
Wisconsin,Boscobel,3150,895,1233,272,17,265,2682
Wisconsin,Blue River village,444,115,154,55,8,32,364
Wisconsin,Siren village,824,230,306,90,16,65,707
Wisconsin,Fall Creek village,1475,279,605,153,1,86,1124
Wisconsin,De Pere,24836,6498,10328,1967,145,950,19888
Wisconsin,Tennyson village,301,74,136,27,0,19,256
Wisconsin,Coloma village,413,92,157,56,2,41,348
Wisconsin,Park Ridge village,507,91,251,45,0,48,435
Wisconsin,French Island,4360,1059,2276,352,0,150,3837
Wisconsin,Lake Mills,5850,1078,2662,604,15,186,4545
Wisconsin,Cambridge village,1250,299,602,128,4,68,1101
Wisconsin,Holmen village,9909,1700,4534,762,70,372,7438
Wisconsin,Mount Horeb village,7421,1448,3056,488,78,401,5471
Wisconsin,Sullivan village,711,186,280,89,17,22,594
Wisconsin,Monona,8068,2089,3265,920,48,429,6751
Wisconsin,Marshall village,3965,939,1512,426,13,125,3015
Wisconsin,Spooner,2591,460,990,396,52,222,2120
Wisconsin,Brooklyn village,1283,264,655,62,6,23,1010
Wisconsin,Belleville village,2459,447,1086,218,28,115,1894
Wisconsin,Rice Lake,8324,2007,3087,1247,62,517,6920
Wisconsin,Almena village,685,161,241,123,0,23,548
Wisconsin,Manawa,1428,330,523,113,10,83,1059
Wisconsin,Stockholm village,88,18,42,22,0,2,84
Wisconsin,Crivitz village,998,184,394,125,13,124,840
Wisconsin,Marion,1138,237,457,153,5,93,945
Wisconsin,Clintonville,4384,842,1606,576,94,409,3527
Wisconsin,Marinette,10678,2723,3900,1424,102,704,8853
Wisconsin,Glendale,13015,3454,5632,1160,61,848,11155
Wisconsin,Pigeon Falls village,403,52,191,34,0,76,353
Wisconsin,Blair,1334,344,431,112,31,116,1034
Wisconsin,Omro,3573,862,1413,342,8,182,2807
Wisconsin,Reedsburg,9484,2175,3638,768,68,561,7210
Wisconsin,Lake Wazeecha,2426,383,1356,152,0,96,1987
Wisconsin,Livingston village,603,124,286,37,2,22,471
Wisconsin,Rio village,1091,219,440,125,6,50,840
Wisconsin,Black Earth village,1395,276,624,186,10,52,1148
Wisconsin,Maple Bluff village,1422,272,801,58,0,44,1175
Wisconsin,Verona,12743,2867,5538,857,131,345,9738
Wisconsin,Waterloo,3333,749,1537,309,49,131,2775
Wisconsin,La Crosse,51866,24303,13709,4710,343,2295,45360
Wisconsin,West Salem village,5013,1035,2326,346,0,319,4026
Wisconsin,Eagle River,1550,485,427,225,27,110,1274
Wisconsin,Neshkoro village,383,52,195,46,3,57,353
Wisconsin,East Troy village,4330,869,1933,502,8,154,3466
Wisconsin,Friendship village,628,190,231,71,4,76,572
Wisconsin,Tony village,118,16,47,11,4,18,96
Wisconsin,Richland Center,5050,1242,1860,597,10,316,4025
Wisconsin,Lone Rock village,814,198,308,113,12,55,686
Wisconsin,Port Washington,11695,2363,5074,1448,103,450,9438
Wisconsin,Belgium village,2210,337,1081,183,9,89,1699
Wisconsin,Pewaukee village,8207,2525,2997,975,73,539,7109
Wisconsin,Nashotah village,1200,226,626,82,4,64,1002
Wisconsin,Mukwonago village,7833,1692,3397,776,53,400,6318
Wisconsin,Hartland village,9260,1845,4243,857,18,437,7400
Wisconsin,Osseo,1694,322,740,175,21,98,1356
Wisconsin,Sheboygan,48531,12266,18846,4967,471,2066,38616
Wisconsin,Ridgeway village,663,188,268,52,2,29,539
Wisconsin,Dodgeville,4734,1129,2041,404,13,290,3877
Wisconsin,Brokaw village,257,78,95,19,5,22,219
Wisconsin,Wyeville village,159,34,64,13,1,6,118
Wisconsin,Norwalk village,698,141,234,36,16,27,454
Wisconsin,Phillips,1437,381,506,192,29,131,1239
Wisconsin,Ferryville village,159,11,111,19,0,9,150
Wisconsin,Albany village,1207,398,391,137,10,47,983
Wisconsin,Brown Deer village,12039,2726,4965,1267,178,604,9740
Wisconsin,Monticello village,1050,246,443,141,34,45,909
Wisconsin,Seymour,3461,958,1489,227,2,204,2880
Wisconsin,Shiocton village,852,182,355,94,2,39,672
Wisconsin,Cudahy,18349,5274,6585,2284,127,1116,15386
Wisconsin,River Hills village,1479,243,835,60,7,66,1211
Wisconsin,Keshena,1377,562,266,94,5,25,952
Wisconsin,Legend Lake,1496,371,648,143,6,105,1273
Wisconsin,Ettrick village,587,119,222,51,12,61,465
Wisconsin,Galesville,1794,484,615,185,22,135,1441
Wisconsin,Brice Prairie,2173,382,1163,167,0,36,1748
Wisconsin,Onalaska,18546,3910,8017,1629,216,1266,15038
Wisconsin,Almond village,482,119,188,39,3,19,368
Wisconsin,Ashland,7963,2360,2803,991,88,462,6704
Wisconsin,Boyceville village,985,167,407,153,5,32,764
Wisconsin,Doylestown village,234,50,97,38,1,15,201
Wisconsin,Elk Mound village,1085,242,367,132,13,49,803
Wisconsin,Knapp village,553,101,224,63,10,44,442
Wisconsin,Deerfield village,2528,629,1090,187,8,40,1954
Wisconsin,McFarland village,8492,1939,4135,619,83,211,6987
Wisconsin,Ashwaubenon village,17181,4499,7455,1394,102,809,14259
Wisconsin,Loyal,1265,281,541,109,27,53,1011
Wisconsin,Theresa village,1056,178,536,126,0,61,901
Wisconsin,Hurley,1533,356,491,258,35,185,1325
Wisconsin,Rib Mountain,6033,1263,3197,217,43,157,4877
Wisconsin,Mosinee,4009,923,1901,317,10,213,3364
Wisconsin,Somerset village,2740,733,919,301,29,31,2013
Wisconsin,New Richmond,8890,1982,3503,1026,168,366,7045
Wisconsin,Elmwood Park village,520,91,263,49,2,33,438
Wisconsin,Gratiot village,261,66,102,31,6,13,218
Wisconsin,Browns Lake,2070,237,1269,36,0,162,1704
Wisconsin,Wautoma,2122,568,620,270,32,168,1658
Wisconsin,Glenbeulah village,425,78,214,43,2,16,353
Wisconsin,Cuba City,2168,409,913,173,24,176,1695
Wisconsin,Amherst village,1028,244,352,152,0,63,811
Wisconsin,Pardeeville village,2077,361,857,267,5,108,1598
Wisconsin,Lake Ripley,1845,349,934,276,8,77,1644
Wisconsin,Stoughton,13080,2703,5402,1217,119,793,10234
Wisconsin,Pittsville,902,153,420,69,5,89,736
Wisconsin,Stetsonville village,601,142,233,63,4,29,471
Wisconsin,Kekoskee village,179,17,115,14,0,14,160
Wisconsin,Bear Creek village,383,112,122,49,7,19,309
Wisconsin,Black Creek village,1379,305,530,168,23,26,1052
Wisconsin,Fairwater village,378,126,146,21,0,15,308
Wisconsin,Oakfield village,1020,232,522,110,6,24,894
Wisconsin,Franklin,36185,8510,16538,2701,145,1977,29871
Wisconsin,Marshfield,18305,4591,7464,2106,146,1102,15409
Wisconsin,Rudolph village,463,119,242,30,0,17,408
Wisconsin,Lake Koshkonong,1133,202,632,84,4,64,986
Wisconsin,Fall River village,1884,354,835,157,16,62,1424
Wisconsin,Middleton,19235,4970,8220,1983,186,685,16044
Wisconsin,Chetek,2166,429,983,220,18,233,1883
Wisconsin,Neosho village,629,143,272,37,3,25,480
Wisconsin,Randolph village,1894,405,709,225,13,115,1467
Wisconsin,Helenville,234,47,124,24,0,11,206
Wisconsin,Lomira village,2582,622,1035,253,24,164,2098
Wisconsin,Johnson Creek village,2969,581,1351,244,10,83,2269
Wisconsin,Watertown,23677,5775,9445,2192,178,1544,19134
Wisconsin,Oshkosh,66610,25346,20347,7508,426,3155,56782
Wisconsin,Mason village,102,19,41,9,0,2,71
Wisconsin,Kennan village,113,22,44,25,0,10,101
Wisconsin,Thorp,1502,308,564,183,14,154,1223
Wisconsin,Curtiss village,299,56,94,16,13,4,183
Wisconsin,Greenwood,1009,225,390,144,10,79,848
Wisconsin,Owen,879,141,377,79,22,63,682
Wisconsin,Prairie du Chien,5695,1573,2006,791,85,417,4872
Wisconsin,Chenequa village,560,74,363,24,0,19,480
Wisconsin,Menomonee Falls village,36784,7123,17821,2637,99,2515,30195
Wisconsin,Boaz village,132,21,56,23,4,10,114
Wisconsin,Yuba village,45,10,21,10,0,2,43
Wisconsin,Delafield,7390,1821,3215,800,19,343,6198
Wisconsin,Big Bend village,1286,251,761,60,0,37,1109
Wisconsin,Colfax village,1106,205,367,169,10,96,847
Wisconsin,Pulaski village,3558,836,1095,512,64,174,2681
Wisconsin,Eland village,154,30,77,10,0,14,131
Wisconsin,Juneau,2686,781,994,291,14,209,2289
Wisconsin,Mount Sterling village,150,38,54,10,3,19,124
Wisconsin,Lowell village,253,51,126,34,0,18,229
Wisconsin,Browntown village,263,35,139,21,6,12,213
Wisconsin,Elroy,1361,364,495,172,31,115,1177
Wisconsin,Potter Lake,1164,197,659,76,9,56,997
Wisconsin,Williams Bay village,2592,451,1202,241,31,190,2115
Wisconsin,Bonduel village,1378,289,587,148,25,52,1101
Wisconsin,Elderon village,326,129,58,15,0,10,212
Wisconsin,Hammond village,2020,403,767,207,44,111,1532
Wisconsin,River Falls,15467,6711,4602,1116,77,552,13058
Wisconsin,Cochrane village,451,112,215,34,0,15,376
Wisconsin,Neopit,858,266,185,79,18,25,573
Wisconsin,Okauchee Lake,4409,686,2506,324,15,92,3623
Wisconsin,Pewaukee,14299,2057,7800,1037,25,610,11529
Wisconsin,Wisconsin Dells,2752,712,1014,266,78,217,2287
Wisconsin,Lake Wisconsin,4336,700,2379,481,4,192,3756
Wisconsin,Lena village,518,147,180,35,5,40,407
Wisconsin,Oconto,4469,1137,1483,653,69,410,3752
Wisconsin,Loganville village,266,40,118,43,2,5,208
Wisconsin,Sauk City village,3467,853,1355,463,18,235,2924
Wisconsin,Powers Lake,970,264,497,81,4,25,871
Wisconsin,Black River Falls,3512,952,1164,404,11,320,2851
Wisconsin,Wind Lake,5266,1039,2700,526,19,173,4457
Wisconsin,Egg Harbor village,244,40,158,11,2,23,234
Wisconsin,Necedah village,944,232,356,157,9,49,803
Wisconsin,New Lisbon,2502,1000,551,454,46,125,2176
Wisconsin,Spring Green village,1716,364,811,109,8,155,1447
Wisconsin,Wausau,38801,10034,14356,4765,485,2162,31802
Wisconsin,Rothschild village,5281,965,2532,469,26,217,4209
Wisconsin,Eleva village,774,159,261,78,0,63,561
Wisconsin,Taylor village,411,107,154,55,0,30,346
Wisconsin,Abbotsford,2175,527,795,179,33,144,1678
Wisconsin,Barneveld village,1276,222,558,86,5,31,902
Wisconsin,Highland village,986,206,445,62,7,40,760
Wisconsin,Elkhart Lake village,1076,268,501,113,6,51,939
Wisconsin,Sheboygan Falls,7878,1658,3423,898,82,490,6551
Wisconsin,Waldo village,634,141,287,38,3,28,497
Wisconsin,Plainfield village,897,196,363,50,0,75,684
Wisconsin,Kenosha,99810,30070,32880,10807,1311,4079,79147
Wisconsin,Cottage Grove village,6904,1165,3128,611,0,136,5040
Wisconsin,Fontana-on-Geneva Lake village,1507,172,912,174,6,80,1344
Wisconsin,Dane village,1098,262,501,74,3,34,874
Wisconsin,Oregon village,10215,2152,4102,1226,26,355,7861
Wisconsin,Hebron,170,53,56,48,3,10,170
Wisconsin,Barron,3334,820,1046,330,127,155,2478
Wisconsin,Markesan,1260,239,551,93,4,106,993
Wisconsin,Conrath village,76,29,19,17,1,10,76
Wisconsin,Glen Flora village,97,31,21,16,4,1,73
Wisconsin,Francis Creek village,550,116,308,28,0,14,466
Wisconsin,Reedsville village,1132,199,591,82,6,32,910
Wisconsin,Bay City village,468,112,179,75,7,25,398
Wyoming,Auburn,556,13,269,0,0,19,301
Wyoming,Thayne,451,86,165,44,12,39,346
Wyoming,Garland,282,103,121,0,0,58,282
Wyoming,Shoshoni,505,97,196,57,3,65,418
Wyoming,Byron,523,107,207,47,6,55,422
Wyoming,Albany,25,0,25,0,0,0,25
Wyoming,Moorcroft,905,85,415,66,4,19,589
Wyoming,Burlington,247,37,105,23,0,3,168
Wyoming,Atlantic City,0,0,0,0,0,0,0
Wyoming,Fort Washakie,1823,549,387,178,25,91,1230
Wyoming,Jeffrey City,29,0,29,0,0,0,29
Wyoming,Slater,84,13,41,17,0,0,71
Wyoming,Fontenelle,18,0,0,0,0,18,18
Wyoming,Buffalo,4586,790,1916,518,7,409,3640
Wyoming,James Town,692,111,433,17,0,14,575
Wyoming,Lusk,1701,398,635,236,26,91,1386
Wyoming,Baggs,440,60,221,31,0,9,321
Wyoming,Fox Park,0,0,0,0,0,0,0
Wyoming,Whiting,99,0,71,28,0,0,99
Wyoming,Urie,491,163,291,0,0,0,454
Wyoming,Shell,138,61,77,0,0,0,138
Wyoming,Ryan Park,0,0,0,0,0,0,0
Wyoming,Osmond,266,0,232,0,0,0,232
Wyoming,Orin,74,34,40,0,0,0,74
Wyoming,Nordic,391,0,220,131,0,0,351
Wyoming,Mammoth,51,26,3,17,0,5,51
Wyoming,Kelly,0,0,0,0,0,0,0
Wyoming,Hillsdale,0,0,0,0,0,0,0
Wyoming,Freedom,247,54,85,17,28,0,184
Wyoming,Carpenter,380,60,280,0,0,0,340
Wyoming,Beulah,0,0,0,0,0,0,0
Wyoming,Arlington,6,0,0,0,0,6,6
Wyoming,Etna,41,0,41,0,0,0,41
Wyoming,Sleepy Hollow,1010,308,527,55,10,0,900
Wyoming,Chugwater,262,53,102,48,7,29,239
Wyoming,Casper Mountain,695,255,339,9,0,35,638
Wyoming,Carter,0,0,0,0,0,0,0
Wyoming,Moose Wilson Road,1479,374,694,240,0,47,1355
Wyoming,Arapahoe,1689,545,327,193,17,89,1171
Wyoming,South Greeley,4345,769,1602,718,119,154,3362
Wyoming,Lost Springs,1,0,0,1,0,0,1
Wyoming,Saratoga,1445,379,728,93,7,66,1273
Wyoming,Meeteetse,295,61,160,26,0,18,265
Wyoming,Hartrandt,745,57,426,54,33,31,601
Wyoming,Parkman,116,14,93,9,0,0,116
Wyoming,Brookhurst,238,50,125,26,0,13,214
Wyoming,Ranchettes,6097,802,3439,483,73,224,5021
Wyoming,Evanston,11953,2351,4784,1299,98,607,9139
Wyoming,Deaver,175,24,82,18,0,11,135
Wyoming,Fox Farm-College,4424,1593,992,606,60,208,3459
Wyoming,Meadow Acres,173,33,75,53,0,0,161
Wyoming,Arrowhead Springs,131,12,63,26,0,0,101
Wyoming,Osage,104,23,19,62,0,0,104
Wyoming,Torrington,6717,1571,2806,706,40,399,5522
Wyoming,Granger,50,0,45,3,0,2,50
Wyoming,Bear River,619,84,317,37,1,15,454
Wyoming,Encampment,437,86,233,33,0,26,378
Wyoming,Star Valley Ranch,1869,206,1137,122,8,64,1537
Wyoming,Veteran,70,24,31,0,0,0,55
Wyoming,Ranchester,1041,146,458,63,8,40,715
Wyoming,Story,639,77,323,54,0,78,532
Wyoming,Lonetree,0,0,0,0,0,0,0
Wyoming,Manville,107,10,74,12,4,7,107
Wyoming,Van Tassell,29,1,8,17,0,0,26
Wyoming,Alpine,716,153,381,84,3,11,632
Wyoming,Cheyenne,63243,13900,25831,7337,767,3110,50945
Wyoming,Hyattville,112,19,61,32,0,0,112
Wyoming,Hoback,1227,238,433,263,0,10,944
Wyoming,Big Horn,490,117,179,92,0,45,433
Wyoming,Wilson,1731,285,1002,73,0,36,1396
Wyoming,Edgerton,172,26,81,24,5,10,146
Wyoming,Casper,58756,13432,22433,7049,549,2903,46366
Wyoming,Lingle,596,76,319,34,14,27,470
Wyoming,Bessemer Bend,183,9,91,56,9,0,165
Wyoming,Clearmont,147,33,52,23,0,12,120
Wyoming,Pinedale,2263,239,763,475,40,51,1568
Wyoming,Hawk Springs,7,0,0,7,0,0,7
Wyoming,Daniel,191,60,79,52,0,0,191
Wyoming,Cora,47,0,35,0,0,12,47
Wyoming,Hartville,71,10,43,16,0,2,71
Wyoming,La Barge,326,36,156,29,0,32,253
Wyoming,Huntley,0,0,0,0,0,0,0
Wyoming,Clearview Acres,1568,323,621,66,81,108,1199
Wyoming,Little America,84,84,0,0,0,0,84
Wyoming,McKinnon,0,0,0,0,0,0,0
Wyoming,Vista West,1016,136,592,128,16,12,884
Wyoming,Ralston,478,52,218,55,0,53,378
Wyoming,Bairoil,197,35,141,4,0,2,182
Wyoming,Green River,12278,2500,5107,1310,73,516,9506
Wyoming,North Rock Springs,2128,532,1028,277,34,17,1888
Wyoming,Table Rock,0,0,0,0,0,0,0
Wyoming,Wamsutter,160,17,101,18,0,6,142
Wyoming,Mountain View,55,5,0,28,0,22,55
Wyoming,Hill View Heights,63,4,52,0,0,7,63
Wyoming,Westview Circle,0,0,0,0,0,0,0
Wyoming,Cody,9761,1960,4590,941,14,475,7980
Wyoming,Frannie,137,24,70,14,2,5,115
Wyoming,Eden,199,73,89,0,0,15,177
Wyoming,Purple Sage,812,291,238,0,0,30,559
Wyoming,Washam,0,0,0,0,0,0,0
Wyoming,Point of Rocks,141,27,54,9,0,0,90
Wyoming,Ten Sleep,176,31,97,20,2,16,166
Wyoming,South Park,1612,177,648,217,54,38,1134
Wyoming,Worland,5236,1016,2132,666,50,241,4105
Wyoming,Newcastle,3461,805,1466,368,0,238,2877
Wyoming,Opal,113,24,60,17,0,5,106
Wyoming,Rock Springs,23633,5152,9012,2540,306,885,17895
Wyoming,Afton,2234,516,861,196,46,92,1711
Wyoming,Cokeville,579,58,282,31,5,13,389
Wyoming,Yoder,120,29,56,18,0,8,111
Wyoming,Glendo,239,12,96,51,0,13,172
Wyoming,Marbleton,1165,224,493,133,0,84,934
Wyoming,Upton,963,121,427,112,16,107,783
Wyoming,Arvada,39,0,12,14,0,0,26
Wyoming,Alcova,0,0,0,0,0,0,0
Wyoming,Bar Nunn,2787,391,1273,266,6,36,1972
Wyoming,Farson,44,0,0,44,0,0,44
Wyoming,Reliance,496,123,226,34,0,95,478
Wyoming,Superior,307,108,111,31,0,2,252
Wyoming,Homa Hills,245,20,131,15,0,55,221
Wyoming,Powell,6349,1613,2266,765,60,348,5052
Wyoming,Sheridan,17825,3854,7349,2155,194,941,14493
Wyoming,Basin,1596,451,545,213,14,153,1376
Wyoming,Greybull,1864,447,720,199,44,81,1491
Wyoming,Woods Landing-Jelm,120,17,84,9,0,0,110
Wyoming,Chugcreek,206,28,105,0,0,0,133
Wyoming,Red Butte,546,112,294,85,0,11,502
Wyoming,Mills,3848,888,1210,610,44,323,3075
Wyoming,Antelope Hills,0,0,0,0,0,0,0
Wyoming,Rolling Hills,458,91,248,17,7,7,370
Wyoming,Midwest,295,38,139,30,6,18,231
Wyoming,Ethete,1598,545,285,169,14,52,1065
Wyoming,Wheatland,3609,566,1772,373,54,257,3022
Wyoming,Owl Creek,0,0,0,0,0,0,0
Wyoming,Laramie,32178,14398,9987,2345,182,681,27593
Wyoming,Mountain View,1329,134,630,56,0,68,888
Wyoming,Medicine Bow,349,75,154,33,0,47,309
Wyoming,Esterbrook,58,0,29,29,0,0,58
Wyoming,Douglas,6402,899,2924,761,53,407,5044
Wyoming,Bondurant,49,0,0,49,0,0,49
Wyoming,Lakeview North,148,0,110,0,0,0,110
Wyoming,Rock River,151,29,79,7,0,22,137
Wyoming,Fairview,175,33,67,0,19,0,119
Wyoming,Boulder,40,0,40,0,0,0,40
Wyoming,La Grange,361,152,110,31,0,17,310
Wyoming,Glenrock,2620,308,1046,467,0,79,1900
Wyoming,Turnerville,79,17,32,0,0,30,79
Wyoming,Kemmerer,2730,588,1177,201,34,111,2111
Wyoming,Alpine Northwest,16,0,0,0,0,16,16
Wyoming,Dubois,741,167,295,115,0,79,656
Wyoming,Crowheart,130,32,61,20,0,12,125
Wyoming,Boulder Flats,300,95,85,41,0,19,240
Wyoming,Dayton,723,126,339,85,0,22,572
Wyoming,Thermopolis,2884,444,1315,319,13,228,2319
Wyoming,Warren AFB,2300,677,902,64,0,0,1643
Wyoming,Sinclair,358,83,182,14,0,34,313
Wyoming,Hanna,765,146,315,85,10,39,595
Wyoming,Cowley,769,168,283,44,3,47,545
Wyoming,Teton Village,201,0,117,21,0,0,138
Wyoming,Jackson,10483,3715,3480,931,176,148,8450
Wyoming,Alta,369,70,213,6,6,61,356
Wyoming,Lyman,2218,301,1064,94,6,71,1536
Wyoming,Dixon,95,15,18,22,0,9,64
Wyoming,Diamondville,708,127,350,46,6,42,571
Wyoming,Taylor,54,5,44,0,0,0,49
Wyoming,Kaycee,258,37,130,22,0,12,201
Wyoming,Riverside,39,6,25,8,0,0,39
Wyoming,Wright,1660,289,801,185,27,12,1314
Wyoming,Gillette,33056,7065,13290,2800,506,795,24456
Wyoming,Burns,347,71,127,38,2,24,262
Wyoming,Big Piney,572,127,202,39,0,17,385
Wyoming,Y-O Ranch,84,0,84,0,0,0,84
Wyoming,Albin,144,21,62,13,0,0,96
Wyoming,Powder River,0,0,0,0,0,0,0
Wyoming,Guernsey,1179,253,512,91,6,40,902
Wyoming,Smoot,184,25,87,26,0,0,138
Wyoming,Oakley,0,0,0,0,0,0,0
Wyoming,Bedford,261,63,37,0,30,0,130
Wyoming,Lander,7621,1995,2704,838,131,448,6116
Wyoming,Pine Haven,516,60,294,26,5,15,400
Wyoming,Kirby,85,9,61,2,0,4,76
Wyoming,Evansville,2944,681,1227,299,0,100,2307
Wyoming,Alpine Northeast,0,0,0,0,0,0,0
Wyoming,Pine Bluffs,1119,186,491,114,0,84,875
Wyoming,Robertson,49,0,0,18,0,16,34
Wyoming,Grover,302,48,133,0,0,0,181
Wyoming,Riverton,11069,2657,4035,1442,168,567,8869
Wyoming,Lucerne,499,86,278,68,0,11,443
Wyoming,East Thermopolis,254,53,62,66,1,35,217
Wyoming,Centennial,257,56,168,27,0,0,251
Wyoming,Rawlins,8975,1994,3443,984,234,316,6971
Wyoming,Elk Mountain,192,31,127,1,0,7,166
Wyoming,Fort Bridger,201,38,91,47,0,25,201
Wyoming,Manderson,75,14,39,8,0,4,65
Wyoming,Rafter J Ranch,1748,177,949,274,0,97,1497
Wyoming,Lance Creek,18,0,18,0,0,0,18
Wyoming,Pavillion,219,30,94,22,5,7,158
Wyoming,Johnstown,225,61,84,23,7,13,188
Wyoming,Hudson,498,109,169,64,10,26,378
Wyoming,Sundance,1694,168,821,124,0,110,1223
Wyoming,Hulett,394,116,151,53,9,18,347
Wyoming,Lovell,2252,449,846,230,37,206,1768
Wyoming,Fort Laramie,247,62,125,29,0,10,226
